"","year_date","week_num","id","num_start_journeys","num_end_journeys","latitude","longitude","name","total_touchpoints"
"1",2020,1,1,59,44,"51.52916347","-0.109970527","River Street , Clerkenwell",103
"2",2020,1,2,141,141,"51.49960695","-0.197574246","Phillimore Gardens, Kensington",282
"3",2020,1,3,68,82,"51.52128377","-0.084605692","Christopher Street, Liverpool Street",150
"4",2020,1,4,63,79,"51.53005939","-0.120973687","St. Chad's Street, King's Cross",142
"5",2020,1,5,164,178,"51.49313","-0.156876","Sedding Street, Sloane Square",342
"6",2020,1,6,110,115,"51.51811784","-0.144228881","Broadcasting House, Marylebone",225
"7",2020,1,7,65,42,"51.53430039","-0.1680743","Charlbert Street, St. John's Wood",107
"8",2020,1,8,80,80,"51.529857","-0.18348604","Maida Vale, Maida Vale",160
"9",2020,1,9,105,113,"51.5073853","-0.096440751","New Globe Walk, Bankside",218
"10",2020,1,10,56,61,"51.50597426","-0.092754157","Park Street, Bankside",117
"11",2020,1,11,111,92,"51.52395143","-0.122502346","Brunswick Square, Bloomsbury",203
"12",2020,1,12,106,119,"51.52168078","-0.130431727","Malet Street, Bloomsbury",225
"13",2020,1,13,34,33,"51.51991453","-0.136039674","Scala Street, Fitzrovia",67
"14",2020,1,14,324,332,"51.52994371","-0.123616824","Belgrove Street , King's Cross",656
"15",2020,1,15,101,110,"51.51772703","-0.127854211","Great Russell Street, Bloomsbury",211
"16",2020,1,16,94,94,"51.52635795","-0.125979294","Cartwright Gardens , Bloomsbury",188
"17",2020,1,17,151,131,"51.5216612","-0.109006325","Hatton Wall, Holborn",282
"18",2020,1,18,186,187,"51.51477076","-0.12221963","Drury Lane, Covent Garden",373
"19",2020,1,19,66,58,"51.52505093","-0.131161087","Taviton Street, Bloomsbury",124
"20",2020,1,20,47,44,"51.527326","-0.13605286","Drummond Street , Euston",91
"21",2020,1,21,41,30,"51.53007835","-0.13884627","Hampstead Road (Cartmel), Euston",71
"22",2020,1,22,93,97,"51.5222641","-0.114079481","Northington Street , Holborn",190
"23",2020,1,23,66,54,"51.51943538","-0.119123345","Red Lion Square, Holborn",120
"24",2020,1,24,84,154,"51.51908011","-0.124678402","British Museum, Bloomsbury",238
"25",2020,1,25,122,106,"51.5288338","-0.132250369","Doric Way , Somers Town",228
"26",2020,1,26,70,56,"51.52728093","-0.11829517","Ampton Street , Clerkenwell",126
"27",2020,1,27,83,89,"51.51382102","-0.107927706","Bouverie Street, Temple",172
"28",2020,1,28,109,101,"51.52351808","-0.143613641","Bolsover Street, Fitzrovia",210
"29",2020,1,29,96,92,"51.513735","-0.193487","Hereford Road, Bayswater",188
"30",2020,1,30,88,80,"51.52915444","-0.093421615","Windsor Terrace, Hoxton",168
"31",2020,1,31,56,85,"51.52953709","-0.083353323","Fanshaw Street, Hoxton",141
"32",2020,1,32,148,189,"51.52469624","-0.084439283","Leonard Circus , Shoreditch",337
"33",2020,1,33,91,92,"51.5156","-0.070056","Central House, Aldgate",183
"34",2020,1,34,53,44,"51.5341235","-0.129386874","Pancras Road, King's Cross",97
"35",2020,1,36,114,118,"51.50173726","-0.184980612","De Vere Gardens, Kensington",232
"36",2020,1,37,124,126,"51.49159394","-0.192369256","Penywern Road, Earl's Court",250
"37",2020,1,38,54,60,"51.4973875","-0.197245586","Abingdon Villas, Kensington",114
"38",2020,1,39,211,207,"51.5263778","-0.078130921","Shoreditch High Street, Shoreditch",418
"39",2020,1,40,96,95,"51.52127071","-0.0755789","Commercial Street, Shoreditch",191
"40",2020,1,41,104,117,"51.520955","-0.083493552","Pindar Street, Liverpool Street",221
"41",2020,1,42,96,78,"51.53099181","-0.093903825","Wenlock Road , Hoxton",174
"42",2020,1,43,99,101,"51.52026","-0.157183945","Crawford Street, Marylebone",200
"43",2020,1,44,63,73,"51.51073687","-0.144165239","Bruton Street, Mayfair",136
"44",2020,1,45,126,100,"51.522511","-0.162298","Boston Place, Marylebone",226
"45",2020,1,46,196,202,"51.507131","-0.06691","Nesham Street, Wapping",398
"46",2020,1,47,124,123,"51.52334476","-0.183846408","Warwick Avenue Station, Maida Vale",247
"47",2020,1,48,176,182,"51.51248445","-0.099141408","Godliman Street, St. Paul's",358
"48",2020,1,49,60,55,"51.50706909","-0.145904427","Curzon Street, Mayfair",115
"49",2020,1,50,90,88,"51.52867339","-0.087459376","East Road, Hoxton",178
"50",2020,1,51,48,49,"51.52671796","-0.104298194","Finsbury Library , Finsbury",97
"51",2020,1,52,61,63,"51.52295439","-0.094934859","Roscoe Street, St. Luke's",124
"52",2020,1,53,37,54,"51.5099923","-0.143495266","Grafton Street, Mayfair",91
"53",2020,1,54,64,62,"51.52174785","-0.094475072","Golden Lane, Barbican",126
"54",2020,1,55,177,190,"51.51707521","-0.086685542","Finsbury Circus, Liverpool Street",367
"55",2020,1,56,79,90,"51.52058381","-0.154701411","Paddington Street, Marylebone",169
"56",2020,1,57,125,130,"51.52334672","-0.120202614","Guilford Street , Bloomsbury",255
"57",2020,1,58,127,128,"51.52452699","-0.079248081","New Inn Yard, Shoreditch",255
"58",2020,1,60,61,48,"51.52644828","-0.172190727","Lisson Grove, St. John's Wood",109
"59",2020,1,61,88,80,"51.49738251","-0.089446947","Great Dover Street, The Borough",168
"60",2020,1,62,62,37,"51.4907579","-0.106323685","Cotton Garden Estate, Kennington",99
"61",2020,1,63,48,37,"51.53089041","-0.089782579","Murray Grove , Hoxton",85
"62",2020,1,64,196,247,"51.50946212","-0.124749274","William IV Street, Strand",443
"63",2020,1,65,68,64,NA,NA,NA,132
"64",2020,1,66,161,187,"51.51795029","-0.108657431","Holborn Circus, Holborn",348
"65",2020,1,67,86,80,"51.51882555","-0.108028472","Hatton Garden, Holborn",166
"66",2020,1,68,123,100,"51.52059681","-0.116688468","Theobald's Road , Holborn",223
"67",2020,1,69,68,86,"51.5262363","-0.134407652","Euston Road, Euston",154
"68",2020,1,70,40,32,"51.53136059","-0.117069978","Calshot Street , King's Cross",72
"69",2020,1,71,178,175,"51.5154186","-0.098850915","Newgate Street , St. Paul's",353
"70",2020,1,72,78,71,"51.52352001","-0.108340165","Farringdon Lane, Clerkenwell",149
"71",2020,1,73,129,128,"51.52572618","-0.088486188","Old Street Station, St. Luke's",257
"72",2020,1,74,197,194,"51.48591714","-0.124469948","Vauxhall Cross, Vauxhall",391
"73",2020,1,75,92,94,"51.53219984","-0.105480698","Torrens Street, Angel",186
"74",2020,1,76,62,30,"51.52559505","-0.144083893","Longford Street, The Regent's Park",92
"75",2020,1,77,105,95,"51.52341837","-0.124121774","Russell Square Station, Bloomsbury",200
"76",2020,1,78,72,61,"51.52486887","-0.099489485","Sadlers Sports Centre, Finsbury",133
"77",2020,1,79,44,39,"51.511726","-0.11385596","Arundel Street, Temple",83
"78",2020,1,80,104,96,"51.50069361","-0.102091246","Webber Street , Southwark",200
"79",2020,1,81,101,104,"51.52025302","-0.141327271","Great Titchfield Street, Fitzrovia",205
"80",2020,1,82,67,67,"51.514274","-0.111257","Chancery Lane, Holborn",134
"81",2020,1,83,159,204,"51.50963938","-0.131510949","Panton Street, West End",363
"82",2020,1,84,60,63,"51.51593725","-0.111778348","Breams Buildings, Holborn",123
"83",2020,1,85,145,166,"51.50064702","-0.078600401","Tanner Street, Bermondsey",311
"84",2020,1,86,70,67,"51.48947903","-0.115156562","Sancroft Street, Vauxhall",137
"85",2020,1,87,82,91,"51.51646835","-0.079684557","Devonshire Square, Liverpool Street",173
"86",2020,1,88,150,188,"51.51858757","-0.132053392","Bayley Street , Bloomsbury",338
"87",2020,1,89,85,73,"51.5262503","-0.123509611","Tavistock Place, Bloomsbury",158
"88",2020,1,90,21,22,"51.53301907","-0.139174593","Harrington Square 1, Camden Town",43
"89",2020,1,91,72,68,"51.49368637","-0.111014912","Walnut Tree Walk, Vauxhall",140
"90",2020,1,92,53,83,"51.49889832","-0.100440521","Borough Road, Elephant & Castle",136
"91",2020,1,93,92,54,"51.53440868","-0.109025404","Cloudesley Road, Angel",146
"92",2020,1,94,152,152,"51.49506109","-0.085814489","Bricklayers Arms, Borough",304
"93",2020,1,95,123,137,"51.5208417","-0.097340162","Aldersgate Street, Barbican",260
"94",2020,1,96,50,53,"51.53095071","-0.078505384","Falkirk Street, Hoxton",103
"95",2020,1,97,98,91,"51.49792478","-0.183834706","Gloucester Road (North), Kensington",189
"96",2020,1,98,81,60,"51.52554222","-0.138231303","Hampstead Road, Euston",141
"97",2020,1,99,211,236,"51.51457763","-0.158264483","Old Quebec Street, Marylebone",447
"98",2020,1,100,79,65,"51.49043573","-0.122806861","Albert Embankment, Vauxhall",144
"99",2020,1,101,175,178,"51.51155322","-0.0929401","Queen Street 1, Bank",353
"100",2020,1,102,75,82,"51.51340693","-0.076793375","Jewry Street, Aldgate",157
"101",2020,1,103,62,52,"51.50472376","-0.192538767","Vicarage Gate, Kensington",114
"102",2020,1,104,243,246,"51.51159481","-0.077121322","Crosswall, Tower",489
"103",2020,1,105,87,99,"51.51552971","-0.190240716","Westbourne Grove, Bayswater",186
"104",2020,1,106,55,50,"51.51410514","-0.147301667","Woodstock Street, Mayfair",105
"105",2020,1,107,197,173,"51.52600832","-0.096317627","Finsbury Leisure Centre, St. Luke's",370
"106",2020,1,108,162,157,"51.49812559","-0.132102166","Abbey Orchard Street, Westminster",319
"107",2020,1,109,251,268,"51.51563144","-0.132328837","Soho Square , Soho",519
"108",2020,1,110,64,59,"51.53304322","-0.172528678","Wellington Road, St. John's Wood",123
"109",2020,1,111,382,413,"51.5100172","-0.157275636","Park Lane , Hyde Park",795
"110",2020,1,112,59,54,"51.51580998","-0.105270275","Stonecutter Street, Holborn",113
"111",2020,1,113,69,71,"51.49646288","-0.183289032","Gloucester Road (Central), South Kensington",140
"112",2020,1,114,112,102,"51.52451738","-0.158963647","Park Road (Baker Street), The Regent's Park",214
"113",2020,1,115,156,158,"51.51423368","-0.073537654","Braham Street, Aldgate",314
"114",2020,1,116,264,280,"51.51449962","-0.141423695","Little Argyll Street, West End",544
"115",2020,1,117,142,136,"51.49288067","-0.114934001","Lollard Street, Vauxhall",278
"116",2020,1,118,54,61,"51.49582705","-0.13547809","Rochester Row, Westminster",115
"117",2020,1,119,139,161,"51.52589324","-0.090847761","Bath Street, St. Luke's",300
"118",2020,1,120,39,54,"51.51573534","-0.093080779","The Guildhall, Guildhall",93
"119",2020,1,121,103,104,"51.51891348","-0.156166631","Baker Street, Marylebone",207
"120",2020,1,122,111,115,"51.52111369","-0.078869751","Norton Folgate, Liverpool Street",226
"121",2020,1,123,39,38,"51.52836014","-0.104724625","St. John Street, Finsbury",77
"122",2020,1,124,46,40,"51.49654462","-0.150905245","Eaton Square, Belgravia",86
"123",2020,1,125,92,88,"51.50069491","-0.094524319","Borough High Street, The Borough",180
"124",2020,1,126,87,87,"51.51782144","-0.096496865","Museum of London, Barbican",174
"125",2020,1,127,44,51,"51.51700801","-0.09388536","Wood Street, Guildhall",95
"126",2020,1,128,91,89,"51.49536226","-0.185296516","Emperor's Gate, South Kensington",180
"127",2020,1,129,107,128,"51.5118973","-0.137043852","Golden Square, Soho",235
"128",2020,1,130,280,332,"51.50950627","-0.075459482","Tower Gardens , Tower",612
"129",2020,1,131,41,45,"51.53300545","-0.136792671","Eversholt Street , Camden Town",86
"130",2020,1,132,324,332,"51.52364804","-0.074754872","Bethnal Green Road, Shoreditch",656
"131",2020,1,133,263,259,NA,NA,NA,522
"132",2020,1,134,61,63,"51.504904","-0.06797","Wapping High Street, Wapping",124
"133",2020,1,135,89,104,"51.52326004","-0.104708922","Clerkenwell Green, Clerkenwell",193
"134",2020,1,136,120,135,"51.51196176","-0.097441687","Queen Victoria Street, St. Paul's",255
"135",2020,1,138,142,158,"51.51227622","-0.157436972","Green Street, Mayfair",300
"136",2020,1,139,99,68,"51.49488108","-0.117974901","Lambeth Road, Vauxhall",167
"137",2020,1,140,103,106,"51.52096262","-0.085634242","Finsbury Square , Moorgate",209
"138",2020,1,141,130,138,"51.51530805","-0.147203711","Chapel Place, Marylebone",268
"139",2020,1,142,72,69,"51.49372451","-0.198286569","West Cromwell Road, Earl's Court",141
"140",2020,1,143,87,85,"51.4968865","-0.161203828","Pont Street, Knightsbridge",172
"141",2020,1,144,162,180,"51.48894022","-0.111435796","Kennington Cross, Kennington",342
"142",2020,1,145,24,13,"51.50074359","-0.202759212","Ilchester Place, Kensington",37
"143",2020,1,146,59,38,"51.48836528","-0.129361842","Vauxhall Bridge , Pimlico",97
"144",2020,1,148,122,110,"51.49211134","-0.138364847","Tachbrook Street, Victoria",232
"145",2020,1,149,90,76,"51.48478899","-0.110683213","Kennington Road Post Office, Oval",166
"146",2020,1,150,103,110,"51.49705603","-0.168917077","Holy Trinity Brompton, Knightsbridge",213
"147",2020,1,151,93,75,"51.51213691","-0.201554966","Chepstow Villas, Notting Hill",168
"148",2020,1,152,100,93,"51.49217002","-0.101536865","Hampton Street, Walworth",193
"149",2020,1,153,226,226,"51.511933","-0.174411","Bayswater Road, Hyde Park",452
"150",2020,1,154,137,127,"51.50379168","-0.11282408","Waterloo Station 3, Waterloo",264
"151",2020,1,155,78,83,"51.49586666","-0.191933711","Lexham Gardens, Kensington",161
"152",2020,1,156,64,58,"51.49443626","-0.092921165","New Kent Road, The Borough",122
"153",2020,1,157,87,105,"51.50039792","-0.193068385","Wright's Lane, Kensington",192
"154",2020,1,158,88,82,"51.49085368","-0.196170309","Trebovir Road, Earl's Court",170
"155",2020,1,159,203,221,"51.51461995","-0.137841333","Great Marlborough Street, Soho",424
"156",2020,1,160,101,91,"51.50663341","-0.131773845","Waterloo Place, St. James's",192
"157",2020,1,161,69,71,"51.49234577","-0.141334487","Guildhouse Street, Victoria",140
"158",2020,1,162,99,98,"51.51760685","-0.121328408","Southampton Place, Holborn",197
"159",2020,1,163,105,96,"51.4931848","-0.167894973","Sloane Avenue, Knightsbridge",201
"160",2020,1,164,59,45,"51.515607","-0.183118788","Cleveland Gardens, Bayswater",104
"161",2020,1,165,42,33,"51.517932","-0.183716959","Orsett Terrace, Bayswater",75
"162",2020,1,166,124,142,"51.50185512","-0.159237081","Seville Street, Knightsbridge",266
"163",2020,1,167,161,169,"51.49395092","-0.147624377","Eccleston Place, Victoria",330
"164",2020,1,168,86,95,"51.50040123","-0.195455928","Argyll Road, Kensington",181
"165",2020,1,169,124,130,"51.51474612","-0.165164288","Porchester Place, Paddington",254
"166",2020,1,170,50,37,"51.52784273","-0.108068155","Hardwick Street, Clerkenwell",87
"167",2020,1,171,54,60,"51.4916156","-0.186753859","Collingham Gardens, Earl's Court",114
"168",2020,1,172,54,60,"51.49121192","-0.173715911","Sumner Place, South Kensington",114
"169",2020,1,173,84,87,"51.50486","-0.113001","Waterloo Road, South Bank",171
"170",2020,1,174,84,78,"51.512529","-0.115163","Strand, Strand",162
"171",2020,1,175,53,57,"51.521668","-0.079608554","Worship Street, Shoreditch",110
"172",2020,1,176,70,62,"51.51791921","-0.188098863","Gloucester Terrace, Bayswater",132
"173",2020,1,177,132,143,"51.49616092","-0.140947636","Ashley Place, Victoria",275
"174",2020,1,178,119,103,"51.48985626","-0.141923621","Warwick Square, Pimlico",222
"175",2020,1,180,105,94,"51.5129118","-0.153645496","North Audley Street, Mayfair",199
"176",2020,1,181,55,55,"51.49941247","-0.152317537","Belgrave Square, Belgravia",110
"177",2020,1,182,77,78,"51.52202903","-0.165842551","Bell Street , Marylebone",155
"178",2020,1,183,123,101,"51.482362","-0.13612398","Riverlight North, Nine Elms",224
"179",2020,1,184,87,82,"51.52071513","-0.14521173","Portland Place, Marylebone",169
"180",2020,1,185,112,126,"51.48805753","-0.140741432","Alderney Street, Pimlico",238
"181",2020,1,186,180,183,"51.51733558","-0.175810943","South Wharf Road, Paddington",363
"182",2020,1,187,88,93,"51.49247977","-0.178433004","Queen's Gate (South), South Kensington",181
"183",2020,1,188,69,70,"51.5165179","-0.164393768","Nutford Place, Marylebone",139
"184",2020,1,189,69,31,"51.53166681","-0.109914711","Claremont Square, Angel",100
"185",2020,1,190,132,121,"51.48997562","-0.132845681","Rampayne Street, Pimlico",253
"186",2020,1,191,649,659,"51.50311799","-0.153520935","Hyde Park Corner, Hyde Park",1308
"187",2020,1,192,175,190,"51.51251523","-0.133201961","Wardour Street, Soho",365
"188",2020,1,193,145,157,"51.50581776","-0.100186337","Bankside Mix, Bankside",302
"189",2020,1,194,311,459,"51.50462759","-0.091773776","Hop Exchange, The Borough",770
"190",2020,1,195,89,101,"51.50724437","-0.106237501","Milroy Walk, South Bank",190
"191",2020,1,196,74,74,"51.50368837","-0.098497684","Union Street, The Borough",148
"192",2020,1,197,95,92,"51.50556905","-0.111606696","Stamford Street, South Bank",187
"193",2020,1,199,271,309,"51.51048489","-0.082989638","Great Tower Street, Monument",580
"194",2020,1,200,95,94,"51.51492456","-0.066078037","LMU Commercial Road, Whitechapel",189
"195",2020,1,201,111,118,"51.5225965","-0.161113413","Dorset Square, Marylebone",229
"196",2020,1,202,145,161,"51.51236389","-0.06954201","Leman Street, Aldgate",306
"197",2020,1,203,106,108,"51.51821864","-0.100791005","West Smithfield Rotunda, Farringdon",214
"198",2020,1,204,78,67,"51.52659961","-0.112432615","Margery Street, Clerkenwell",145
"199",2020,1,206,146,158,"51.518154","-0.062697","New Road 1 , Whitechapel",304
"200",2020,1,207,35,32,"51.50135267","-0.153194766","Grosvenor Crescent, Belgravia",67
"201",2020,1,208,51,45,"51.52505151","-0.166304359","Mallory Street, Marylebone",96
"202",2020,1,209,54,48,"51.49358391","-0.165101392","Denyer Street, Knightsbridge",102
"203",2020,1,210,141,135,"51.51681444","-0.151926305","Hinde Street, Marylebone",276
"204",2020,1,211,73,83,"51.49464523","-0.158105512","Cadogan Place, Knightsbridge",156
"205",2020,1,212,30,28,"51.50658458","-0.199004026","Campden Hill Road, Notting Hill",58
"206",2020,1,213,410,381,"51.50274025","-0.149569201","Wellington Arch, Hyde Park",791
"207",2020,1,214,131,138,"51.52683806","-0.130504336","Endsleigh Gardens, Euston",269
"208",2020,1,215,112,134,"51.51906932","-0.088285377","Moorfields, Moorgate",246
"209",2020,1,216,97,95,"51.49094565","-0.181190899","Old Brompton Road, South Kensington",192
"210",2020,1,217,261,261,"51.51615461","-0.082422399","Wormwood Street, Liverpool Street",522
"211",2020,1,218,71,67,"51.48971651","-0.170194408","St. Luke's Church, Chelsea",138
"212",2020,1,219,114,113,"51.49016361","-0.19039362","Bramham Gardens, Earl's Court",227
"213",2020,1,220,39,38,"51.49066456","-0.166485083","Chelsea Green, Chelsea",77
"214",2020,1,221,90,83,"51.49481649","-0.13045856","Horseferry Road, Westminster",173
"215",2020,1,222,70,68,"51.50275704","-0.155349725","Knightsbridge, Hyde Park",138
"216",2020,1,223,118,124,"51.49148474","-0.090220911","Rodney Road , Walworth",242
"217",2020,1,224,157,151,"51.51031","-0.18740235","Queensway, Kensington Gardens",308
"218",2020,1,225,192,142,"51.50935342","-0.196422","Notting Hill Gate Station, Notting Hill",334
"219",2020,1,226,108,106,"51.50844614","-0.131961389","Charles II Street, West End",214
"220",2020,1,227,112,100,"51.52891573","-0.115480888","Great Percy Street, Clerkenwell",212
"221",2020,1,228,226,305,"51.50742485","-0.134621209","St. James's Square, St. James's",531
"222",2020,1,229,165,188,"51.50654321","-0.123179697","Whitehall Place, Strand",353
"223",2020,1,230,91,121,"51.50669284","-0.103137426","Poured Lines, Bankside",212
"224",2020,1,231,109,115,"51.49396755","-0.17873226","Queen's Gate (Central), South Kensington",224
"225",2020,1,232,13,13,"51.51501025","-0.112753217","Carey Street, Holborn",26
"226",2020,1,233,219,275,"51.50777049","-0.130699733","Pall Mall East, West End",494
"227",2020,1,234,157,149,"51.53450449","-0.106992706","Liverpool Road (N1 Centre), Angel",306
"228",2020,1,235,81,61,"51.49571828","-0.110889274","Kennington Road  , Vauxhall",142
"229",2020,1,236,53,50,"51.51838043","-0.073438925","Fashion Street, Whitechapel",103
"230",2020,1,237,136,108,"51.5097860151","-0.0681619805156","Dock Street, Wapping",244
"231",2020,1,238,60,44,"51.5233534","-0.175116099","Frampton Street, Paddington",104
"232",2020,1,239,155,145,"51.52443845","-0.138019439","Warren Street Station, Euston",300
"233",2020,1,240,21,22,"51.50545935","-0.10569204","Colombo Street, Southwark",43
"234",2020,1,242,81,81,"51.52200801","-0.151359288","Beaumont Street, Marylebone",162
"235",2020,1,243,125,108,"51.49096258","-0.139625122","Gloucester Street, Pimlico",233
"236",2020,1,244,87,116,"51.51611887","-0.128585022","Earnshaw Street , Covent Garden",203
"237",2020,1,245,72,63,"51.4853572","-0.142207481","Grosvenor Road, Pimlico",135
"238",2020,1,246,89,98,"51.52285301","-0.099994052","Berry Street, Clerkenwell",187
"239",2020,1,247,85,60,"51.530529","-0.167515","St. John's Wood Church, The Regent's Park",145
"240",2020,1,248,244,259,"51.50645179","-0.170279555","Triangle Car Park, Hyde Park",503
"241",2020,1,249,66,70,"51.49859784","-0.096191134","Harper Road, The Borough",136
"242",2020,1,250,75,82,"51.489932","-0.162727","Royal Avenue 1, Chelsea",157
"243",2020,1,251,215,292,"51.518908","-0.079249","Brushfield Street, Liverpool Street",507
"244",2020,1,252,148,202,"51.5046364","-0.116542278","Jubilee Gardens, South Bank",350
"245",2020,1,253,108,99,"51.53404294","-0.086379717","Shoreditch Park, Hoxton",207
"246",2020,1,254,108,85,"51.53051587","-0.106408455","Chadwell Street, Angel",193
"247",2020,1,255,82,68,"51.52557531","-0.179592915","Clifton Road, Maida Vale",150
"248",2020,1,256,28,25,"51.51362054","-0.116764211","Houghton Street, Strand",53
"249",2020,1,257,63,63,"51.52248185","-0.154907218","Westminster University, Marylebone",126
"250",2020,1,258,41,30,NA,NA,NA,71
"251",2020,1,259,92,86,"51.490959","-0.1532331","Bourne Street, Belgravia",178
"252",2020,1,260,101,104,"51.5136846","-0.135580879","Broadwick Street, Soho",205
"253",2020,1,261,37,34,"51.5134891","-0.191351186","Princes Square, Bayswater",71
"254",2020,1,262,77,53,"51.49874469","-0.103132904","LSBU (Borough Road), Elephant & Castle",130
"255",2020,1,263,81,81,"51.51422502","-0.080660083","St. Mary Axe, Aldgate",162
"256",2020,1,264,120,115,"51.52644342","-0.109256828","Tysoe Street, Clerkenwell",235
"257",2020,1,265,82,67,"51.51595344","-0.169249375","Southwick Street, Paddington",149
"258",2020,1,266,75,51,"51.50102668","-0.180246101","Queen's Gate (North), Kensington",126
"259",2020,1,267,90,74,"51.49206037","-0.132224622","Regency Street, Westminster",164
"260",2020,1,268,137,117,"51.49320445","-0.144132875","Belgrave Road, Victoria",254
"261",2020,1,269,95,76,"51.50082346","-0.089740764","Empire Square, The Borough",171
"262",2020,1,270,266,261,"51.4863434","-0.122492418","Kennington Lane Rail Bridge, Vauxhall",527
"263",2020,1,271,65,58,"51.53583617","-0.156285395","London Zoo,  The Regent's Park",123
"264",2020,1,272,213,218,"51.50144456","-0.110699309","Baylis Road, Waterloo",431
"265",2020,1,273,107,124,"51.50613324","-0.114686385","Belvedere Road 1, South Bank",231
"266",2020,1,274,75,73,"51.49671237","-0.20528437","Warwick Road, Olympia",148
"267",2020,1,275,87,89,"51.52004497","-0.092176447","Barbican Centre, Barbican",176
"268",2020,1,276,61,63,"51.50930161","-0.084985356","Lower Thames Street, Monument",124
"269",2020,1,277,103,120,"51.50315739","-0.191496313","Kensington Church Street, Kensington",223
"270",2020,1,278,336,358,"51.5034938","-0.07962099","Tooley Street, Bermondsey",694
"271",2020,1,279,85,74,"51.51862243","-0.176645823","North Wharf Road, Paddington",159
"272",2020,1,280,98,109,"51.490083","-0.162418","Royal Avenue 2, Chelsea",207
"273",2020,1,281,58,60,"51.49580589","-0.127575233","Smith Square, Westminster",118
"274",2020,1,282,197,218,"51.51906446","-0.059642081","Royal London Hospital, Whitechapel",415
"275",2020,1,283,21,22,"51.51440928","-0.118478757","Kingsway, Covent Garden",43
"276",2020,1,284,105,95,"51.49914063","-0.112031483","Lambeth North Station, Waterloo",200
"277",2020,1,286,51,26,"51.5272947","-0.174653609","St. John's Wood Road, St. John's Wood",77
"278",2020,1,287,24,32,"51.52367314","-0.128377673","Bedford Way, Bloomsbury",56
"279",2020,1,288,168,154,"51.49236962","-0.147478734","Elizabeth Bridge, Victoria",322
"280",2020,1,289,27,34,"51.50923022","-0.151296092","South Audley Street, Mayfair",61
"281",2020,1,290,55,59,"51.518268","-0.17110323","St Mary's Hospital, Paddington",114
"282",2020,1,291,107,73,"51.48483991","-0.138089062","Claverton Street, Pimlico",180
"283",2020,1,292,169,185,"51.49888404","-0.165471605","Montpelier Street, Knightsbridge",354
"284",2020,1,293,70,63,"51.49815779","-0.209494128","Kensington Olympia Station, Olympia",133
"285",2020,1,294,153,149,"51.488226","-0.135635511","St. George's Square, Pimlico",302
"286",2020,1,295,85,85,"51.50029631","-0.092762704","Swan Street, The Borough",170
"287",2020,1,296,69,73,"51.49363156","-0.190603326","Knaresborough Place, Earl's Court",142
"288",2020,1,297,21,11,"51.49612799","-0.106000855","Geraldine Street, Elephant & Castle",32
"289",2020,1,298,178,195,"51.50227992","-0.074189225","Curlew Street, Shad Thames",373
"290",2020,1,299,50,45,"51.49398524","-0.136928582","Vincent Square, Westminster",95
"291",2020,1,300,261,258,"51.505014","-0.17306032","Serpentine Car Park, Hyde Park",519
"292",2020,1,301,137,145,"51.51475963","-0.148105415","Marylebone Lane, Marylebone",282
"293",2020,1,302,72,96,"51.466907","-0.216573","Putney Pier, Wandsworth",168
"294",2020,1,303,519,546,"51.50295379","-0.158456089","Albert Gate, Hyde Park",1065
"295",2020,1,306,54,55,"51.51816295","-0.135025698","Rathbone Street, Fitzrovia",109
"296",2020,1,307,316,322,"51.50990837","-0.187842717","Black Lion Gate, Kensington Gardens",638
"297",2020,1,308,86,84,"51.49907558","-0.085666316","Long Lane , Bermondsey",170
"298",2020,1,309,61,61,"51.50963123","-0.119047563","Embankment (Savoy), Strand",122
"299",2020,1,310,110,86,"51.4908679","-0.116911864","Black Prince Road, Vauxhall",196
"300",2020,1,311,72,79,"51.51918144","-0.140485596","Foley Street, Fitzrovia",151
"301",2020,1,312,82,57,"51.53088935","-0.176770502","Grove End Road, St. John's Wood",139
"302",2020,1,313,96,103,"51.51734403","-0.138072691","Wells Street, Fitzrovia",199
"303",2020,1,314,74,50,"51.50088934","-0.083159352","Tyers Gate, Bermondsey",124
"304",2020,1,315,92,85,"51.52536703","-0.153463612","The Tennis Courts, The Regent's Park",177
"305",2020,1,316,119,107,NA,NA,NA,226
"306",2020,1,317,46,40,"51.49679128","-0.093913472","Dickens Square, Borough",86
"307",2020,1,318,127,134,"51.51004801","-0.138846453","Sackville Street, Mayfair",261
"308",2020,1,319,109,115,"51.52702563","-0.088542771","Baldwin Street, St. Luke's",224
"309",2020,1,320,131,148,"51.49357351","-0.139956043","Queen Mother Sports Centre, Victoria",279
"310",2020,1,321,178,168,"51.49785559","-0.081608045","Bermondsey Street, Bermondsey",346
"311",2020,1,322,84,50,"51.526293","-0.073955","Palissy Street, Shoreditch",134
"312",2020,1,323,45,45,"51.523196","-0.083067","Clifton Street, Shoreditch",90
"313",2020,1,324,92,117,"51.49652013","-0.101384068","Ontario Street, Elephant & Castle",209
"314",2020,1,325,126,136,"51.50908747","-0.129697889","St. Martin's Street, West End",262
"315",2020,1,326,112,116,"51.53266186","-0.099981142","Graham Street, Angel",228
"316",2020,1,327,36,19,"51.53095","-0.085603","New North Road 1, Hoxton",55
"317",2020,1,328,39,34,"51.53114","-0.086016","New North Road 2, Hoxton",73
"318",2020,1,329,95,91,"51.53589283","-0.160854428","Prince Albert Road, The Regent's Park",186
"319",2020,1,330,109,75,"51.51641749","-0.179135079","Eastbourne Mews, Paddington",184
"320",2020,1,331,145,173,"51.52085887","-0.089887855","Bunhill Row, Moorgate",318
"321",2020,1,332,51,54,"51.49334336","-0.194757949","Nevern Place, Earl's Court",105
"322",2020,1,333,118,73,"51.50860544","-0.193764092","Palace Gardens Terrace, Notting Hill",191
"323",2020,1,334,88,76,"51.505044","-0.115851","Concert Hall Approach 1, South Bank",164
"324",2020,1,335,125,147,"51.51196803","-0.120718759","Tavistock Street, Covent Garden",272
"325",2020,1,336,47,95,"51.504942","-0.115533","Concert Hall Approach 2, South Bank",142
"326",2020,1,337,80,64,"51.51108452","-0.197524944","Pembridge Villas, Notting Hill",144
"327",2020,1,338,174,223,"51.51175646","-0.119643424","Wellington Street , Strand",397
"328",2020,1,339,34,24,"51.5333196","-0.1117812","Risinghill Street, Angel",58
"329",2020,1,340,119,119,"51.51444134","-0.087587447","Bank of England Museum, Bank",238
"330",2020,1,341,224,258,"51.50810309","-0.12602103","Craven Street, Strand",482
"331",2020,1,343,91,75,"51.53692216","-0.150181444","London Zoo Car Park, The Regent's Park",166
"332",2020,1,344,75,65,"51.528246","-0.10102611","Goswell Road (City Uni), Finsbury",140
"333",2020,1,345,201,203,"51.48802358","-0.166878535","Flood Street, Chelsea",404
"334",2020,1,347,99,106,"51.50013942","-0.113936001","Lower Marsh, Waterloo",205
"335",2020,1,348,100,114,"51.51217033","-0.150481272","Grosvenor Square, Mayfair",214
"336",2020,1,349,72,90,"51.51196","-0.142783033","St. George Street, Mayfair",162
"337",2020,1,350,151,142,"51.5017154373867","-0.1798541843891","Queen's Gate, Kensington Gardens",293
"338",2020,1,351,98,79,"51.529423","-0.097122","Macclesfield Rd, St Lukes",177
"339",2020,1,352,76,74,"51.486965","-0.116625","Vauxhall Street, Vauxhall",150
"340",2020,1,353,34,32,"51.49459148","-0.134234258","Greycoat Street , Westminster",66
"341",2020,1,354,109,140,"51.506767","-0.123702","Northumberland Avenue, Strand",249
"342",2020,1,355,40,40,NA,NA,NA,80
"343",2020,1,356,255,262,"51.494412","-0.173881","South Kensington Station, South Kensington",517
"344",2020,1,357,107,123,"51.520994","-0.139016","Howland Street, Fitzrovia",230
"345",2020,1,358,107,116,"51.516226","-0.124826","High Holborn , Covent Garden",223
"346",2020,1,360,132,147,"51.49675303","-0.138733562","Howick Place, Westminster",279
"347",2020,1,361,237,152,"51.50391973","-0.11342629","Waterloo Station 2, Waterloo",389
"348",2020,1,362,48,50,"51.536264","-0.133952","Royal College Street, Camden Town",98
"349",2020,1,363,28,15,"51.5291212008901","-0.171185284853","Lord's, St. John's Wood",43
"350",2020,1,364,67,70,"51.519656","-0.132339","Alfred Place, Bloomsbury",137
"351",2020,1,365,70,58,"51.530344","-0.100168","City Road, Angel",128
"352",2020,1,366,38,46,"51.5109192966489","-0.1511263847351","Millennium Hotel, Mayfair",84
"353",2020,1,367,79,73,"51.5173721","-0.1642075","Harrowby Street, Marylebone",152
"354",2020,1,368,128,156,"51.50024195","-0.15934065","Harriet Street, Knightsbridge",284
"355",2020,1,370,35,24,"51.520205","-0.174593","Paddington Green, Paddington",59
"356",2020,1,371,51,46,"51.49775","-0.10988","King Edward Walk, Waterloo",97
"357",2020,1,372,56,55,"51.515208","-0.117863","Sardinia Street, Holborn",111
"358",2020,1,373,30,25,"51.49980661","-0.176415994","Prince Consort Road, Knightsbridge",55
"359",2020,1,374,375,411,"51.50402794","-0.11386436","Waterloo Station 1, Waterloo",786
"360",2020,1,375,49,61,"51.50194596","-0.194392952","Kensington Town Hall, Kensington",110
"361",2020,1,376,154,153,"51.49188409","-0.125674815","Millbank Tower, Pimlico",307
"362",2020,1,377,39,39,"51.50535447","-0.113656543","Waterloo Bridge, South Bank",78
"363",2020,1,378,100,123,"51.49559291","-0.179077626","Natural History Museum, South Kensington",223
"364",2020,1,379,91,91,"51.51431171","-0.200838199","Turquoise Island, Notting Hill",182
"365",2020,1,380,38,57,"51.50686435","-0.150666888","Stanhope Gate, Mayfair",95
"366",2020,1,381,77,88,"51.51953043","-0.13577731","Charlotte Street, Fitzrovia",165
"367",2020,1,382,48,55,"51.50935171","-0.14744969","Farm Street, Mayfair",103
"368",2020,1,383,149,169,"51.51310333","-0.13121385","Frith Street, Soho",318
"369",2020,1,384,32,30,"51.496481","-0.192404","Marloes Road, Kensington",62
"370",2020,1,386,228,225,"51.51352755","-0.130110822","Moor Street, Soho",453
"371",2020,1,387,126,95,"51.49369988","-0.121394101","Fire Brigade Pier, Vauxhall",221
"372",2020,1,388,158,149,"51.51070161","-0.121723604","Southampton Street, Strand",307
"373",2020,1,389,60,64,"51.51013066","-0.155757901","Upper Grosvenor Street, Mayfair",124
"374",2020,1,390,41,32,"51.521776","-0.068856","Buxton Street 1, Shoreditch",73
"375",2020,1,392,125,110,"51.49942855","-0.179702476","Imperial College, Knightsbridge",235
"376",2020,1,393,87,86,"51.51733427","-0.103604248","Snow Hill, Farringdon",173
"377",2020,1,394,55,45,"51.524826","-0.176268","Aberdeen Place, St. John's Wood",100
"378",2020,1,395,151,177,"51.492462","-0.159919","Cadogan Gardens, Chelsea",328
"379",2020,1,396,56,61,"51.51809","-0.163609","Shouldham Street, Marylebone",117
"380",2020,1,397,150,145,"51.51348","-0.17977","Devonshire Terrace, Bayswater",295
"381",2020,1,398,77,50,"51.502319","-0.200742","Holland Park, Kensington",127
"382",2020,1,399,104,119,"51.52261762","-0.071653961","Brick Lane Market, Shoreditch",223
"383",2020,1,400,31,36,"51.517703","-0.154106","George Street, Marylebone",67
"384",2020,1,401,127,97,"51.528187","-0.075375","Columbia Road, Shoreditch",224
"385",2020,1,402,58,54,"51.52289229","-0.171681991","Penfold Street, Marylebone",112
"386",2020,1,403,67,70,"51.51689296","-0.158249929","George Place Mews, Marylebone",137
"387",2020,1,404,277,283,"51.50204238","-0.184400221","Palace Gate, Kensington Gardens",560
"388",2020,1,405,171,162,"51.49418566","-0.18267094","Gloucester Road Station, South Kensington",333
"389",2020,1,408,27,30,NA,NA,NA,57
"390",2020,1,409,109,99,"51.493146","-0.099828","Strata, Elephant & Castle",208
"391",2020,1,410,103,74,"51.519968","-0.169774","Edgware Road Station, Marylebone",177
"392",2020,1,411,128,153,"51.49337264","-0.09968067","Walworth Road, Elephant & Castle",281
"393",2020,1,412,51,42,"51.488105","-0.110121","Cleaver Street, Kennington",93
"394",2020,1,419,92,89,"51.485821","-0.149004","Chelsea Bridge, Pimlico",181
"395",2020,1,420,47,63,"51.504043","-0.105312","Southwark Station 1, Southwark",110
"396",2020,1,421,96,82,"51.504044","-0.104778","Southwark Station 2, Southwark",178
"397",2020,1,423,84,69,"51.49456127","-0.15393398","Eaton Square (South), Belgravia",153
"398",2020,1,424,70,58,"51.490491","-0.149186","Ebury Bridge, Pimlico",128
"399",2020,1,425,62,60,"51.533379","-0.139159","Harrington Square 2, Camden Town",122
"400",2020,1,426,77,69,"51.493072","-0.129925","Vincent Street, Pimlico",146
"401",2020,1,427,228,209,"51.51397065","-0.09294031","Cheapside, Bank",437
"402",2020,1,428,210,211,"51.499917","-0.174554","Exhibition Road, Knightsbridge",421
"403",2020,1,430,38,41,"51.48902","-0.17524","South Parade, Chelsea",79
"404",2020,1,431,38,43,"51.534474","-0.122203","Crinan Street, King's Cross",81
"405",2020,1,432,200,202,"51.496957","-0.173894","Exhibition Road Museums, South Kensington",402
"406",2020,1,433,119,100,"51.524564","-0.116279","Wren Street, Holborn",219
"407",2020,1,435,90,82,"51.488852","-0.105593","Kennington Station, Kennington",172
"408",2020,1,436,131,127,"51.51824","-0.11655","Red Lion Street, Holborn",258
"409",2020,1,437,71,71,"51.488124","-0.120903","Vauxhall Walk, Vauxhall",142
"410",2020,1,439,42,40,"51.5338","-0.118677","Killick Street, King's Cross",82
"411",2020,1,440,73,79,"51.483145","-0.113134","Kennington Oval, Oval",152
"412",2020,1,441,83,56,"51.495656","-0.114605","Sail Street, Vauxhall",139
"413",2020,1,442,32,31,"51.510101","-0.211358","Walmer Road, Avondale",63
"414",2020,1,443,89,80,"51.515256","-0.058641","Philpot Street, Whitechapel",169
"415",2020,1,444,92,84,"51.52568","-0.055312","Bethnal Green Garden, Bethnal Green",176
"416",2020,1,445,45,45,"51.52388","-0.065076","Cheshire Street, Bethnal Green",90
"417",2020,1,446,96,112,"51.528936","-0.055894","York Hall, Bethnal Green",208
"418",2020,1,447,17,18,"51.493381","-0.007542","Jubilee Crescent, Cubitt Town",35
"419",2020,1,448,93,88,"51.50623","-0.02296","Fisherman's Walk West, Canary Wharf",181
"420",2020,1,449,129,124,"51.511088","-0.057159","Shadwell Station, Shadwell",253
"421",2020,1,450,101,87,"51.515975","-0.053177","Jubilee Street, Stepney",188
"422",2020,1,451,100,102,"51.504719","-0.063531","Hermitage Court, Wapping",202
"423",2020,1,452,67,57,"51.505697","-0.070542","St. Katharine's Way, Tower",124
"424",2020,1,453,72,82,"51.508447","-0.055167","Garnet Street, Shadwell",154
"425",2020,1,454,40,42,"51.487679","-0.021582","Napier Avenue, Millwall",82
"426",2020,1,455,32,42,"51.49447","-0.014409","East Ferry Road, Cubitt Town",74
"427",2020,1,456,64,95,"51.538071","-0.144664","Parkway, Camden Town",159
"428",2020,1,457,107,126,"51.542138","-0.145393","Castlehaven Road, Camden Town",233
"429",2020,1,458,105,123,"51.504749","-0.057544","Wapping Lane, Wapping",228
"430",2020,1,459,112,120,"51.535179","-0.03338","Gunmakers Lane, Old Ford",232
"431",2020,1,460,79,69,"51.516196","-0.029138","Burdett Road, Mile End",148
"432",2020,1,461,79,75,"51.516","-0.038775","Aston Street, Stepney",154
"433",2020,1,462,98,111,"51.541603","-0.138853","Bonny Street, Camden Town",209
"434",2020,1,463,44,36,"51.534776","-0.071881","Thurtle Road, Haggerston",80
"435",2020,1,464,21,18,"51.51417","-0.052099","St. Mary & St. Michael Church, Stepney",39
"436",2020,1,465,120,102,"51.53558","-0.08249","Pitfield Street North,Hoxton",222
"437",2020,1,466,88,64,"51.534464","-0.076341","Whiston Road, Haggerston",152
"438",2020,1,467,68,42,"51.523538","-0.030556","Southern Grove, Bow",110
"439",2020,1,468,14,24,"51.521564","-0.022694","Cantrell Road, Bow",38
"440",2020,1,469,55,63,"51.513757","-0.020467","Lindfield Street, Poplar",118
"441",2020,1,470,67,65,"51.530535","-0.025492","Mostyn Grove, Bow",132
"442",2020,1,471,69,74,"51.533283","-0.028155","Hewison Street, Old Ford",143
"443",2020,1,472,15,13,"51.529452","-0.027616","Malmesbury Road, Bow",28
"444",2020,1,473,14,9,"51.496137","-0.019355","Millharbour, Millwall",23
"445",2020,1,475,29,20,"51.499041","-0.020157","Lightermans Road, Millwall",49
"446",2020,1,476,17,20,"51.489096","-0.009205","Stebondale Street, Cubitt Town",37
"447",2020,1,477,37,41,"51.49109","-0.018716","Spindrift Avenue, Millwall",78
"448",2020,1,478,162,158,"51.521889","-0.04667","Stepney Green Station, Stepney",320
"449",2020,1,479,136,133,"51.527152","-0.058005","Pott Street, Bethnal Green",269
"450",2020,1,480,182,177,"51.5128711","-0.0389866","Flamborough Street, Limehouse",359
"451",2020,1,481,101,121,"51.487129","-0.009001","Saunders Ness Road, Cubitt Town",222
"452",2020,1,483,85,73,"51.51328","-0.047784","Albert Gardens, Stepney",158
"453",2020,1,484,54,48,"51.528828","-0.013258","Bromley High Street, Bow",102
"454",2020,1,485,77,76,"51.531127","-0.048017","Old Ford Road, Bethnal Green",153
"455",2020,1,486,143,130,"51.525645","-0.069543","Granby Street, Shoreditch",273
"456",2020,1,487,19,29,"51.511811","-0.025626","Canton Street, Poplar",48
"457",2020,1,488,82,77,"51.506946","-0.058681","Reardon Street, Wapping",159
"458",2020,1,489,82,68,"51.513074","-0.064094","Christian Street, Whitechapel",150
"459",2020,1,490,24,35,"51.508622","-0.065006","Pennington Street, Wapping",59
"460",2020,1,491,69,68,"51.522507","-0.041378","Queen Mary's, Mile End",137
"461",2020,1,492,218,198,"51.525501","-0.032267204","Maplin Street, Mile End",416
"462",2020,1,494,2,2,"51.50196","-0.016251","South Quay East, Canary Wharf",4
"463",2020,1,495,110,75,"51.528169","-0.018703","Bow Church Station, Bow",185
"464",2020,1,496,61,60,"51.52512","-0.015578","Devons Road, Bow",121
"465",2020,1,497,40,50,"51.526149","-0.027396845","Merchant Street, Bow",90
"466",2020,1,498,57,48,"51.527058","-0.025296","Bow Road Station, Bow",105
"467",2020,1,499,114,102,"51.519265","-0.021345","Furze Green, Bow",216
"468",2020,1,500,148,145,"51.519806","-0.055731","Ansell House, Stepney",293
"469",2020,1,501,90,85,"51.522561","-0.054883","Cephas Street, Bethnal Green",175
"470",2020,1,502,115,120,"51.53341","-0.049591815","Bonner Gate, Victoria Park",235
"471",2020,1,503,218,223,"51.520893","-0.051394","Cleveland Way, Stepney",441
"472",2020,1,504,5,8,"51.496454","-0.009506","St. John's Park, Cubitt Town",13
"473",2020,1,505,55,62,"51.520398","-0.026768","Ackroyd Drive, Bow",117
"474",2020,1,506,73,76,"51.517475","-0.075855","Bell Lane, Liverpool Street",149
"475",2020,1,507,47,38,"51.528692","-0.059091","Clarkson Street, Bethnal Green",85
"476",2020,1,508,152,159,"51.519362","-0.074431","Fournier Street, Whitechapel",311
"477",2020,1,509,51,51,"51.517842","-0.090075","Fore Street, Guildhall",102
"478",2020,1,510,117,150,"51.509303","-0.025996","Westferry DLR, Limehouse",267
"479",2020,1,511,108,114,"51.511066","-0.053558","Sutton Street, Shadwell",222
"480",2020,1,512,175,150,"51.532091","-0.06142","Pritchard's Road, Bethnal Green",325
"481",2020,1,513,77,78,"51.5142228","-0.055656","Watney Market, Stepney",155
"482",2020,1,514,96,105,"51.516204","-0.155525","Portman Square, Marylebone",201
"483",2020,1,515,23,30,"51.500088","-0.211316","Russell Gardens, Olympia",53
"484",2020,1,516,57,60,"51.5112","-0.014438","Chrisp Street Market, Poplar",117
"485",2020,1,517,49,56,"51.532513","-0.033085","Ford Road, Old Ford",105
"486",2020,1,518,83,79,"51.528224","-0.037471","Antill Road, Mile End",162
"487",2020,1,519,5,5,"51.518811","-0.011662","Teviot Street, Poplar",10
"488",2020,1,520,96,78,"51.526041","-0.047218","Bancroft Road, Bethnal Green",174
"489",2020,1,521,100,110,"51.534137","-0.037366","Driffield Road, Old Ford",210
"490",2020,1,522,59,71,"51.525941","-0.036017","Clinton Road, Mile End",130
"491",2020,1,523,31,29,"51.51549","-0.013475","Langdon Park, Poplar",60
"492",2020,1,524,165,127,"51.511654","-0.179668","Lancaster Gate , Bayswater",292
"493",2020,1,526,30,21,"51.503143","-0.008428","Lancaster Drive, Blackwall",51
"494",2020,1,527,64,69,"51.503802","-0.215808","Hansard Mews, Holland Park",133
"495",2020,1,528,26,27,"51.507326","-0.145827","Clarges Street, Mayfair",53
"496",2020,1,529,75,86,"51.486892","-0.170983","Manresa Road, Chelsea",161
"497",2020,1,530,21,25,"51.508896","-0.012413","Newby Place, Poplar",46
"498",2020,1,531,138,111,"51.530326","-0.042744","Twig Folly Bridge, Mile End",249
"499",2020,1,532,59,50,"51.50357","-0.020068","Jubilee Plaza, Canary Wharf",109
"500",2020,1,533,96,97,"51.528222","-0.069743","Wellington Row, Bethnal Green",193
"501",2020,1,534,121,101,"51.531864","-0.066035","Goldsmith's Row, Haggerston",222
"502",2020,1,535,131,74,"51.537349","-0.147154","Gloucester Avenue, Camden Town",205
"503",2020,1,536,32,23,"51.53385","-0.06992","Queensbridge Road, Haggerston",55
"504",2020,1,537,103,111,"51.51793","-0.067937","Old Montague Street, Whitechapel",214
"505",2020,1,538,34,41,"51.508981","-0.00699","Naval Row, Blackwall",75
"506",2020,1,540,110,79,"51.528302","-0.144466","Albany Street, The Regent's Park",189
"507",2020,1,541,279,259,"51.506613","-0.142844","Green Park Station, Mayfair",538
"508",2020,1,542,66,65,"51.514115","-0.033828","Salmon Lane, Limehouse",131
"509",2020,1,543,29,17,"51.509591","-0.204666","Lansdowne Walk, Ladbroke Grove",46
"510",2020,1,544,64,57,"51.526153","-0.102208","Percival Street, Finsbury",121
"511",2020,1,545,49,65,"51.539957","-0.145246","Arlington Road, Camden Town",114
"512",2020,1,546,97,102,"51.517428","-0.107987","New Fetter Lane, Holborn",199
"513",2020,1,547,35,44,"51.509474","-0.002275","East India DLR, Blackwall",79
"514",2020,1,548,35,33,"51.498386","-0.107913","Westminster Bridge Road, Elephant & Castle",68
"515",2020,1,549,83,65,"51.49605","-0.104193","Gaywood  Street, Elephant & Castle",148
"516",2020,1,550,80,69,"51.521564","-0.039264","Harford Street, Mile End",149
"517",2020,1,551,52,63,"51.505772","-0.016460175","Import Dock, Canary Wharf",115
"518",2020,1,552,134,100,"51.511542","-0.056667","Watney Street, Shadwell",234
"519",2020,1,553,294,294,"51.535678","-0.062546","Regent's Row , Haggerston",588
"520",2020,1,554,34,27,"51.513548","-0.005659","Aberfeldy Street, Poplar",61
"521",2020,1,556,47,36,"51.502661","-0.021596","Heron Quays DLR, Canary Wharf",83
"522",2020,1,557,58,59,"51.51601","-0.0985","King Edward Street, St Pauls",117
"523",2020,1,558,103,101,"51.493978","-0.127554","Page Street, Westminster",204
"524",2020,1,559,37,34,"51.501391","-0.205991","Abbotsbury Road, Holland Park",71
"525",2020,1,560,45,33,"51.511624","-0.205921","Ladbroke Grove Central, Ladbroke Grove",78
"526",2020,1,561,40,38,"51.518369","-0.043371","Rectory Square, Stepney",78
"527",2020,1,562,89,79,"51.51746","-0.12335","Bury Place, Holborn",168
"528",2020,1,563,36,26,"51.499286","-0.009152","Preston's Road, Cubitt Town",62
"529",2020,1,564,209,233,"51.509943","-0.117619","Somerset House, Strand",442
"530",2020,1,565,50,40,"51.521905","-0.063386","Selby Street, Whitechapel",90
"531",2020,1,566,100,90,"51.509158","-0.224103","Westfield Ariel Way, White City",190
"532",2020,1,568,140,137,"51.51616","-0.18697","Bishop's Bridge Road West, Bayswater",277
"533",2020,1,569,89,67,"51.53213","-0.08299","Pitfield Street Central, Hoxton",156
"534",2020,1,570,108,91,"51.503083","-0.017676","Upper Bank Street, Canary Wharf",199
"535",2020,1,571,86,97,"51.506256","-0.218337","Westfield Southern Terrace ,Shepherd's Bush",183
"536",2020,1,572,139,129,"51.539099","-0.141728","Greenland Road, Camden Town",268
"537",2020,1,573,186,195,"51.485587","-0.18119","Limerston Street, West Chelsea",381
"538",2020,1,574,201,165,"51.53356","-0.09315","Eagle Wharf Road, Hoxton",366
"539",2020,1,576,28,23,"51.497304","-0.022793","Alpha Grove, Millwall",51
"540",2020,1,577,89,95,"51.528869","-0.047548","Globe Town Market, Bethnal Green",184
"541",2020,1,578,60,60,"51.527607","-0.057133","Hollybush Gardens, Bethnal Green",120
"542",2020,1,579,228,257,"51.511246","-0.093051","Queen Street 2, Bank",485
"543",2020,1,580,84,96,"51.48692917","-0.102996299","Doddington Grove, Kennington",180
"544",2020,1,581,79,92,"51.519167","-0.147983","New Cavendish Street, Marylebone",171
"545",2020,1,583,122,188,"51.497622","-0.125978","Abingdon Green, Westminster",310
"546",2020,1,584,113,85,"51.51244","-0.19096","Ilchester Gardens, Bayswater",198
"547",2020,1,586,30,30,"51.490645","-0.014582","Mudchute DLR, Cubitt Town",60
"548",2020,1,587,170,184,"51.50964","-0.08497","Monument Street, Monument",354
"549",2020,1,588,49,48,"51.52959","-0.0801","Hoxton Street, Hoxton",97
"550",2020,1,589,134,135,"51.487196","-0.179369","Drayton Gardens, West Chelsea",269
"551",2020,1,590,40,12,"51.53256","-0.16862","Greenberry Street, St.John's Wood",52
"552",2020,1,592,53,47,"51.5171","-0.18377","Bishop's Bridge Road East, Bayswater",100
"553",2020,1,593,45,44,"51.531066","-0.11934","Northdown Street, King's Cross",89
"554",2020,1,594,61,68,"51.513875","-0.117774","Kingsway Southbound, Strand",129
"555",2020,1,595,116,102,"51.493267","-0.21985","Hammersmith Road, Hammersmith",218
"556",2020,1,596,122,111,"51.472817","-0.199783","Parson's Green , Parson's Green",233
"557",2020,1,597,63,73,"51.473471","-0.20782","Fulham Park Road, Fulham",136
"558",2020,1,598,70,84,"51.494499","-0.228188","Southerton Road, Hammersmith",154
"559",2020,1,599,30,40,"51.485743","-0.223616","Manbre Road, Hammersmith",70
"560",2020,1,600,115,120,"51.481747","-0.124642","South Lambeth Road, Vauxhall",235
"561",2020,1,601,49,55,"51.514767","-0.225787","BBC White City, White City",104
"562",2020,1,602,91,71,"51.472993","-0.133972","Union Grove, Wandsworth Road",162
"563",2020,1,603,79,85,"51.477839","-0.116493","Caldwell Street, Stockwell",164
"564",2020,1,604,27,23,"51.538792","-0.138535","St Martins Close, Camden Town",50
"565",2020,1,605,67,56,"51.520331","-0.163667","Seymour Place, Marylebone",123
"566",2020,1,606,34,30,"51.504199","-0.210941","Addison Road, Holland Park",64
"567",2020,1,607,82,88,"51.468814","-0.210279","Putney Bridge Station, Fulham",170
"568",2020,1,608,11,10,"51.491093","-0.216493","Colet Gardens, Hammersmith",21
"569",2020,1,609,52,38,"51.46512358","-0.157788279","Sugden Road, Clapham",90
"570",2020,1,610,90,95,"51.48256792","-0.172078187","Danvers Street, West Chelsea",185
"571",2020,1,611,42,36,"51.50646524","-0.208486599","Princedale Road , Holland Park",78
"572",2020,1,612,89,68,"51.46925984","-0.141812513","Wandsworth Rd, Isley Court, Wandsworth Road",157
"573",2020,1,613,160,161,"51.50403821","-0.217400093","Woodstock Grove, Shepherd's Bush",321
"574",2020,1,614,31,32,"51.47817208","-0.144690541","Bradmead, Battersea Park",63
"575",2020,1,615,124,123,"51.4768851","-0.215895601","Finlay Street, Fulham",247
"576",2020,1,616,99,90,"51.48102131","-0.209973497","Aintree Street, Fulham",189
"577",2020,1,617,39,38,"51.47107905","-0.207842908","Elysium Place, Fulham",77
"578",2020,1,618,88,75,"51.47625965","-0.193254007","Eel Brook Common, Walham Green",163
"579",2020,1,619,64,59,"51.4737636","-0.197010096","Irene Road, Parsons Green",123
"580",2020,1,620,106,92,"51.47518024","-0.167160736","Surrey Lane, Battersea",198
"581",2020,1,621,93,107,"51.46086446","-0.187427294","Wandsworth Town Station, Wandsworth",200
"582",2020,1,622,96,85,"51.50748124","-0.205535908","Lansdowne Road, Ladbroke Grove",181
"583",2020,1,623,30,22,"51.46193072","-0.180791784","Nantes Close, Wandsworth",52
"584",2020,1,624,57,71,"51.4729184","-0.132102704","Courland Grove, Wandsworth Road",128
"585",2020,1,625,172,180,"51.47761941","-0.149551631","Queen's Circus, Battersea Park",352
"586",2020,1,626,132,143,"51.48438657","-0.20481514","Normand Park, West Kensington",275
"587",2020,1,627,34,30,"51.4687905","-0.158230901","Holden Street, Battersea",64
"588",2020,1,628,94,86,"51.46881971","-0.184318843","William Morris Way, Sands End",180
"589",2020,1,629,19,23,"51.45995384","-0.190184054","Morie Street, Wandsworth",42
"590",2020,1,630,49,35,"51.47073264","-0.126994068","Clarence Walk, Stockwell",84
"591",2020,1,631,105,90,"51.4795017","-0.141770709","Battersea Park Road, Nine Elms",195
"592",2020,1,632,64,68,"51.47053858","-0.163041605","Sheepcote Lane, Battersea",132
"593",2020,1,633,89,100,"51.48959104","-0.209378594","Vereker Road, West Kensington",189
"594",2020,1,634,50,49,"51.49434708","-0.215804559","Brook Green South, Brook Green",99
"595",2020,1,635,136,126,"51.48606206","-0.214428378","Greyhound Road, Hammersmith",262
"596",2020,1,636,66,63,"51.46706414","-0.193502076","South Park, Sands End",129
"597",2020,1,637,25,21,"51.45787019","-0.174691623","Spencer Park, Wandsworth Common",46
"598",2020,1,638,158,163,"51.46663393","-0.169821175","Falcon Road, Clapham Junction",321
"599",2020,1,639,97,110,"51.48357068","-0.202038682","Coomer Place, West Kensington",207
"600",2020,1,640,56,70,"51.47286577","-0.148059277","Silverthorne Road, Battersea",126
"601",2020,1,641,102,107,"51.49824168","-0.117495865","Archbishop's Park, Waterloo",209
"602",2020,1,642,23,28,"51.46916161","-0.174485792","Fawcett Close, Battersea",51
"603",2020,1,643,44,37,"51.5190427","-0.204764421","All Saints' Road, Portobello",81
"604",2020,1,644,69,74,"51.48373225","-0.223852256","Rainville Road, Hammersmith",143
"605",2020,1,645,66,58,"51.50173215","-0.100292412","Great Suffolk Street, The Borough",124
"606",2020,1,646,140,168,"51.49886563","-0.137424571","Buckingham Gate, Westminster",308
"607",2020,1,647,79,82,"51.50035306","-0.217515071","Richmond Way, Shepherd's Bush",161
"608",2020,1,648,35,32,"51.46904022","-0.19627483","Peterborough Road, Sands End",67
"609",2020,1,649,78,75,"51.48180515","-0.18027465","World's End Place, West Chelsea",153
"610",2020,1,650,64,74,"51.51687069","-0.213872396","St. Mark's Road, North Kensington",138
"611",2020,1,651,63,51,"51.48089844","-0.183853573","Thorndike Close, West Chelsea",114
"612",2020,1,652,28,23,"51.51148696","-0.218190203","Evesham Street, Avondale",51
"613",2020,1,653,92,98,"51.47084722","-0.17070367","Simpson Street, Clapham Junction",190
"614",2020,1,654,75,74,"51.48267821","-0.117661574","Ashmole Estate, Oval",149
"615",2020,1,655,54,63,"51.48294452","-0.219346128","Crabtree Lane, Fulham",117
"616",2020,1,656,44,43,"51.46841875","-0.199135704","Broomhouse Lane, Parsons Green",87
"617",2020,1,657,54,44,"51.4996806","-0.221791552","Blythe Road West, Shepherd's Bush",98
"618",2020,1,658,176,170,"51.47729232","-0.16478637","Ethelburga Estate, Battersea Park",346
"619",2020,1,659,81,73,"51.511934","-0.10307894","Blackfriars Station, St. Paul's",154
"620",2020,1,660,46,45,"51.49087074","-0.206029743","West Kensington Station, West Kensington",91
"621",2020,1,661,179,163,"51.51632095","-0.202608612","All Saints Church, Portobello",342
"622",2020,1,662,86,90,"51.48498496","-0.167919869","Phene Street, Chelsea",176
"623",2020,1,663,47,47,"51.51323001","-0.211593602","Clarendon Road, Avondale",94
"624",2020,1,664,93,83,"51.474376","-0.155442787","Austin Road, Battersea Park",176
"625",2020,1,665,73,87,"51.46108367","-0.191722864","Smugglers Way, Wandsworth",160
"626",2020,1,666,66,52,"51.49610093","-0.208158259","Olympia Way, Olympia",118
"627",2020,1,667,80,77,"51.5015946","-0.222293381","Shepherd's Bush Road North, Shepherd's Bush",157
"628",2020,1,668,59,71,"51.49422354","-0.236769936","Ravenscourt Park Station, Hammersmith",130
"629",2020,1,669,22,39,"51.47614939","-0.1232585","Teversham Lane, Stockwell",61
"630",2020,1,670,79,77,"51.46718562","-0.152248582","Ashley Crescent, Battersea",156
"631",2020,1,671,134,149,"51.475089","-0.201968","Parsons Green Station, Parsons Green",283
"632",2020,1,673,94,106,"51.46517078","-0.18038939","Hibbert Street, Battersea",200
"633",2020,1,674,60,36,"51.53546778","-0.11619105","Carnegie Street, King's Cross",96
"634",2020,1,675,90,78,"51.46348914","-0.182126248","Usk Road, Clapham Junction",168
"635",2020,1,676,103,111,"51.47787084","-0.126874471","Hartington Road, Stockwell",214
"636",2020,1,677,41,31,"51.46866929","-0.146544642","Heath Road, Battersea",72
"637",2020,1,678,25,26,"51.46231278","-0.211468596","Esmond Street, Putney",51
"638",2020,1,679,57,53,"51.47453545","-0.170210533","Orbel Street, Battersea",110
"639",2020,1,680,133,135,"51.47768469","-0.170329317","Westbridge Road, Battersea",268
"640",2020,1,681,105,101,"51.47303687","-0.214749808","Bishop's Avenue, Fulham",206
"641",2020,1,682,154,144,"51.48810829","-0.22660621","Crisp Road, Hammersmith",298
"642",2020,1,683,70,46,"51.46506424","-0.163750945","Dorothy Road, Clapham Junction",116
"643",2020,1,684,57,48,"51.45475251","-0.195197203","Neville Gill Close, Wandsworth",105
"644",2020,1,685,95,91,"51.46067005","-0.198735357","Osiers Road, Wandsworth",186
"645",2020,1,686,68,63,"51.48814438","-0.222456468","Beryl Road, Hammersmith",131
"646",2020,1,687,78,77,"51.49760804","-0.21145598","Maclise Road, Olympia",155
"647",2020,1,688,46,30,"51.46095151","-0.20066766","Northfields, Wandsworth",76
"648",2020,1,689,29,13,"51.45922541","-0.180884959","Spanish Road, Clapham Junction",42
"649",2020,1,690,42,43,"51.47047503","-0.152130083","Stanley Grove, Battersea",85
"650",2020,1,691,86,114,"51.47946386","-0.195777222","Erin Close, Walham Green",200
"651",2020,1,692,121,100,"51.54211855","-0.028941601","Cadogan Close, Victoria Park",221
"652",2020,1,693,36,55,"51.464786","-0.215618902","Felsham Road, Putney",91
"653",2020,1,694,39,38,"51.46071722","-0.216526155","Putney Rail Station, Putney",77
"654",2020,1,695,241,233,"51.53638435","-0.102757578","Islington Green, Angel",474
"655",2020,1,696,67,70,"51.48728535","-0.217995921","Charing Cross Hospital, Hammersmith",137
"656",2020,1,697,62,44,"51.53639219","-0.112721065","Charlotte Terrace, Angel",106
"657",2020,1,698,105,90,"51.53908372","-0.070329419","Shoreditch Court, Haggerston",195
"658",2020,1,699,51,39,"51.5366541","-0.07023031","Belford House, Haggerston",90
"659",2020,1,700,87,89,"51.47696496","-0.174347066","Battersea Church Road, Battersea",176
"660",2020,1,701,135,126,"51.47287627","-0.176267008","Vicarage Crescent, Battersea",261
"661",2020,1,702,115,110,"51.52868155","-0.065550321","Durant Street, Bethnal Green",225
"662",2020,1,703,111,142,"51.51505991","-0.10534448","St. Bride Street, Holborn",253
"663",2020,1,704,29,18,"51.45682071","-0.202802098","Mexfield Road, East Putney",47
"664",2020,1,705,35,34,NA,NA,NA,69
"665",2020,1,706,107,123,"51.50215353","-0.083632928","Snowsfields, London Bridge",230
"666",2020,1,707,122,112,"51.49021762","-0.215087092","Barons Court Station, West Kensington",234
"667",2020,1,708,64,50,"51.46161068","-0.21614583","Disraeli Road, Putney",114
"668",2020,1,709,57,58,"51.46321128","-0.215550761","Montserrat Road , Putney",115
"669",2020,1,710,110,112,"51.47439218","-0.163347594","Albert Bridge Road, Battersea Park",222
"670",2020,1,711,66,64,"51.48335692","-0.216305546","Everington Street, Fulham",130
"671",2020,1,712,133,133,"51.51854104","-0.034903714","Mile End Stadium, Mile End",266
"672",2020,1,713,32,44,"51.54100708","-0.14326094","Hawley Crescent, Camden Town",76
"673",2020,1,714,55,46,"51.47311696","-0.137235175","Stewart's Road, Wandsworth Road",101
"674",2020,1,715,76,49,"51.51563007","-0.049067243","Aylward Street, Stepney",125
"675",2020,1,716,71,54,"51.51542791","-0.02356501","Stainsby Road , Poplar",125
"676",2020,1,717,234,205,"51.53658514","-0.075885686","Dunston Road , Haggerston",439
"677",2020,1,718,70,107,"51.53571683","-0.060291813","Ada Street, Hackney Central",177
"678",2020,1,719,166,142,"51.53642464","-0.054162264","Victoria Park Road, Hackney Central",308
"679",2020,1,720,81,65,"51.48724429","-0.205279052","Star Road, West Kensington",146
"680",2020,1,721,58,52,"51.53603947","-0.026262677","Wendon Street, Old Ford",110
"681",2020,1,722,66,56,"51.52458353","-0.058631453","Finnis Street, Bethnal Green",122
"682",2020,1,723,145,135,"51.46822047","-0.190346493","Stephendale Road, Sands End",280
"683",2020,1,724,32,30,"51.45799126","-0.184806157","Alma Road, Wandsworth",62
"684",2020,1,725,112,107,"51.491327","-0.096518684","Walworth Square, Walworth",219
"685",2020,1,726,93,90,"51.47505096","-0.150908371","Alfreda Street, Battersea Park",183
"686",2020,1,727,129,110,"51.47569809","-0.20587627","Chesilton Road, Fulham",239
"687",2020,1,728,35,38,"51.46199911","-0.206240805","Putney Bridge Road, East Putney",73
"688",2020,1,729,104,111,"51.47893931","-0.208485293","St. Peter's Terrace, Fulham",215
"689",2020,1,730,67,72,"51.49208492","-0.229116862","Bridge Avenue, Hammersmith",139
"690",2020,1,731,69,72,"51.47727637","-0.189210466","Michael Road, Walham Green",141
"691",2020,1,732,239,294,"51.50630441","-0.087262995","Duke Street Hill, London Bridge",533
"692",2020,1,733,85,87,"51.50542628","-0.150817316","Park Lane, Mayfair",172
"693",2020,1,734,51,41,"51.46230566","-0.175407201","Plough Terrace, Clapham Junction",92
"694",2020,1,735,77,84,"51.46489445","-0.17302926","Grant Road East, Clapham Junction",161
"695",2020,1,736,37,51,"51.50659035","-0.216104479","Queensdale Road, Shepherd's Bush",88
"696",2020,1,737,290,318,"51.47993289","-0.19411695","Fulham Broadway, Walham Green",608
"697",2020,1,738,81,64,"51.47514228","-0.187278987","Imperial Road, Sands End",145
"698",2020,1,739,86,85,"51.48176572","-0.185273723","Hortensia Road, West Brompton",171
"699",2020,1,740,24,34,"51.51092871","-0.214594781","Sirdar Road, Avondale",58
"700",2020,1,741,27,28,"51.5129814","-0.219486603","Freston Road, Avondale",55
"701",2020,1,742,75,86,"51.51510818","-0.208565479","Blenheim Crescent, Ladbroke Grove",161
"702",2020,1,743,19,20,"51.46079243","-0.212607684","Oxford Road, Putney",39
"703",2020,1,744,11,23,"51.46745485","-0.172293499","Ingrave Street, Clapham Junction",34
"704",2020,1,745,37,50,"51.47816972","-0.18243547","Upcerne Road, West Chelsea",87
"705",2020,1,746,65,67,"51.4795738","-0.17903854","Lots Road, West Chelsea",132
"706",2020,1,747,85,76,"51.48796408","-0.161765173","Ormonde Gate, Chelsea",161
"707",2020,1,748,126,97,"51.53727795","-0.079201849","Hertford Road, De Beauvoir Town",223
"708",2020,1,749,113,114,"51.53932857","-0.074284675","Haggerston Road, Haggerston",227
"709",2020,1,750,36,42,"51.4710956","-0.157850096","Culvert Road, Battersea",78
"710",2020,1,751,54,48,"51.51612862","-0.120909408","Newton Street, Covent Garden",102
"711",2020,1,754,43,38,"51.5129006","-0.214762686","Grenfell Road, Avondale",81
"712",2020,1,755,119,137,"51.48512191","-0.174971902","The Vale, Chelsea",256
"713",2020,1,756,84,92,"51.47515398","-0.159169801","Prince of Wales Drive, Battersea Park",176
"714",2020,1,757,78,60,"51.48795853","-0.187404506","Harcourt Terrace, West Brompton",138
"715",2020,1,758,63,67,"51.51787005","-0.201005397","Westbourne Park Road, Portobello",130
"716",2020,1,759,24,12,"51.52456169","-0.165668686","Broadley Terrace, Marylebone",36
"717",2020,1,760,43,28,"51.52526975","-0.163795009","Rossmore Road, Marylebone",71
"718",2020,1,761,94,95,"51.48321729","-0.211860644","Humbolt Road, Fulham",189
"719",2020,1,762,66,81,"51.50070305","-0.129698963","Storey's Gate, Westminster",147
"720",2020,1,763,60,64,"51.52059714","-0.032566533","Mile End Park Leisure Centre, Mile End",124
"721",2020,1,764,83,113,"51.46239255","-0.16829214","St. John's Road, Clapham Junction",196
"722",2020,1,765,52,47,"51.46760141","-0.20682737","Ranelagh Gardens, Fulham",99
"723",2020,1,766,123,124,"51.45752945","-0.192165613","Ram Street, Wandsworth",247
"724",2020,1,767,15,8,"51.45705988","-0.200806304","Santos Road, Wandsworth",23
"725",2020,1,768,90,95,"51.46134382","-0.159322467","Clapham Common North Side, Clapham Common",185
"726",2020,1,769,87,96,"51.473611","-0.191803","Sandilands Road, Walham Green",183
"727",2020,1,770,69,60,"51.491026","-0.209121","Gwendwr Road, West Kensington",129
"728",2020,1,771,29,40,"51.509224","-0.216016","Rifle Place, Avondale",69
"729",2020,1,772,144,136,"51.47250956","-0.122831913","Binfield Road, Stockwell",280
"730",2020,1,773,85,103,"51.511891","-0.107349","Tallis Street, Temple",188
"731",2020,1,774,24,21,"51.470131","-0.20464","Hurlingham Park, Parsons Green",45
"732",2020,1,775,38,42,"51.496664","-0.223868","Little Brook Green, Brook Green",80
"733",2020,1,776,59,49,"51.460333","-0.167029","Abyssinia Close, Clapham Junction",108
"734",2020,1,777,22,21,"51.4619230679","-0.165297856693","Limburg Road, Clapham Junction",43
"735",2020,1,779,79,79,"51.514449","-0.077178979","Houndsditch, Aldgate",158
"736",2020,1,780,151,156,"51.474665","-0.18316517","Imperial Wharf Station, Sands End",307
"737",2020,1,781,116,109,"51.495898","-0.173009","Victoria & Albert Museum, South Kensington",225
"738",2020,1,782,110,112,"51.483911","-0.19760944","Halford Road, West Kensington",222
"739",2020,1,783,143,147,"51.5403115","-0.021630359","Monier Road, Hackney Wick",290
"740",2020,1,784,110,110,"51.546326","-0.00993526","East Village, Queen Elizabeth Olympic Park",220
"741",2020,1,785,391,366,"51.54094","-0.010510565","Aquatic Centre, Queen Elizabeth Olympic Park",757
"742",2020,1,786,118,136,"51.549369","-0.015717614","Lee Valley VeloPark, Queen Elizabeth Olympic Park",254
"743",2020,1,787,114,102,"51.546805","-0.01469126","Timber Lodge, Queen Elizabeth Olympic Park",216
"744",2020,1,789,151,156,"51.538718","-0.011889482","Podium, Queen Elizabeth Olympic Park",307
"745",2020,1,790,137,125,"51.541793","-0.00481","Stratford Station, Stratford",262
"746",2020,1,792,79,72,"51.505461","-0.10454093","Blackfriars Road, Southwark",151
"747",2020,1,793,41,42,"51.528279","-0.11955857","Cromer Street, Bloomsbury",83
"748",2020,1,794,30,35,NA,NA,NA,65
"749",2020,1,795,56,46,"51.527068","-0.13186102","Euston Square Gardens, Euston",102
"750",2020,1,796,64,72,"51.524","-0.12640984","Coram Street, Bloomsbury",136
"751",2020,1,797,92,96,"51.5293","-0.12827903","Ossulston Street, Somers Town",188
"752",2020,1,798,148,160,"51.5301998755","-0.122299440803","Birkenhead Street, King's Cross",308
"753",2020,1,799,45,58,"51.4976984561","-0.137598896295","Kings Gate House, Westminster",103
"754",2020,1,800,136,132,"51.4811219398","-0.149035374873","Sopwith Way, Battersea Park",268
"755",2020,1,801,101,109,"51.5052241745","-0.0980318118664","Lavington Street, Bankside",210
"756",2020,1,802,78,73,"51.4765900593","-0.118256789081","Albert Square, Stockwell",151
"757",2020,1,803,70,78,"51.5054099403","-0.0983410884509","Southwark Street, Bankside",148
"758",2020,1,804,157,161,"51.5346677396","-0.125078652873","Good's Way, King's Cross",318
"759",2020,1,806,54,59,"51.5372405623","-0.124807385707","Handyside Street, King's Cross",113
"760",2020,1,807,101,101,"51.5212","-0.20888818","Bevington Road West, North Kensington",202
"761",2020,1,808,52,48,NA,NA,NA,100
"762",2020,1,809,54,52,"51.5162778834","-0.118272991635","Lincoln's Inn Fields, Holborn",106
"763",2020,1,810,126,139,"51.5067252868","-0.0988072461627","Tate Modern, Bankside",265
"764",2020,1,811,127,163,"51.5057030357","-0.0277727426235","Westferry Circus, Canary Wharf",290
"765",2020,1,812,21,31,"51.5487311915","-0.0226065549321","Here East North, Queen Elizabeth Olympic Park",52
"766",2020,1,813,61,81,"51.4878074485","-0.122759625866","New Spring Gardens Walk, Vauxhall",142
"767",2020,1,814,68,57,"51.4714330677","-0.123670735702","Clapham Road, Lingham Street, Stockwell",125
"768",2020,1,815,107,133,"51.5000891978","-0.116628700672","Lambeth Palace Road, Waterloo",240
"769",2020,1,816,35,42,"51.5465327935","-0.0205975904647","Here East South, Queen Elizabeth Olympic Park",77
"770",2020,1,817,100,91,"51.4813354746","-0.138212295869","Riverlight South, Nine Elms",191
"771",2020,1,818,267,299,"51.501513","-0.12382322","Westminster Pier, Westminster",566
"772",2020,1,819,58,60,"51.50621","-0.114842","Belvedere Road 2, South Bank",118
"773",2020,1,820,55,47,"51.492807","-0.091938","Victory Place, Walworth",102
"774",2020,1,821,241,203,"51.4835074867","-0.147714557371","Battersea Power Station, Battersea Park",444
"775",2020,1,826,214,190,"51.496863","-0.1429434","Allington Street, Victoria",404
"776",2020,1,827,121,126,"51.479601","-0.11147178","Cranmer Road, Stockwell",247
"777",2020,1,828,74,70,"51.473874","-0.11258096","Normandy Road, Stockwell",144
"778",2020,1,829,46,32,"51.469217","-0.11268674","Wynne Road, Stockwell",78
"779",2020,1,830,56,44,"51.469202","-0.11902256","Sidney Road, Stockwell",100
"780",2020,1,831,30,43,"51.466232","-0.11317995","St John's Crescent, Brixton",73
"781",2020,1,832,99,115,"51.464019","-0.11578197","Ferndale Road, Brixton",214
"782",2020,1,833,88,88,"51.460232","-0.11537509","Saltoun Road, Brixton",176
"783",2020,1,834,78,95,"51.477966","-0.14785703","Gas Holders, Battersea Park",173
"784",2020,1,835,68,64,"51.516785","-0.10494775","Farringdon Street, Holborn",132
"785",2020,1,836,80,64,"51.541596","-0.12544145","York Way, Kings Cross",144
"786",2020,1,838,58,57,"51.518093","-0.0914017","Fore Street Avenue, Guildhall",115
"787",2020,1,839,175,171,"51.508033","-0.10682363","Sea Containers, South Bank",346
"788",2020,2,1,163,120,"51.52916347","-0.109970527","River Street , Clerkenwell",283
"789",2020,2,2,233,260,"51.49960695","-0.197574246","Phillimore Gardens, Kensington",493
"790",2020,2,3,259,296,"51.52128377","-0.084605692","Christopher Street, Liverpool Street",555
"791",2020,2,4,126,149,"51.53005939","-0.120973687","St. Chad's Street, King's Cross",275
"792",2020,2,5,327,398,"51.49313","-0.156876","Sedding Street, Sloane Square",725
"793",2020,2,6,226,250,"51.51811784","-0.144228881","Broadcasting House, Marylebone",476
"794",2020,2,7,125,107,"51.53430039","-0.1680743","Charlbert Street, St. John's Wood",232
"795",2020,2,8,155,119,"51.529857","-0.18348604","Maida Vale, Maida Vale",274
"796",2020,2,9,215,246,"51.5073853","-0.096440751","New Globe Walk, Bankside",461
"797",2020,2,10,88,94,"51.50597426","-0.092754157","Park Street, Bankside",182
"798",2020,2,11,253,200,"51.52395143","-0.122502346","Brunswick Square, Bloomsbury",453
"799",2020,2,12,408,404,"51.52168078","-0.130431727","Malet Street, Bloomsbury",812
"800",2020,2,13,172,173,"51.51991453","-0.136039674","Scala Street, Fitzrovia",345
"801",2020,2,14,1620,1584,"51.52994371","-0.123616824","Belgrove Street , King's Cross",3204
"802",2020,2,15,246,230,"51.51772703","-0.127854211","Great Russell Street, Bloomsbury",476
"803",2020,2,16,273,237,"51.52635795","-0.125979294","Cartwright Gardens , Bloomsbury",510
"804",2020,2,17,401,426,"51.5216612","-0.109006325","Hatton Wall, Holborn",827
"805",2020,2,18,415,406,"51.51477076","-0.12221963","Drury Lane, Covent Garden",821
"806",2020,2,19,241,216,"51.52505093","-0.131161087","Taviton Street, Bloomsbury",457
"807",2020,2,20,183,139,"51.527326","-0.13605286","Drummond Street , Euston",322
"808",2020,2,21,70,60,"51.53007835","-0.13884627","Hampstead Road (Cartmel), Euston",130
"809",2020,2,22,284,292,"51.5222641","-0.114079481","Northington Street , Holborn",576
"810",2020,2,23,193,187,"51.51943538","-0.119123345","Red Lion Square, Holborn",380
"811",2020,2,24,241,298,"51.51908011","-0.124678402","British Museum, Bloomsbury",539
"812",2020,2,25,396,381,"51.5288338","-0.132250369","Doric Way , Somers Town",777
"813",2020,2,26,168,132,"51.52728093","-0.11829517","Ampton Street , Clerkenwell",300
"814",2020,2,27,299,326,"51.51382102","-0.107927706","Bouverie Street, Temple",625
"815",2020,2,28,266,229,"51.52351808","-0.143613641","Bolsover Street, Fitzrovia",495
"816",2020,2,29,220,197,"51.513735","-0.193487","Hereford Road, Bayswater",417
"817",2020,2,30,264,235,"51.52915444","-0.093421615","Windsor Terrace, Hoxton",499
"818",2020,2,31,163,183,"51.52953709","-0.083353323","Fanshaw Street, Hoxton",346
"819",2020,2,32,457,503,"51.52469624","-0.084439283","Leonard Circus , Shoreditch",960
"820",2020,2,33,195,207,"51.5156","-0.070056","Central House, Aldgate",402
"821",2020,2,34,150,148,"51.5341235","-0.129386874","Pancras Road, King's Cross",298
"822",2020,2,36,193,183,"51.50173726","-0.184980612","De Vere Gardens, Kensington",376
"823",2020,2,37,233,230,"51.49159394","-0.192369256","Penywern Road, Earl's Court",463
"824",2020,2,38,131,121,"51.4973875","-0.197245586","Abingdon Villas, Kensington",252
"825",2020,2,39,480,471,"51.5263778","-0.078130921","Shoreditch High Street, Shoreditch",951
"826",2020,2,40,168,174,"51.52127071","-0.0755789","Commercial Street, Shoreditch",342
"827",2020,2,41,398,439,"51.520955","-0.083493552","Pindar Street, Liverpool Street",837
"828",2020,2,42,262,194,"51.53099181","-0.093903825","Wenlock Road , Hoxton",456
"829",2020,2,43,270,273,"51.52026","-0.157183945","Crawford Street, Marylebone",543
"830",2020,2,44,161,162,"51.51073687","-0.144165239","Bruton Street, Mayfair",323
"831",2020,2,45,380,293,"51.522511","-0.162298","Boston Place, Marylebone",673
"832",2020,2,46,470,475,"51.507131","-0.06691","Nesham Street, Wapping",945
"833",2020,2,47,210,209,"51.52334476","-0.183846408","Warwick Avenue Station, Maida Vale",419
"834",2020,2,48,400,467,"51.51248445","-0.099141408","Godliman Street, St. Paul's",867
"835",2020,2,49,122,154,"51.50706909","-0.145904427","Curzon Street, Mayfair",276
"836",2020,2,50,209,222,"51.52867339","-0.087459376","East Road, Hoxton",431
"837",2020,2,51,182,175,"51.52671796","-0.104298194","Finsbury Library , Finsbury",357
"838",2020,2,52,210,225,"51.52295439","-0.094934859","Roscoe Street, St. Luke's",435
"839",2020,2,53,109,137,"51.5099923","-0.143495266","Grafton Street, Mayfair",246
"840",2020,2,54,198,261,"51.52174785","-0.094475072","Golden Lane, Barbican",459
"841",2020,2,55,586,766,"51.51707521","-0.086685542","Finsbury Circus, Liverpool Street",1352
"842",2020,2,56,186,188,"51.52058381","-0.154701411","Paddington Street, Marylebone",374
"843",2020,2,57,282,280,"51.52334672","-0.120202614","Guilford Street , Bloomsbury",562
"844",2020,2,58,352,360,"51.52452699","-0.079248081","New Inn Yard, Shoreditch",712
"845",2020,2,60,116,91,"51.52644828","-0.172190727","Lisson Grove, St. John's Wood",207
"846",2020,2,61,166,162,"51.49738251","-0.089446947","Great Dover Street, The Borough",328
"847",2020,2,62,108,84,"51.4907579","-0.106323685","Cotton Garden Estate, Kennington",192
"848",2020,2,63,142,113,"51.53089041","-0.089782579","Murray Grove , Hoxton",255
"849",2020,2,64,401,480,"51.50946212","-0.124749274","William IV Street, Strand",881
"850",2020,2,65,176,149,NA,NA,NA,325
"851",2020,2,66,648,1046,"51.51795029","-0.108657431","Holborn Circus, Holborn",1694
"852",2020,2,67,373,275,"51.51882555","-0.108028472","Hatton Garden, Holborn",648
"853",2020,2,68,324,320,"51.52059681","-0.116688468","Theobald's Road , Holborn",644
"854",2020,2,69,201,183,"51.5262363","-0.134407652","Euston Road, Euston",384
"855",2020,2,70,117,74,"51.53136059","-0.117069978","Calshot Street , King's Cross",191
"856",2020,2,71,509,601,"51.5154186","-0.098850915","Newgate Street , St. Paul's",1110
"857",2020,2,72,176,186,"51.52352001","-0.108340165","Farringdon Lane, Clerkenwell",362
"858",2020,2,73,463,453,"51.52572618","-0.088486188","Old Street Station, St. Luke's",916
"859",2020,2,74,485,479,"51.48591714","-0.124469948","Vauxhall Cross, Vauxhall",964
"860",2020,2,75,235,214,"51.53219984","-0.105480698","Torrens Street, Angel",449
"861",2020,2,76,80,86,"51.52559505","-0.144083893","Longford Street, The Regent's Park",166
"862",2020,2,77,242,230,"51.52341837","-0.124121774","Russell Square Station, Bloomsbury",472
"863",2020,2,78,253,246,"51.52486887","-0.099489485","Sadlers Sports Centre, Finsbury",499
"864",2020,2,79,121,142,"51.511726","-0.11385596","Arundel Street, Temple",263
"865",2020,2,80,195,168,"51.50069361","-0.102091246","Webber Street , Southwark",363
"866",2020,2,81,249,251,"51.52025302","-0.141327271","Great Titchfield Street, Fitzrovia",500
"867",2020,2,82,148,153,"51.514274","-0.111257","Chancery Lane, Holborn",301
"868",2020,2,83,233,242,"51.50963938","-0.131510949","Panton Street, West End",475
"869",2020,2,84,150,166,"51.51593725","-0.111778348","Breams Buildings, Holborn",316
"870",2020,2,85,301,312,"51.50064702","-0.078600401","Tanner Street, Bermondsey",613
"871",2020,2,86,146,124,"51.48947903","-0.115156562","Sancroft Street, Vauxhall",270
"872",2020,2,87,290,288,"51.51646835","-0.079684557","Devonshire Square, Liverpool Street",578
"873",2020,2,88,318,373,"51.51858757","-0.132053392","Bayley Street , Bloomsbury",691
"874",2020,2,89,228,208,"51.5262503","-0.123509611","Tavistock Place, Bloomsbury",436
"875",2020,2,90,48,55,"51.53301907","-0.139174593","Harrington Square 1, Camden Town",103
"876",2020,2,91,166,139,"51.49368637","-0.111014912","Walnut Tree Walk, Vauxhall",305
"877",2020,2,92,160,182,"51.49889832","-0.100440521","Borough Road, Elephant & Castle",342
"878",2020,2,93,206,107,"51.53440868","-0.109025404","Cloudesley Road, Angel",313
"879",2020,2,94,270,252,"51.49506109","-0.085814489","Bricklayers Arms, Borough",522
"880",2020,2,95,404,411,"51.5208417","-0.097340162","Aldersgate Street, Barbican",815
"881",2020,2,96,149,153,"51.53095071","-0.078505384","Falkirk Street, Hoxton",302
"882",2020,2,97,233,222,"51.49792478","-0.183834706","Gloucester Road (North), Kensington",455
"883",2020,2,98,240,204,"51.52554222","-0.138231303","Hampstead Road, Euston",444
"884",2020,2,99,320,331,"51.51457763","-0.158264483","Old Quebec Street, Marylebone",651
"885",2020,2,100,175,175,"51.49043573","-0.122806861","Albert Embankment, Vauxhall",350
"886",2020,2,101,647,692,"51.51155322","-0.0929401","Queen Street 1, Bank",1339
"887",2020,2,102,297,320,"51.51340693","-0.076793375","Jewry Street, Aldgate",617
"888",2020,2,103,106,95,"51.50472376","-0.192538767","Vicarage Gate, Kensington",201
"889",2020,2,104,693,753,"51.51159481","-0.077121322","Crosswall, Tower",1446
"890",2020,2,105,210,205,"51.51552971","-0.190240716","Westbourne Grove, Bayswater",415
"891",2020,2,106,129,134,"51.51410514","-0.147301667","Woodstock Street, Mayfair",263
"892",2020,2,107,510,505,"51.52600832","-0.096317627","Finsbury Leisure Centre, St. Luke's",1015
"893",2020,2,108,282,360,"51.49812559","-0.132102166","Abbey Orchard Street, Westminster",642
"894",2020,2,109,515,599,"51.51563144","-0.132328837","Soho Square , Soho",1114
"895",2020,2,110,123,99,"51.53304322","-0.172528678","Wellington Road, St. John's Wood",222
"896",2020,2,111,284,295,"51.5100172","-0.157275636","Park Lane , Hyde Park",579
"897",2020,2,112,191,217,"51.51580998","-0.105270275","Stonecutter Street, Holborn",408
"898",2020,2,113,163,156,"51.49646288","-0.183289032","Gloucester Road (Central), South Kensington",319
"899",2020,2,114,222,213,"51.52451738","-0.158963647","Park Road (Baker Street), The Regent's Park",435
"900",2020,2,115,355,390,"51.51423368","-0.073537654","Braham Street, Aldgate",745
"901",2020,2,116,357,411,"51.51449962","-0.141423695","Little Argyll Street, West End",768
"902",2020,2,117,261,253,"51.49288067","-0.114934001","Lollard Street, Vauxhall",514
"903",2020,2,118,162,193,"51.49582705","-0.13547809","Rochester Row, Westminster",355
"904",2020,2,119,414,414,"51.52589324","-0.090847761","Bath Street, St. Luke's",828
"905",2020,2,120,202,203,"51.51573534","-0.093080779","The Guildhall, Guildhall",405
"906",2020,2,121,254,303,"51.51891348","-0.156166631","Baker Street, Marylebone",557
"907",2020,2,122,265,303,"51.52111369","-0.078869751","Norton Folgate, Liverpool Street",568
"908",2020,2,123,135,107,"51.52836014","-0.104724625","St. John Street, Finsbury",242
"909",2020,2,124,87,82,"51.49654462","-0.150905245","Eaton Square, Belgravia",169
"910",2020,2,125,213,245,"51.50069491","-0.094524319","Borough High Street, The Borough",458
"911",2020,2,126,371,377,"51.51782144","-0.096496865","Museum of London, Barbican",748
"912",2020,2,127,198,211,"51.51700801","-0.09388536","Wood Street, Guildhall",409
"913",2020,2,128,157,154,"51.49536226","-0.185296516","Emperor's Gate, South Kensington",311
"914",2020,2,129,240,264,"51.5118973","-0.137043852","Golden Square, Soho",504
"915",2020,2,130,303,360,"51.50950627","-0.075459482","Tower Gardens , Tower",663
"916",2020,2,131,156,129,"51.53300545","-0.136792671","Eversholt Street , Camden Town",285
"917",2020,2,132,601,598,"51.52364804","-0.074754872","Bethnal Green Road, Shoreditch",1199
"918",2020,2,133,457,473,NA,NA,NA,930
"919",2020,2,134,109,82,"51.504904","-0.06797","Wapping High Street, Wapping",191
"920",2020,2,135,373,362,"51.52326004","-0.104708922","Clerkenwell Green, Clerkenwell",735
"921",2020,2,136,287,314,"51.51196176","-0.097441687","Queen Victoria Street, St. Paul's",601
"922",2020,2,138,222,223,"51.51227622","-0.157436972","Green Street, Mayfair",445
"923",2020,2,139,176,145,"51.49488108","-0.117974901","Lambeth Road, Vauxhall",321
"924",2020,2,140,385,417,"51.52096262","-0.085634242","Finsbury Square , Moorgate",802
"925",2020,2,141,262,280,"51.51530805","-0.147203711","Chapel Place, Marylebone",542
"926",2020,2,142,140,130,"51.49372451","-0.198286569","West Cromwell Road, Earl's Court",270
"927",2020,2,143,189,192,"51.4968865","-0.161203828","Pont Street, Knightsbridge",381
"928",2020,2,144,340,320,"51.48894022","-0.111435796","Kennington Cross, Kennington",660
"929",2020,2,145,48,29,"51.50074359","-0.202759212","Ilchester Place, Kensington",77
"930",2020,2,146,87,103,"51.48836528","-0.129361842","Vauxhall Bridge , Pimlico",190
"931",2020,2,148,233,220,"51.49211134","-0.138364847","Tachbrook Street, Victoria",453
"932",2020,2,149,149,132,"51.48478899","-0.110683213","Kennington Road Post Office, Oval",281
"933",2020,2,150,152,213,"51.49705603","-0.168917077","Holy Trinity Brompton, Knightsbridge",365
"934",2020,2,151,161,89,"51.51213691","-0.201554966","Chepstow Villas, Notting Hill",250
"935",2020,2,152,214,208,"51.49217002","-0.101536865","Hampton Street, Walworth",422
"936",2020,2,153,344,348,"51.511933","-0.174411","Bayswater Road, Hyde Park",692
"937",2020,2,154,1489,1418,"51.50379168","-0.11282408","Waterloo Station 3, Waterloo",2907
"938",2020,2,155,190,169,"51.49586666","-0.191933711","Lexham Gardens, Kensington",359
"939",2020,2,156,173,157,"51.49443626","-0.092921165","New Kent Road, The Borough",330
"940",2020,2,157,215,254,"51.50039792","-0.193068385","Wright's Lane, Kensington",469
"941",2020,2,158,156,151,"51.49085368","-0.196170309","Trebovir Road, Earl's Court",307
"942",2020,2,159,401,462,"51.51461995","-0.137841333","Great Marlborough Street, Soho",863
"943",2020,2,160,177,186,"51.50663341","-0.131773845","Waterloo Place, St. James's",363
"944",2020,2,161,139,149,"51.49234577","-0.141334487","Guildhouse Street, Victoria",288
"945",2020,2,162,233,250,"51.51760685","-0.121328408","Southampton Place, Holborn",483
"946",2020,2,163,301,306,"51.4931848","-0.167894973","Sloane Avenue, Knightsbridge",607
"947",2020,2,164,151,127,"51.515607","-0.183118788","Cleveland Gardens, Bayswater",278
"948",2020,2,165,71,64,"51.517932","-0.183716959","Orsett Terrace, Bayswater",135
"949",2020,2,166,103,189,"51.50185512","-0.159237081","Seville Street, Knightsbridge",292
"950",2020,2,167,464,471,"51.49395092","-0.147624377","Eccleston Place, Victoria",935
"951",2020,2,168,140,150,"51.50040123","-0.195455928","Argyll Road, Kensington",290
"952",2020,2,169,252,227,"51.51474612","-0.165164288","Porchester Place, Paddington",479
"953",2020,2,170,130,95,"51.52784273","-0.108068155","Hardwick Street, Clerkenwell",225
"954",2020,2,171,160,146,"51.4916156","-0.186753859","Collingham Gardens, Earl's Court",306
"955",2020,2,172,127,127,"51.49121192","-0.173715911","Sumner Place, South Kensington",254
"956",2020,2,173,218,214,"51.50486","-0.113001","Waterloo Road, South Bank",432
"957",2020,2,174,183,204,"51.512529","-0.115163","Strand, Strand",387
"958",2020,2,175,295,340,"51.521668","-0.079608554","Worship Street, Shoreditch",635
"959",2020,2,176,154,135,"51.51791921","-0.188098863","Gloucester Terrace, Bayswater",289
"960",2020,2,177,432,466,"51.49616092","-0.140947636","Ashley Place, Victoria",898
"961",2020,2,178,217,175,"51.48985626","-0.141923621","Warwick Square, Pimlico",392
"962",2020,2,180,185,209,"51.5129118","-0.153645496","North Audley Street, Mayfair",394
"963",2020,2,181,95,109,"51.49941247","-0.152317537","Belgrave Square, Belgravia",204
"964",2020,2,182,203,205,"51.52202903","-0.165842551","Bell Street , Marylebone",408
"965",2020,2,183,250,251,"51.482362","-0.13612398","Riverlight North, Nine Elms",501
"966",2020,2,184,209,205,"51.52071513","-0.14521173","Portland Place, Marylebone",414
"967",2020,2,185,223,190,"51.48805753","-0.140741432","Alderney Street, Pimlico",413
"968",2020,2,186,610,525,"51.51733558","-0.175810943","South Wharf Road, Paddington",1135
"969",2020,2,187,191,167,"51.49247977","-0.178433004","Queen's Gate (South), South Kensington",358
"970",2020,2,188,121,103,"51.5165179","-0.164393768","Nutford Place, Marylebone",224
"971",2020,2,189,159,79,"51.53166681","-0.109914711","Claremont Square, Angel",238
"972",2020,2,190,277,259,"51.48997562","-0.132845681","Rampayne Street, Pimlico",536
"973",2020,2,191,814,805,"51.50311799","-0.153520935","Hyde Park Corner, Hyde Park",1619
"974",2020,2,192,316,352,"51.51251523","-0.133201961","Wardour Street, Soho",668
"975",2020,2,193,396,433,"51.50581776","-0.100186337","Bankside Mix, Bankside",829
"976",2020,2,194,678,934,"51.50462759","-0.091773776","Hop Exchange, The Borough",1612
"977",2020,2,195,246,247,"51.50724437","-0.106237501","Milroy Walk, South Bank",493
"978",2020,2,196,238,256,"51.50368837","-0.098497684","Union Street, The Borough",494
"979",2020,2,197,286,355,"51.50556905","-0.111606696","Stamford Street, South Bank",641
"980",2020,2,199,577,660,"51.51048489","-0.082989638","Great Tower Street, Monument",1237
"981",2020,2,200,220,222,"51.51492456","-0.066078037","LMU Commercial Road, Whitechapel",442
"982",2020,2,201,288,255,"51.5225965","-0.161113413","Dorset Square, Marylebone",543
"983",2020,2,202,441,425,"51.51236389","-0.06954201","Leman Street, Aldgate",866
"984",2020,2,203,359,371,"51.51821864","-0.100791005","West Smithfield Rotunda, Farringdon",730
"985",2020,2,204,166,158,"51.52659961","-0.112432615","Margery Street, Clerkenwell",324
"986",2020,2,206,242,255,"51.518154","-0.062697","New Road 1 , Whitechapel",497
"987",2020,2,207,62,54,"51.50135267","-0.153194766","Grosvenor Crescent, Belgravia",116
"988",2020,2,208,81,80,"51.52505151","-0.166304359","Mallory Street, Marylebone",161
"989",2020,2,209,115,112,"51.49358391","-0.165101392","Denyer Street, Knightsbridge",227
"990",2020,2,210,308,387,"51.51681444","-0.151926305","Hinde Street, Marylebone",695
"991",2020,2,211,133,170,"51.49464523","-0.158105512","Cadogan Place, Knightsbridge",303
"992",2020,2,212,84,65,"51.50658458","-0.199004026","Campden Hill Road, Notting Hill",149
"993",2020,2,213,500,524,"51.50274025","-0.149569201","Wellington Arch, Hyde Park",1024
"994",2020,2,214,361,387,"51.52683806","-0.130504336","Endsleigh Gardens, Euston",748
"995",2020,2,215,517,529,"51.51906932","-0.088285377","Moorfields, Moorgate",1046
"996",2020,2,216,203,191,"51.49094565","-0.181190899","Old Brompton Road, South Kensington",394
"997",2020,2,217,833,915,"51.51615461","-0.082422399","Wormwood Street, Liverpool Street",1748
"998",2020,2,218,179,170,"51.48971651","-0.170194408","St. Luke's Church, Chelsea",349
"999",2020,2,219,290,270,"51.49016361","-0.19039362","Bramham Gardens, Earl's Court",560
"1000",2020,2,220,123,129,"51.49066456","-0.166485083","Chelsea Green, Chelsea",252
"1001",2020,2,221,283,299,"51.49481649","-0.13045856","Horseferry Road, Westminster",582
"1002",2020,2,222,78,61,"51.50275704","-0.155349725","Knightsbridge, Hyde Park",139
"1003",2020,2,223,217,185,"51.49148474","-0.090220911","Rodney Road , Walworth",402
"1004",2020,2,224,224,187,"51.51031","-0.18740235","Queensway, Kensington Gardens",411
"1005",2020,2,225,402,292,"51.50935342","-0.196422","Notting Hill Gate Station, Notting Hill",694
"1006",2020,2,226,176,206,"51.50844614","-0.131961389","Charles II Street, West End",382
"1007",2020,2,227,197,174,"51.52891573","-0.115480888","Great Percy Street, Clerkenwell",371
"1008",2020,2,228,407,638,"51.50742485","-0.134621209","St. James's Square, St. James's",1045
"1009",2020,2,229,436,463,"51.50654321","-0.123179697","Whitehall Place, Strand",899
"1010",2020,2,230,151,154,"51.50669284","-0.103137426","Poured Lines, Bankside",305
"1011",2020,2,231,184,183,"51.49396755","-0.17873226","Queen's Gate (Central), South Kensington",367
"1012",2020,2,232,103,104,"51.51501025","-0.112753217","Carey Street, Holborn",207
"1013",2020,2,233,249,359,"51.50777049","-0.130699733","Pall Mall East, West End",608
"1014",2020,2,234,308,300,"51.53450449","-0.106992706","Liverpool Road (N1 Centre), Angel",608
"1015",2020,2,235,138,116,"51.49571828","-0.110889274","Kennington Road  , Vauxhall",254
"1016",2020,2,236,143,156,"51.51838043","-0.073438925","Fashion Street, Whitechapel",299
"1017",2020,2,237,236,245,"51.5097860151","-0.0681619805156","Dock Street, Wapping",481
"1018",2020,2,238,99,74,"51.5233534","-0.175116099","Frampton Street, Paddington",173
"1019",2020,2,239,360,348,"51.52443845","-0.138019439","Warren Street Station, Euston",708
"1020",2020,2,240,85,86,"51.50545935","-0.10569204","Colombo Street, Southwark",171
"1021",2020,2,242,184,181,"51.52200801","-0.151359288","Beaumont Street, Marylebone",365
"1022",2020,2,243,258,219,"51.49096258","-0.139625122","Gloucester Street, Pimlico",477
"1023",2020,2,244,241,269,"51.51611887","-0.128585022","Earnshaw Street , Covent Garden",510
"1024",2020,2,245,106,97,"51.4853572","-0.142207481","Grosvenor Road, Pimlico",203
"1025",2020,2,246,361,379,"51.52285301","-0.099994052","Berry Street, Clerkenwell",740
"1026",2020,2,247,94,63,"51.530529","-0.167515","St. John's Wood Church, The Regent's Park",157
"1027",2020,2,248,379,348,"51.50645179","-0.170279555","Triangle Car Park, Hyde Park",727
"1028",2020,2,249,121,105,"51.49859784","-0.096191134","Harper Road, The Borough",226
"1029",2020,2,250,127,130,"51.489932","-0.162727","Royal Avenue 1, Chelsea",257
"1030",2020,2,251,612,752,"51.518908","-0.079249","Brushfield Street, Liverpool Street",1364
"1031",2020,2,252,370,443,"51.5046364","-0.116542278","Jubilee Gardens, South Bank",813
"1032",2020,2,253,298,231,"51.53404294","-0.086379717","Shoreditch Park, Hoxton",529
"1033",2020,2,254,272,218,"51.53051587","-0.106408455","Chadwell Street, Angel",490
"1034",2020,2,255,164,130,"51.52557531","-0.179592915","Clifton Road, Maida Vale",294
"1035",2020,2,256,107,108,"51.51362054","-0.116764211","Houghton Street, Strand",215
"1036",2020,2,257,87,77,"51.52248185","-0.154907218","Westminster University, Marylebone",164
"1037",2020,2,258,119,108,NA,NA,NA,227
"1038",2020,2,259,194,198,"51.490959","-0.1532331","Bourne Street, Belgravia",392
"1039",2020,2,260,253,277,"51.5136846","-0.135580879","Broadwick Street, Soho",530
"1040",2020,2,261,97,56,"51.5134891","-0.191351186","Princes Square, Bayswater",153
"1041",2020,2,262,140,108,"51.49874469","-0.103132904","LSBU (Borough Road), Elephant & Castle",248
"1042",2020,2,263,236,255,"51.51422502","-0.080660083","St. Mary Axe, Aldgate",491
"1043",2020,2,264,297,280,"51.52644342","-0.109256828","Tysoe Street, Clerkenwell",577
"1044",2020,2,265,185,156,"51.51595344","-0.169249375","Southwick Street, Paddington",341
"1045",2020,2,266,222,218,"51.50102668","-0.180246101","Queen's Gate (North), Kensington",440
"1046",2020,2,267,170,167,"51.49206037","-0.132224622","Regency Street, Westminster",337
"1047",2020,2,268,310,323,"51.49320445","-0.144132875","Belgrave Road, Victoria",633
"1048",2020,2,269,209,200,"51.50082346","-0.089740764","Empire Square, The Borough",409
"1049",2020,2,270,538,535,"51.4863434","-0.122492418","Kennington Lane Rail Bridge, Vauxhall",1073
"1050",2020,2,271,98,87,"51.53583617","-0.156285395","London Zoo,  The Regent's Park",185
"1051",2020,2,272,457,461,"51.50144456","-0.110699309","Baylis Road, Waterloo",918
"1052",2020,2,273,309,378,"51.50613324","-0.114686385","Belvedere Road 1, South Bank",687
"1053",2020,2,274,167,149,"51.49671237","-0.20528437","Warwick Road, Olympia",316
"1054",2020,2,275,224,250,"51.52004497","-0.092176447","Barbican Centre, Barbican",474
"1055",2020,2,276,153,155,"51.50930161","-0.084985356","Lower Thames Street, Monument",308
"1056",2020,2,277,211,223,"51.50315739","-0.191496313","Kensington Church Street, Kensington",434
"1057",2020,2,278,648,675,"51.5034938","-0.07962099","Tooley Street, Bermondsey",1323
"1058",2020,2,279,275,284,"51.51862243","-0.176645823","North Wharf Road, Paddington",559
"1059",2020,2,280,208,219,"51.490083","-0.162418","Royal Avenue 2, Chelsea",427
"1060",2020,2,281,221,222,"51.49580589","-0.127575233","Smith Square, Westminster",443
"1061",2020,2,282,401,417,"51.51906446","-0.059642081","Royal London Hospital, Whitechapel",818
"1062",2020,2,283,45,52,"51.51440928","-0.118478757","Kingsway, Covent Garden",97
"1063",2020,2,284,172,174,"51.49914063","-0.112031483","Lambeth North Station, Waterloo",346
"1064",2020,2,286,92,67,"51.5272947","-0.174653609","St. John's Wood Road, St. John's Wood",159
"1065",2020,2,287,140,121,"51.52367314","-0.128377673","Bedford Way, Bloomsbury",261
"1066",2020,2,288,299,291,"51.49236962","-0.147478734","Elizabeth Bridge, Victoria",590
"1067",2020,2,289,58,62,"51.50923022","-0.151296092","South Audley Street, Mayfair",120
"1068",2020,2,290,127,118,"51.518268","-0.17110323","St Mary's Hospital, Paddington",245
"1069",2020,2,291,178,163,"51.48483991","-0.138089062","Claverton Street, Pimlico",341
"1070",2020,2,292,231,257,"51.49888404","-0.165471605","Montpelier Street, Knightsbridge",488
"1071",2020,2,293,108,101,"51.49815779","-0.209494128","Kensington Olympia Station, Olympia",209
"1072",2020,2,294,285,256,"51.488226","-0.135635511","St. George's Square, Pimlico",541
"1073",2020,2,295,210,194,"51.50029631","-0.092762704","Swan Street, The Borough",404
"1074",2020,2,296,114,117,"51.49363156","-0.190603326","Knaresborough Place, Earl's Court",231
"1075",2020,2,297,66,56,"51.49612799","-0.106000855","Geraldine Street, Elephant & Castle",122
"1076",2020,2,298,412,415,"51.50227992","-0.074189225","Curlew Street, Shad Thames",827
"1077",2020,2,299,100,109,"51.49398524","-0.136928582","Vincent Square, Westminster",209
"1078",2020,2,300,390,371,"51.505014","-0.17306032","Serpentine Car Park, Hyde Park",761
"1079",2020,2,301,271,298,"51.51475963","-0.148105415","Marylebone Lane, Marylebone",569
"1080",2020,2,302,138,145,"51.466907","-0.216573","Putney Pier, Wandsworth",283
"1081",2020,2,303,451,507,"51.50295379","-0.158456089","Albert Gate, Hyde Park",958
"1082",2020,2,306,186,190,"51.51816295","-0.135025698","Rathbone Street, Fitzrovia",376
"1083",2020,2,307,442,442,"51.50990837","-0.187842717","Black Lion Gate, Kensington Gardens",884
"1084",2020,2,308,203,206,"51.49907558","-0.085666316","Long Lane , Bermondsey",409
"1085",2020,2,309,124,139,"51.50963123","-0.119047563","Embankment (Savoy), Strand",263
"1086",2020,2,310,196,201,"51.4908679","-0.116911864","Black Prince Road, Vauxhall",397
"1087",2020,2,311,211,222,"51.51918144","-0.140485596","Foley Street, Fitzrovia",433
"1088",2020,2,312,161,148,"51.53088935","-0.176770502","Grove End Road, St. John's Wood",309
"1089",2020,2,313,288,297,"51.51734403","-0.138072691","Wells Street, Fitzrovia",585
"1090",2020,2,314,215,224,"51.50088934","-0.083159352","Tyers Gate, Bermondsey",439
"1091",2020,2,315,97,105,"51.52536703","-0.153463612","The Tennis Courts, The Regent's Park",202
"1092",2020,2,316,176,193,NA,NA,NA,369
"1093",2020,2,317,92,65,"51.49679128","-0.093913472","Dickens Square, Borough",157
"1094",2020,2,318,222,283,"51.51004801","-0.138846453","Sackville Street, Mayfair",505
"1095",2020,2,319,294,291,"51.52702563","-0.088542771","Baldwin Street, St. Luke's",585
"1096",2020,2,320,303,305,"51.49357351","-0.139956043","Queen Mother Sports Centre, Victoria",608
"1097",2020,2,321,350,340,"51.49785559","-0.081608045","Bermondsey Street, Bermondsey",690
"1098",2020,2,322,128,115,"51.526293","-0.073955","Palissy Street, Shoreditch",243
"1099",2020,2,323,162,177,"51.523196","-0.083067","Clifton Street, Shoreditch",339
"1100",2020,2,324,256,263,"51.49652013","-0.101384068","Ontario Street, Elephant & Castle",519
"1101",2020,2,325,156,156,"51.50908747","-0.129697889","St. Martin's Street, West End",312
"1102",2020,2,326,327,278,"51.53266186","-0.099981142","Graham Street, Angel",605
"1103",2020,2,327,65,35,"51.53095","-0.085603","New North Road 1, Hoxton",100
"1104",2020,2,328,76,61,"51.53114","-0.086016","New North Road 2, Hoxton",137
"1105",2020,2,329,154,131,"51.53589283","-0.160854428","Prince Albert Road, The Regent's Park",285
"1106",2020,2,330,330,252,"51.51641749","-0.179135079","Eastbourne Mews, Paddington",582
"1107",2020,2,331,404,437,"51.52085887","-0.089887855","Bunhill Row, Moorgate",841
"1108",2020,2,332,94,80,"51.49334336","-0.194757949","Nevern Place, Earl's Court",174
"1109",2020,2,333,222,169,"51.50860544","-0.193764092","Palace Gardens Terrace, Notting Hill",391
"1110",2020,2,334,210,222,"51.505044","-0.115851","Concert Hall Approach 1, South Bank",432
"1111",2020,2,335,276,322,"51.51196803","-0.120718759","Tavistock Street, Covent Garden",598
"1112",2020,2,336,160,230,"51.504942","-0.115533","Concert Hall Approach 2, South Bank",390
"1113",2020,2,337,130,71,"51.51108452","-0.197524944","Pembridge Villas, Notting Hill",201
"1114",2020,2,338,330,372,"51.51175646","-0.119643424","Wellington Street , Strand",702
"1115",2020,2,339,109,70,"51.5333196","-0.1117812","Risinghill Street, Angel",179
"1116",2020,2,340,491,524,"51.51444134","-0.087587447","Bank of England Museum, Bank",1015
"1117",2020,2,341,626,619,"51.50810309","-0.12602103","Craven Street, Strand",1245
"1118",2020,2,343,136,103,"51.53692216","-0.150181444","London Zoo Car Park, The Regent's Park",239
"1119",2020,2,344,169,149,"51.528246","-0.10102611","Goswell Road (City Uni), Finsbury",318
"1120",2020,2,345,382,404,"51.48802358","-0.166878535","Flood Street, Chelsea",786
"1121",2020,2,347,243,270,"51.50013942","-0.113936001","Lower Marsh, Waterloo",513
"1122",2020,2,348,177,252,"51.51217033","-0.150481272","Grosvenor Square, Mayfair",429
"1123",2020,2,349,186,211,"51.51196","-0.142783033","St. George Street, Mayfair",397
"1124",2020,2,350,207,227,"51.5017154373867","-0.1798541843891","Queen's Gate, Kensington Gardens",434
"1125",2020,2,351,269,185,"51.529423","-0.097122","Macclesfield Rd, St Lukes",454
"1126",2020,2,352,155,168,"51.486965","-0.116625","Vauxhall Street, Vauxhall",323
"1127",2020,2,353,99,116,"51.49459148","-0.134234258","Greycoat Street , Westminster",215
"1128",2020,2,354,300,396,"51.506767","-0.123702","Northumberland Avenue, Strand",696
"1129",2020,2,355,52,56,NA,NA,NA,108
"1130",2020,2,356,448,482,"51.494412","-0.173881","South Kensington Station, South Kensington",930
"1131",2020,2,357,301,349,"51.520994","-0.139016","Howland Street, Fitzrovia",650
"1132",2020,2,358,209,219,"51.516226","-0.124826","High Holborn , Covent Garden",428
"1133",2020,2,360,355,421,"51.49675303","-0.138733562","Howick Place, Westminster",776
"1134",2020,2,361,689,554,"51.50391973","-0.11342629","Waterloo Station 2, Waterloo",1243
"1135",2020,2,362,165,127,"51.536264","-0.133952","Royal College Street, Camden Town",292
"1136",2020,2,363,55,39,"51.5291212008901","-0.171185284853","Lord's, St. John's Wood",94
"1137",2020,2,364,281,313,"51.519656","-0.132339","Alfred Place, Bloomsbury",594
"1138",2020,2,365,187,191,"51.530344","-0.100168","City Road, Angel",378
"1139",2020,2,366,104,123,"51.5109192966489","-0.1511263847351","Millennium Hotel, Mayfair",227
"1140",2020,2,367,141,116,"51.5173721","-0.1642075","Harrowby Street, Marylebone",257
"1141",2020,2,368,219,220,"51.50024195","-0.15934065","Harriet Street, Knightsbridge",439
"1142",2020,2,370,84,38,"51.520205","-0.174593","Paddington Green, Paddington",122
"1143",2020,2,371,99,80,"51.49775","-0.10988","King Edward Walk, Waterloo",179
"1144",2020,2,372,150,138,"51.515208","-0.117863","Sardinia Street, Holborn",288
"1145",2020,2,373,120,167,"51.49980661","-0.176415994","Prince Consort Road, Knightsbridge",287
"1146",2020,2,374,1425,1274,"51.50402794","-0.11386436","Waterloo Station 1, Waterloo",2699
"1147",2020,2,375,114,104,"51.50194596","-0.194392952","Kensington Town Hall, Kensington",218
"1148",2020,2,376,254,284,"51.49188409","-0.125674815","Millbank Tower, Pimlico",538
"1149",2020,2,377,141,142,"51.50535447","-0.113656543","Waterloo Bridge, South Bank",283
"1150",2020,2,378,244,258,"51.49559291","-0.179077626","Natural History Museum, South Kensington",502
"1151",2020,2,379,220,224,"51.51431171","-0.200838199","Turquoise Island, Notting Hill",444
"1152",2020,2,380,96,124,"51.50686435","-0.150666888","Stanhope Gate, Mayfair",220
"1153",2020,2,381,188,214,"51.51953043","-0.13577731","Charlotte Street, Fitzrovia",402
"1154",2020,2,382,89,111,"51.50935171","-0.14744969","Farm Street, Mayfair",200
"1155",2020,2,383,241,273,"51.51310333","-0.13121385","Frith Street, Soho",514
"1156",2020,2,384,62,65,"51.496481","-0.192404","Marloes Road, Kensington",127
"1157",2020,2,386,338,378,"51.51352755","-0.130110822","Moor Street, Soho",716
"1158",2020,2,387,190,186,"51.49369988","-0.121394101","Fire Brigade Pier, Vauxhall",376
"1159",2020,2,388,237,289,"51.51070161","-0.121723604","Southampton Street, Strand",526
"1160",2020,2,389,25,22,"51.51013066","-0.155757901","Upper Grosvenor Street, Mayfair",47
"1161",2020,2,390,86,90,"51.521776","-0.068856","Buxton Street 1, Shoreditch",176
"1162",2020,2,392,303,335,"51.49942855","-0.179702476","Imperial College, Knightsbridge",638
"1163",2020,2,393,399,401,"51.51733427","-0.103604248","Snow Hill, Farringdon",800
"1164",2020,2,394,118,95,"51.524826","-0.176268","Aberdeen Place, St. John's Wood",213
"1165",2020,2,395,255,289,"51.492462","-0.159919","Cadogan Gardens, Chelsea",544
"1166",2020,2,396,146,134,"51.51809","-0.163609","Shouldham Street, Marylebone",280
"1167",2020,2,397,245,197,"51.51348","-0.17977","Devonshire Terrace, Bayswater",442
"1168",2020,2,398,94,49,"51.502319","-0.200742","Holland Park, Kensington",143
"1169",2020,2,399,261,256,"51.52261762","-0.071653961","Brick Lane Market, Shoreditch",517
"1170",2020,2,400,15,20,"51.517703","-0.154106","George Street, Marylebone",35
"1171",2020,2,401,264,228,"51.528187","-0.075375","Columbia Road, Shoreditch",492
"1172",2020,2,402,98,91,"51.52289229","-0.171681991","Penfold Street, Marylebone",189
"1173",2020,2,403,193,189,"51.51689296","-0.158249929","George Place Mews, Marylebone",382
"1174",2020,2,404,248,258,"51.50204238","-0.184400221","Palace Gate, Kensington Gardens",506
"1175",2020,2,405,397,417,"51.49418566","-0.18267094","Gloucester Road Station, South Kensington",814
"1176",2020,2,408,62,52,NA,NA,NA,114
"1177",2020,2,409,203,210,"51.493146","-0.099828","Strata, Elephant & Castle",413
"1178",2020,2,410,154,123,"51.519968","-0.169774","Edgware Road Station, Marylebone",277
"1179",2020,2,411,291,301,"51.49337264","-0.09968067","Walworth Road, Elephant & Castle",592
"1180",2020,2,412,110,106,"51.488105","-0.110121","Cleaver Street, Kennington",216
"1181",2020,2,419,170,153,"51.485821","-0.149004","Chelsea Bridge, Pimlico",323
"1182",2020,2,420,180,154,"51.504043","-0.105312","Southwark Station 1, Southwark",334
"1183",2020,2,421,238,222,"51.504044","-0.104778","Southwark Station 2, Southwark",460
"1184",2020,2,423,117,104,"51.49456127","-0.15393398","Eaton Square (South), Belgravia",221
"1185",2020,2,424,177,148,"51.490491","-0.149186","Ebury Bridge, Pimlico",325
"1186",2020,2,425,187,176,"51.533379","-0.139159","Harrington Square 2, Camden Town",363
"1187",2020,2,426,167,171,"51.493072","-0.129925","Vincent Street, Pimlico",338
"1188",2020,2,427,633,662,"51.51397065","-0.09294031","Cheapside, Bank",1295
"1189",2020,2,428,473,532,"51.499917","-0.174554","Exhibition Road, Knightsbridge",1005
"1190",2020,2,430,93,96,"51.48902","-0.17524","South Parade, Chelsea",189
"1191",2020,2,431,104,106,"51.534474","-0.122203","Crinan Street, King's Cross",210
"1192",2020,2,432,291,315,"51.496957","-0.173894","Exhibition Road Museums, South Kensington",606
"1193",2020,2,433,337,326,"51.524564","-0.116279","Wren Street, Holborn",663
"1194",2020,2,435,197,172,"51.488852","-0.105593","Kennington Station, Kennington",369
"1195",2020,2,436,388,376,"51.51824","-0.11655","Red Lion Street, Holborn",764
"1196",2020,2,437,180,188,"51.488124","-0.120903","Vauxhall Walk, Vauxhall",368
"1197",2020,2,439,87,92,"51.5338","-0.118677","Killick Street, King's Cross",179
"1198",2020,2,440,149,154,"51.483145","-0.113134","Kennington Oval, Oval",303
"1199",2020,2,441,172,150,"51.495656","-0.114605","Sail Street, Vauxhall",322
"1200",2020,2,442,85,97,"51.510101","-0.211358","Walmer Road, Avondale",182
"1201",2020,2,443,227,230,"51.515256","-0.058641","Philpot Street, Whitechapel",457
"1202",2020,2,444,210,190,"51.52568","-0.055312","Bethnal Green Garden, Bethnal Green",400
"1203",2020,2,445,157,148,"51.52388","-0.065076","Cheshire Street, Bethnal Green",305
"1204",2020,2,446,261,241,"51.528936","-0.055894","York Hall, Bethnal Green",502
"1205",2020,2,447,44,36,"51.493381","-0.007542","Jubilee Crescent, Cubitt Town",80
"1206",2020,2,448,155,176,"51.50623","-0.02296","Fisherman's Walk West, Canary Wharf",331
"1207",2020,2,449,276,256,"51.511088","-0.057159","Shadwell Station, Shadwell",532
"1208",2020,2,450,194,136,"51.515975","-0.053177","Jubilee Street, Stepney",330
"1209",2020,2,451,195,206,"51.504719","-0.063531","Hermitage Court, Wapping",401
"1210",2020,2,452,187,182,"51.505697","-0.070542","St. Katharine's Way, Tower",369
"1211",2020,2,453,181,157,"51.508447","-0.055167","Garnet Street, Shadwell",338
"1212",2020,2,454,60,60,"51.487679","-0.021582","Napier Avenue, Millwall",120
"1213",2020,2,455,43,41,"51.49447","-0.014409","East Ferry Road, Cubitt Town",84
"1214",2020,2,456,116,132,"51.538071","-0.144664","Parkway, Camden Town",248
"1215",2020,2,457,184,157,"51.542138","-0.145393","Castlehaven Road, Camden Town",341
"1216",2020,2,458,215,217,"51.504749","-0.057544","Wapping Lane, Wapping",432
"1217",2020,2,459,182,170,"51.535179","-0.03338","Gunmakers Lane, Old Ford",352
"1218",2020,2,460,158,169,"51.516196","-0.029138","Burdett Road, Mile End",327
"1219",2020,2,461,156,143,"51.516","-0.038775","Aston Street, Stepney",299
"1220",2020,2,462,230,193,"51.541603","-0.138853","Bonny Street, Camden Town",423
"1221",2020,2,463,122,84,"51.534776","-0.071881","Thurtle Road, Haggerston",206
"1222",2020,2,464,76,59,"51.51417","-0.052099","St. Mary & St. Michael Church, Stepney",135
"1223",2020,2,465,294,235,"51.53558","-0.08249","Pitfield Street North,Hoxton",529
"1224",2020,2,466,170,119,"51.534464","-0.076341","Whiston Road, Haggerston",289
"1225",2020,2,467,99,82,"51.523538","-0.030556","Southern Grove, Bow",181
"1226",2020,2,468,52,39,"51.521564","-0.022694","Cantrell Road, Bow",91
"1227",2020,2,469,129,110,"51.513757","-0.020467","Lindfield Street, Poplar",239
"1228",2020,2,470,171,146,"51.530535","-0.025492","Mostyn Grove, Bow",317
"1229",2020,2,471,126,124,"51.533283","-0.028155","Hewison Street, Old Ford",250
"1230",2020,2,472,27,20,"51.529452","-0.027616","Malmesbury Road, Bow",47
"1231",2020,2,473,30,36,"51.496137","-0.019355","Millharbour, Millwall",66
"1232",2020,2,475,70,61,"51.499041","-0.020157","Lightermans Road, Millwall",131
"1233",2020,2,476,24,38,"51.489096","-0.009205","Stebondale Street, Cubitt Town",62
"1234",2020,2,477,64,66,"51.49109","-0.018716","Spindrift Avenue, Millwall",130
"1235",2020,2,478,269,279,"51.521889","-0.04667","Stepney Green Station, Stepney",548
"1236",2020,2,479,230,232,"51.527152","-0.058005","Pott Street, Bethnal Green",462
"1237",2020,2,480,348,334,"51.5128711","-0.0389866","Flamborough Street, Limehouse",682
"1238",2020,2,481,118,148,"51.487129","-0.009001","Saunders Ness Road, Cubitt Town",266
"1239",2020,2,483,198,197,"51.51328","-0.047784","Albert Gardens, Stepney",395
"1240",2020,2,484,69,79,"51.528828","-0.013258","Bromley High Street, Bow",148
"1241",2020,2,485,148,126,"51.531127","-0.048017","Old Ford Road, Bethnal Green",274
"1242",2020,2,486,280,270,"51.525645","-0.069543","Granby Street, Shoreditch",550
"1243",2020,2,487,46,50,"51.511811","-0.025626","Canton Street, Poplar",96
"1244",2020,2,488,196,180,"51.506946","-0.058681","Reardon Street, Wapping",376
"1245",2020,2,489,226,194,"51.513074","-0.064094","Christian Street, Whitechapel",420
"1246",2020,2,490,90,91,"51.508622","-0.065006","Pennington Street, Wapping",181
"1247",2020,2,491,197,196,"51.522507","-0.041378","Queen Mary's, Mile End",393
"1248",2020,2,492,341,351,"51.525501","-0.032267204","Maplin Street, Mile End",692
"1249",2020,2,494,5,7,"51.50196","-0.016251","South Quay East, Canary Wharf",12
"1250",2020,2,495,147,130,"51.528169","-0.018703","Bow Church Station, Bow",277
"1251",2020,2,496,117,112,"51.52512","-0.015578","Devons Road, Bow",229
"1252",2020,2,497,120,116,"51.526149","-0.027396845","Merchant Street, Bow",236
"1253",2020,2,498,177,148,"51.527058","-0.025296","Bow Road Station, Bow",325
"1254",2020,2,499,198,185,"51.519265","-0.021345","Furze Green, Bow",383
"1255",2020,2,500,278,265,"51.519806","-0.055731","Ansell House, Stepney",543
"1256",2020,2,501,167,141,"51.522561","-0.054883","Cephas Street, Bethnal Green",308
"1257",2020,2,502,220,218,"51.53341","-0.049591815","Bonner Gate, Victoria Park",438
"1258",2020,2,503,406,394,"51.520893","-0.051394","Cleveland Way, Stepney",800
"1259",2020,2,504,11,16,"51.496454","-0.009506","St. John's Park, Cubitt Town",27
"1260",2020,2,505,136,104,"51.520398","-0.026768","Ackroyd Drive, Bow",240
"1261",2020,2,506,213,227,"51.517475","-0.075855","Bell Lane, Liverpool Street",440
"1262",2020,2,507,142,120,"51.528692","-0.059091","Clarkson Street, Bethnal Green",262
"1263",2020,2,508,316,328,"51.519362","-0.074431","Fournier Street, Whitechapel",644
"1264",2020,2,509,221,243,"51.517842","-0.090075","Fore Street, Guildhall",464
"1265",2020,2,510,238,304,"51.509303","-0.025996","Westferry DLR, Limehouse",542
"1266",2020,2,511,275,244,"51.511066","-0.053558","Sutton Street, Shadwell",519
"1267",2020,2,512,375,336,"51.532091","-0.06142","Pritchard's Road, Bethnal Green",711
"1268",2020,2,513,159,123,"51.5142228","-0.055656","Watney Market, Stepney",282
"1269",2020,2,514,203,244,"51.516204","-0.155525","Portman Square, Marylebone",447
"1270",2020,2,515,69,69,"51.500088","-0.211316","Russell Gardens, Olympia",138
"1271",2020,2,516,130,124,"51.5112","-0.014438","Chrisp Street Market, Poplar",254
"1272",2020,2,517,126,107,"51.532513","-0.033085","Ford Road, Old Ford",233
"1273",2020,2,518,156,116,"51.528224","-0.037471","Antill Road, Mile End",272
"1274",2020,2,519,23,15,"51.518811","-0.011662","Teviot Street, Poplar",38
"1275",2020,2,520,194,172,"51.526041","-0.047218","Bancroft Road, Bethnal Green",366
"1276",2020,2,521,176,165,"51.534137","-0.037366","Driffield Road, Old Ford",341
"1277",2020,2,522,171,174,"51.525941","-0.036017","Clinton Road, Mile End",345
"1278",2020,2,523,27,28,"51.51549","-0.013475","Langdon Park, Poplar",55
"1279",2020,2,524,169,146,"51.511654","-0.179668","Lancaster Gate , Bayswater",315
"1280",2020,2,526,38,40,"51.503143","-0.008428","Lancaster Drive, Blackwall",78
"1281",2020,2,527,87,92,"51.503802","-0.215808","Hansard Mews, Holland Park",179
"1282",2020,2,528,99,113,"51.507326","-0.145827","Clarges Street, Mayfair",212
"1283",2020,2,529,169,171,"51.486892","-0.170983","Manresa Road, Chelsea",340
"1284",2020,2,530,40,33,"51.508896","-0.012413","Newby Place, Poplar",73
"1285",2020,2,531,216,193,"51.530326","-0.042744","Twig Folly Bridge, Mile End",409
"1286",2020,2,532,139,142,"51.50357","-0.020068","Jubilee Plaza, Canary Wharf",281
"1287",2020,2,533,235,229,"51.528222","-0.069743","Wellington Row, Bethnal Green",464
"1288",2020,2,534,236,194,"51.531864","-0.066035","Goldsmith's Row, Haggerston",430
"1289",2020,2,535,190,154,"51.537349","-0.147154","Gloucester Avenue, Camden Town",344
"1290",2020,2,536,103,101,"51.53385","-0.06992","Queensbridge Road, Haggerston",204
"1291",2020,2,537,248,244,"51.51793","-0.067937","Old Montague Street, Whitechapel",492
"1292",2020,2,538,66,60,"51.508981","-0.00699","Naval Row, Blackwall",126
"1293",2020,2,540,173,128,"51.528302","-0.144466","Albany Street, The Regent's Park",301
"1294",2020,2,541,377,377,"51.506613","-0.142844","Green Park Station, Mayfair",754
"1295",2020,2,542,139,143,"51.514115","-0.033828","Salmon Lane, Limehouse",282
"1296",2020,2,543,38,26,"51.509591","-0.204666","Lansdowne Walk, Ladbroke Grove",64
"1297",2020,2,544,164,145,"51.526153","-0.102208","Percival Street, Finsbury",309
"1298",2020,2,545,142,137,"51.539957","-0.145246","Arlington Road, Camden Town",279
"1299",2020,2,546,279,312,"51.517428","-0.107987","New Fetter Lane, Holborn",591
"1300",2020,2,547,70,64,"51.509474","-0.002275","East India DLR, Blackwall",134
"1301",2020,2,548,80,82,"51.498386","-0.107913","Westminster Bridge Road, Elephant & Castle",162
"1302",2020,2,549,148,134,"51.49605","-0.104193","Gaywood  Street, Elephant & Castle",282
"1303",2020,2,550,151,142,"51.521564","-0.039264","Harford Street, Mile End",293
"1304",2020,2,551,114,120,"51.505772","-0.016460175","Import Dock, Canary Wharf",234
"1305",2020,2,552,250,227,"51.511542","-0.056667","Watney Street, Shadwell",477
"1306",2020,2,553,555,576,"51.535678","-0.062546","Regent's Row , Haggerston",1131
"1307",2020,2,554,41,45,"51.513548","-0.005659","Aberfeldy Street, Poplar",86
"1308",2020,2,556,90,92,"51.502661","-0.021596","Heron Quays DLR, Canary Wharf",182
"1309",2020,2,557,154,171,"51.51601","-0.0985","King Edward Street, St Pauls",325
"1310",2020,2,558,349,388,"51.493978","-0.127554","Page Street, Westminster",737
"1311",2020,2,559,71,59,"51.501391","-0.205991","Abbotsbury Road, Holland Park",130
"1312",2020,2,560,82,38,"51.511624","-0.205921","Ladbroke Grove Central, Ladbroke Grove",120
"1313",2020,2,561,112,76,"51.518369","-0.043371","Rectory Square, Stepney",188
"1314",2020,2,562,199,208,"51.51746","-0.12335","Bury Place, Holborn",407
"1315",2020,2,563,38,34,"51.499286","-0.009152","Preston's Road, Cubitt Town",72
"1316",2020,2,564,406,447,"51.509943","-0.117619","Somerset House, Strand",853
"1317",2020,2,565,96,98,"51.521905","-0.063386","Selby Street, Whitechapel",194
"1318",2020,2,566,145,199,"51.509158","-0.224103","Westfield Ariel Way, White City",344
"1319",2020,2,568,254,255,"51.51616","-0.18697","Bishop's Bridge Road West, Bayswater",509
"1320",2020,2,569,179,156,"51.53213","-0.08299","Pitfield Street Central, Hoxton",335
"1321",2020,2,570,219,219,"51.503083","-0.017676","Upper Bank Street, Canary Wharf",438
"1322",2020,2,571,131,139,"51.506256","-0.218337","Westfield Southern Terrace ,Shepherd's Bush",270
"1323",2020,2,572,190,210,"51.539099","-0.141728","Greenland Road, Camden Town",400
"1324",2020,2,573,429,434,"51.485587","-0.18119","Limerston Street, West Chelsea",863
"1325",2020,2,574,537,446,"51.53356","-0.09315","Eagle Wharf Road, Hoxton",983
"1326",2020,2,576,34,31,"51.497304","-0.022793","Alpha Grove, Millwall",65
"1327",2020,2,577,218,214,"51.528869","-0.047548","Globe Town Market, Bethnal Green",432
"1328",2020,2,578,139,129,"51.527607","-0.057133","Hollybush Gardens, Bethnal Green",268
"1329",2020,2,579,478,597,"51.511246","-0.093051","Queen Street 2, Bank",1075
"1330",2020,2,580,191,172,"51.48692917","-0.102996299","Doddington Grove, Kennington",363
"1331",2020,2,581,274,276,"51.519167","-0.147983","New Cavendish Street, Marylebone",550
"1332",2020,2,583,260,313,"51.497622","-0.125978","Abingdon Green, Westminster",573
"1333",2020,2,584,194,176,"51.51244","-0.19096","Ilchester Gardens, Bayswater",370
"1334",2020,2,586,21,21,"51.490645","-0.014582","Mudchute DLR, Cubitt Town",42
"1335",2020,2,587,356,372,"51.50964","-0.08497","Monument Street, Monument",728
"1336",2020,2,588,164,136,"51.52959","-0.0801","Hoxton Street, Hoxton",300
"1337",2020,2,589,291,309,"51.487196","-0.179369","Drayton Gardens, West Chelsea",600
"1338",2020,2,590,58,24,"51.53256","-0.16862","Greenberry Street, St.John's Wood",82
"1339",2020,2,592,118,97,"51.5171","-0.18377","Bishop's Bridge Road East, Bayswater",215
"1340",2020,2,593,155,138,"51.531066","-0.11934","Northdown Street, King's Cross",293
"1341",2020,2,594,156,187,"51.513875","-0.117774","Kingsway Southbound, Strand",343
"1342",2020,2,595,250,259,"51.493267","-0.21985","Hammersmith Road, Hammersmith",509
"1343",2020,2,596,254,252,"51.472817","-0.199783","Parson's Green , Parson's Green",506
"1344",2020,2,597,138,140,"51.473471","-0.20782","Fulham Park Road, Fulham",278
"1345",2020,2,598,157,170,"51.494499","-0.228188","Southerton Road, Hammersmith",327
"1346",2020,2,599,120,103,"51.485743","-0.223616","Manbre Road, Hammersmith",223
"1347",2020,2,600,233,229,"51.481747","-0.124642","South Lambeth Road, Vauxhall",462
"1348",2020,2,601,118,130,"51.514767","-0.225787","BBC White City, White City",248
"1349",2020,2,602,181,185,"51.472993","-0.133972","Union Grove, Wandsworth Road",366
"1350",2020,2,603,185,199,"51.477839","-0.116493","Caldwell Street, Stockwell",384
"1351",2020,2,604,72,60,"51.538792","-0.138535","St Martins Close, Camden Town",132
"1352",2020,2,605,167,181,"51.520331","-0.163667","Seymour Place, Marylebone",348
"1353",2020,2,606,98,97,"51.504199","-0.210941","Addison Road, Holland Park",195
"1354",2020,2,607,179,181,"51.468814","-0.210279","Putney Bridge Station, Fulham",360
"1355",2020,2,608,24,21,"51.491093","-0.216493","Colet Gardens, Hammersmith",45
"1356",2020,2,609,89,65,"51.46512358","-0.157788279","Sugden Road, Clapham",154
"1357",2020,2,610,130,120,"51.48256792","-0.172078187","Danvers Street, West Chelsea",250
"1358",2020,2,611,105,88,"51.50646524","-0.208486599","Princedale Road , Holland Park",193
"1359",2020,2,612,193,173,"51.46925984","-0.141812513","Wandsworth Rd, Isley Court, Wandsworth Road",366
"1360",2020,2,613,293,296,"51.50403821","-0.217400093","Woodstock Grove, Shepherd's Bush",589
"1361",2020,2,614,84,73,"51.47817208","-0.144690541","Bradmead, Battersea Park",157
"1362",2020,2,615,193,199,"51.4768851","-0.215895601","Finlay Street, Fulham",392
"1363",2020,2,616,203,199,"51.48102131","-0.209973497","Aintree Street, Fulham",402
"1364",2020,2,617,108,92,"51.47107905","-0.207842908","Elysium Place, Fulham",200
"1365",2020,2,618,151,146,"51.47625965","-0.193254007","Eel Brook Common, Walham Green",297
"1366",2020,2,619,152,131,"51.4737636","-0.197010096","Irene Road, Parsons Green",283
"1367",2020,2,620,160,156,"51.47518024","-0.167160736","Surrey Lane, Battersea",316
"1368",2020,2,621,210,217,"51.46086446","-0.187427294","Wandsworth Town Station, Wandsworth",427
"1369",2020,2,622,211,206,"51.50748124","-0.205535908","Lansdowne Road, Ladbroke Grove",417
"1370",2020,2,623,69,54,"51.46193072","-0.180791784","Nantes Close, Wandsworth",123
"1371",2020,2,624,148,105,"51.4729184","-0.132102704","Courland Grove, Wandsworth Road",253
"1372",2020,2,625,320,256,"51.47761941","-0.149551631","Queen's Circus, Battersea Park",576
"1373",2020,2,626,271,268,"51.48438657","-0.20481514","Normand Park, West Kensington",539
"1374",2020,2,627,62,54,"51.4687905","-0.158230901","Holden Street, Battersea",116
"1375",2020,2,628,205,214,"51.46881971","-0.184318843","William Morris Way, Sands End",419
"1376",2020,2,629,45,42,"51.45995384","-0.190184054","Morie Street, Wandsworth",87
"1377",2020,2,630,97,78,"51.47073264","-0.126994068","Clarence Walk, Stockwell",175
"1378",2020,2,631,214,217,"51.4795017","-0.141770709","Battersea Park Road, Nine Elms",431
"1379",2020,2,632,142,146,"51.47053858","-0.163041605","Sheepcote Lane, Battersea",288
"1380",2020,2,633,162,136,"51.48959104","-0.209378594","Vereker Road, West Kensington",298
"1381",2020,2,634,128,140,"51.49434708","-0.215804559","Brook Green South, Brook Green",268
"1382",2020,2,635,188,168,"51.48606206","-0.214428378","Greyhound Road, Hammersmith",356
"1383",2020,2,636,218,203,"51.46706414","-0.193502076","South Park, Sands End",421
"1384",2020,2,637,62,52,"51.45787019","-0.174691623","Spencer Park, Wandsworth Common",114
"1385",2020,2,638,388,388,"51.46663393","-0.169821175","Falcon Road, Clapham Junction",776
"1386",2020,2,639,211,204,"51.48357068","-0.202038682","Coomer Place, West Kensington",415
"1387",2020,2,640,123,130,"51.47286577","-0.148059277","Silverthorne Road, Battersea",253
"1388",2020,2,641,114,118,"51.49824168","-0.117495865","Archbishop's Park, Waterloo",232
"1389",2020,2,642,58,51,"51.46916161","-0.174485792","Fawcett Close, Battersea",109
"1390",2020,2,643,86,76,"51.5190427","-0.204764421","All Saints' Road, Portobello",162
"1391",2020,2,644,204,179,"51.48373225","-0.223852256","Rainville Road, Hammersmith",383
"1392",2020,2,645,185,194,"51.50173215","-0.100292412","Great Suffolk Street, The Borough",379
"1393",2020,2,646,237,282,"51.49886563","-0.137424571","Buckingham Gate, Westminster",519
"1394",2020,2,647,143,125,"51.50035306","-0.217515071","Richmond Way, Shepherd's Bush",268
"1395",2020,2,648,80,81,"51.46904022","-0.19627483","Peterborough Road, Sands End",161
"1396",2020,2,649,146,153,"51.48180515","-0.18027465","World's End Place, West Chelsea",299
"1397",2020,2,650,138,134,"51.51687069","-0.213872396","St. Mark's Road, North Kensington",272
"1398",2020,2,651,146,130,"51.48089844","-0.183853573","Thorndike Close, West Chelsea",276
"1399",2020,2,652,55,57,"51.51148696","-0.218190203","Evesham Street, Avondale",112
"1400",2020,2,653,181,184,"51.47084722","-0.17070367","Simpson Street, Clapham Junction",365
"1401",2020,2,654,149,160,"51.48267821","-0.117661574","Ashmole Estate, Oval",309
"1402",2020,2,655,118,103,"51.48294452","-0.219346128","Crabtree Lane, Fulham",221
"1403",2020,2,656,79,83,"51.46841875","-0.199135704","Broomhouse Lane, Parsons Green",162
"1404",2020,2,657,112,84,"51.4996806","-0.221791552","Blythe Road West, Shepherd's Bush",196
"1405",2020,2,658,366,341,"51.47729232","-0.16478637","Ethelburga Estate, Battersea Park",707
"1406",2020,2,659,112,140,"51.511934","-0.10307894","Blackfriars Station, St. Paul's",252
"1407",2020,2,660,124,116,"51.49087074","-0.206029743","West Kensington Station, West Kensington",240
"1408",2020,2,661,323,330,"51.51632095","-0.202608612","All Saints Church, Portobello",653
"1409",2020,2,662,215,181,"51.48498496","-0.167919869","Phene Street, Chelsea",396
"1410",2020,2,663,106,100,"51.51323001","-0.211593602","Clarendon Road, Avondale",206
"1411",2020,2,664,163,146,"51.474376","-0.155442787","Austin Road, Battersea Park",309
"1412",2020,2,665,142,126,"51.46108367","-0.191722864","Smugglers Way, Wandsworth",268
"1413",2020,2,666,147,138,"51.49610093","-0.208158259","Olympia Way, Olympia",285
"1414",2020,2,667,153,152,"51.5015946","-0.222293381","Shepherd's Bush Road North, Shepherd's Bush",305
"1415",2020,2,668,179,191,"51.49422354","-0.236769936","Ravenscourt Park Station, Hammersmith",370
"1416",2020,2,669,64,51,"51.47614939","-0.1232585","Teversham Lane, Stockwell",115
"1417",2020,2,670,127,129,"51.46718562","-0.152248582","Ashley Crescent, Battersea",256
"1418",2020,2,671,341,350,"51.475089","-0.201968","Parsons Green Station, Parsons Green",691
"1419",2020,2,673,191,178,"51.46517078","-0.18038939","Hibbert Street, Battersea",369
"1420",2020,2,674,125,94,"51.53546778","-0.11619105","Carnegie Street, King's Cross",219
"1421",2020,2,675,148,141,"51.46348914","-0.182126248","Usk Road, Clapham Junction",289
"1422",2020,2,676,212,200,"51.47787084","-0.126874471","Hartington Road, Stockwell",412
"1423",2020,2,677,90,61,"51.46866929","-0.146544642","Heath Road, Battersea",151
"1424",2020,2,678,46,57,"51.46231278","-0.211468596","Esmond Street, Putney",103
"1425",2020,2,679,136,131,"51.47453545","-0.170210533","Orbel Street, Battersea",267
"1426",2020,2,680,331,326,"51.47768469","-0.170329317","Westbridge Road, Battersea",657
"1427",2020,2,681,136,148,"51.47303687","-0.214749808","Bishop's Avenue, Fulham",284
"1428",2020,2,682,217,248,"51.48810829","-0.22660621","Crisp Road, Hammersmith",465
"1429",2020,2,683,118,107,"51.46506424","-0.163750945","Dorothy Road, Clapham Junction",225
"1430",2020,2,684,84,105,"51.45475251","-0.195197203","Neville Gill Close, Wandsworth",189
"1431",2020,2,685,167,160,"51.46067005","-0.198735357","Osiers Road, Wandsworth",327
"1432",2020,2,686,163,139,"51.48814438","-0.222456468","Beryl Road, Hammersmith",302
"1433",2020,2,687,183,174,"51.49760804","-0.21145598","Maclise Road, Olympia",357
"1434",2020,2,688,83,80,"51.46095151","-0.20066766","Northfields, Wandsworth",163
"1435",2020,2,689,52,30,"51.45922541","-0.180884959","Spanish Road, Clapham Junction",82
"1436",2020,2,690,91,69,"51.47047503","-0.152130083","Stanley Grove, Battersea",160
"1437",2020,2,691,161,190,"51.47946386","-0.195777222","Erin Close, Walham Green",351
"1438",2020,2,692,211,214,"51.54211855","-0.028941601","Cadogan Close, Victoria Park",425
"1439",2020,2,693,95,91,"51.464786","-0.215618902","Felsham Road, Putney",186
"1440",2020,2,694,67,68,"51.46071722","-0.216526155","Putney Rail Station, Putney",135
"1441",2020,2,695,413,403,"51.53638435","-0.102757578","Islington Green, Angel",816
"1442",2020,2,696,193,180,"51.48728535","-0.217995921","Charing Cross Hospital, Hammersmith",373
"1443",2020,2,697,131,75,"51.53639219","-0.112721065","Charlotte Terrace, Angel",206
"1444",2020,2,698,177,154,"51.53908372","-0.070329419","Shoreditch Court, Haggerston",331
"1445",2020,2,699,97,65,"51.5366541","-0.07023031","Belford House, Haggerston",162
"1446",2020,2,700,200,162,"51.47696496","-0.174347066","Battersea Church Road, Battersea",362
"1447",2020,2,701,248,245,"51.47287627","-0.176267008","Vicarage Crescent, Battersea",493
"1448",2020,2,702,204,162,"51.52868155","-0.065550321","Durant Street, Bethnal Green",366
"1449",2020,2,703,345,423,"51.51505991","-0.10534448","St. Bride Street, Holborn",768
"1450",2020,2,704,54,47,"51.45682071","-0.202802098","Mexfield Road, East Putney",101
"1451",2020,2,705,47,39,NA,NA,NA,86
"1452",2020,2,706,252,271,"51.50215353","-0.083632928","Snowsfields, London Bridge",523
"1453",2020,2,707,300,282,"51.49021762","-0.215087092","Barons Court Station, West Kensington",582
"1454",2020,2,708,98,112,"51.46161068","-0.21614583","Disraeli Road, Putney",210
"1455",2020,2,709,69,71,"51.46321128","-0.215550761","Montserrat Road , Putney",140
"1456",2020,2,710,204,199,"51.47439218","-0.163347594","Albert Bridge Road, Battersea Park",403
"1457",2020,2,711,138,130,"51.48335692","-0.216305546","Everington Street, Fulham",268
"1458",2020,2,712,193,181,"51.51854104","-0.034903714","Mile End Stadium, Mile End",374
"1459",2020,2,713,79,66,"51.54100708","-0.14326094","Hawley Crescent, Camden Town",145
"1460",2020,2,714,85,81,"51.47311696","-0.137235175","Stewart's Road, Wandsworth Road",166
"1461",2020,2,715,113,74,"51.51563007","-0.049067243","Aylward Street, Stepney",187
"1462",2020,2,716,100,86,"51.51542791","-0.02356501","Stainsby Road , Poplar",186
"1463",2020,2,717,440,372,"51.53658514","-0.075885686","Dunston Road , Haggerston",812
"1464",2020,2,718,244,239,"51.53571683","-0.060291813","Ada Street, Hackney Central",483
"1465",2020,2,719,163,150,"51.53642464","-0.054162264","Victoria Park Road, Hackney Central",313
"1466",2020,2,720,134,116,"51.48724429","-0.205279052","Star Road, West Kensington",250
"1467",2020,2,721,127,122,"51.53603947","-0.026262677","Wendon Street, Old Ford",249
"1468",2020,2,722,163,153,"51.52458353","-0.058631453","Finnis Street, Bethnal Green",316
"1469",2020,2,723,291,281,"51.46822047","-0.190346493","Stephendale Road, Sands End",572
"1470",2020,2,724,84,56,"51.45799126","-0.184806157","Alma Road, Wandsworth",140
"1471",2020,2,725,223,228,"51.491327","-0.096518684","Walworth Square, Walworth",451
"1472",2020,2,726,173,171,"51.47505096","-0.150908371","Alfreda Street, Battersea Park",344
"1473",2020,2,727,217,194,"51.47569809","-0.20587627","Chesilton Road, Fulham",411
"1474",2020,2,728,67,49,"51.46199911","-0.206240805","Putney Bridge Road, East Putney",116
"1475",2020,2,729,255,248,"51.47893931","-0.208485293","St. Peter's Terrace, Fulham",503
"1476",2020,2,730,174,177,"51.49208492","-0.229116862","Bridge Avenue, Hammersmith",351
"1477",2020,2,731,166,170,"51.47727637","-0.189210466","Michael Road, Walham Green",336
"1478",2020,2,732,646,773,"51.50630441","-0.087262995","Duke Street Hill, London Bridge",1419
"1479",2020,2,733,125,126,"51.50542628","-0.150817316","Park Lane, Mayfair",251
"1480",2020,2,734,80,84,"51.46230566","-0.175407201","Plough Terrace, Clapham Junction",164
"1481",2020,2,735,241,248,"51.46489445","-0.17302926","Grant Road East, Clapham Junction",489
"1482",2020,2,736,66,68,"51.50659035","-0.216104479","Queensdale Road, Shepherd's Bush",134
"1483",2020,2,737,562,565,"51.47993289","-0.19411695","Fulham Broadway, Walham Green",1127
"1484",2020,2,738,168,131,"51.47514228","-0.187278987","Imperial Road, Sands End",299
"1485",2020,2,739,189,179,"51.48176572","-0.185273723","Hortensia Road, West Brompton",368
"1486",2020,2,740,33,29,"51.51092871","-0.214594781","Sirdar Road, Avondale",62
"1487",2020,2,741,71,73,"51.5129814","-0.219486603","Freston Road, Avondale",144
"1488",2020,2,742,140,152,"51.51510818","-0.208565479","Blenheim Crescent, Ladbroke Grove",292
"1489",2020,2,743,60,49,"51.46079243","-0.212607684","Oxford Road, Putney",109
"1490",2020,2,744,46,44,"51.46745485","-0.172293499","Ingrave Street, Clapham Junction",90
"1491",2020,2,745,127,112,"51.47816972","-0.18243547","Upcerne Road, West Chelsea",239
"1492",2020,2,746,145,128,"51.4795738","-0.17903854","Lots Road, West Chelsea",273
"1493",2020,2,747,130,133,"51.48796408","-0.161765173","Ormonde Gate, Chelsea",263
"1494",2020,2,748,263,210,"51.53727795","-0.079201849","Hertford Road, De Beauvoir Town",473
"1495",2020,2,749,264,238,"51.53932857","-0.074284675","Haggerston Road, Haggerston",502
"1496",2020,2,750,43,51,"51.4710956","-0.157850096","Culvert Road, Battersea",94
"1497",2020,2,751,160,167,"51.51612862","-0.120909408","Newton Street, Covent Garden",327
"1498",2020,2,754,92,84,"51.5129006","-0.214762686","Grenfell Road, Avondale",176
"1499",2020,2,755,196,209,"51.48512191","-0.174971902","The Vale, Chelsea",405
"1500",2020,2,756,174,159,"51.47515398","-0.159169801","Prince of Wales Drive, Battersea Park",333
"1501",2020,2,757,172,165,"51.48795853","-0.187404506","Harcourt Terrace, West Brompton",337
"1502",2020,2,758,117,98,"51.51787005","-0.201005397","Westbourne Park Road, Portobello",215
"1503",2020,2,759,51,62,"51.52456169","-0.165668686","Broadley Terrace, Marylebone",113
"1504",2020,2,760,67,69,"51.52526975","-0.163795009","Rossmore Road, Marylebone",136
"1505",2020,2,761,202,165,"51.48321729","-0.211860644","Humbolt Road, Fulham",367
"1506",2020,2,762,304,360,"51.50070305","-0.129698963","Storey's Gate, Westminster",664
"1507",2020,2,763,142,127,"51.52059714","-0.032566533","Mile End Park Leisure Centre, Mile End",269
"1508",2020,2,764,129,179,"51.46239255","-0.16829214","St. John's Road, Clapham Junction",308
"1509",2020,2,765,86,85,"51.46760141","-0.20682737","Ranelagh Gardens, Fulham",171
"1510",2020,2,766,207,212,"51.45752945","-0.192165613","Ram Street, Wandsworth",419
"1511",2020,2,767,55,25,"51.45705988","-0.200806304","Santos Road, Wandsworth",80
"1512",2020,2,768,156,144,"51.46134382","-0.159322467","Clapham Common North Side, Clapham Common",300
"1513",2020,2,769,206,175,"51.473611","-0.191803","Sandilands Road, Walham Green",381
"1514",2020,2,770,124,124,"51.491026","-0.209121","Gwendwr Road, West Kensington",248
"1515",2020,2,771,58,62,"51.509224","-0.216016","Rifle Place, Avondale",120
"1516",2020,2,772,271,273,"51.47250956","-0.122831913","Binfield Road, Stockwell",544
"1517",2020,2,773,371,388,"51.511891","-0.107349","Tallis Street, Temple",759
"1518",2020,2,774,72,63,"51.470131","-0.20464","Hurlingham Park, Parsons Green",135
"1519",2020,2,775,100,135,"51.496664","-0.223868","Little Brook Green, Brook Green",235
"1520",2020,2,776,116,104,"51.460333","-0.167029","Abyssinia Close, Clapham Junction",220
"1521",2020,2,777,45,29,"51.4619230679","-0.165297856693","Limburg Road, Clapham Junction",74
"1522",2020,2,779,246,262,"51.514449","-0.077178979","Houndsditch, Aldgate",508
"1523",2020,2,780,263,277,"51.474665","-0.18316517","Imperial Wharf Station, Sands End",540
"1524",2020,2,781,176,209,"51.495898","-0.173009","Victoria & Albert Museum, South Kensington",385
"1525",2020,2,782,195,195,"51.483911","-0.19760944","Halford Road, West Kensington",390
"1526",2020,2,783,233,252,"51.5403115","-0.021630359","Monier Road, Hackney Wick",485
"1527",2020,2,784,155,127,"51.546326","-0.00993526","East Village, Queen Elizabeth Olympic Park",282
"1528",2020,2,785,455,477,"51.54094","-0.010510565","Aquatic Centre, Queen Elizabeth Olympic Park",932
"1529",2020,2,786,137,131,"51.549369","-0.015717614","Lee Valley VeloPark, Queen Elizabeth Olympic Park",268
"1530",2020,2,787,109,115,"51.546805","-0.01469126","Timber Lodge, Queen Elizabeth Olympic Park",224
"1531",2020,2,789,170,160,"51.538718","-0.011889482","Podium, Queen Elizabeth Olympic Park",330
"1532",2020,2,790,204,201,"51.541793","-0.00481","Stratford Station, Stratford",405
"1533",2020,2,792,227,245,"51.505461","-0.10454093","Blackfriars Road, Southwark",472
"1534",2020,2,793,91,85,"51.528279","-0.11955857","Cromer Street, Bloomsbury",176
"1535",2020,2,794,54,62,NA,NA,NA,116
"1536",2020,2,795,151,156,"51.527068","-0.13186102","Euston Square Gardens, Euston",307
"1537",2020,2,796,178,149,"51.524","-0.12640984","Coram Street, Bloomsbury",327
"1538",2020,2,797,249,243,"51.5293","-0.12827903","Ossulston Street, Somers Town",492
"1539",2020,2,798,265,270,"51.5301998755","-0.122299440803","Birkenhead Street, King's Cross",535
"1540",2020,2,799,176,198,"51.4976984561","-0.137598896295","Kings Gate House, Westminster",374
"1541",2020,2,800,201,201,"51.4811219398","-0.149035374873","Sopwith Way, Battersea Park",402
"1542",2020,2,801,237,269,"51.5052241745","-0.0980318118664","Lavington Street, Bankside",506
"1543",2020,2,802,170,128,"51.4765900593","-0.118256789081","Albert Square, Stockwell",298
"1544",2020,2,803,188,198,"51.5054099403","-0.0983410884509","Southwark Street, Bankside",386
"1545",2020,2,804,367,371,"51.5346677396","-0.125078652873","Good's Way, King's Cross",738
"1546",2020,2,806,193,180,"51.5372405623","-0.124807385707","Handyside Street, King's Cross",373
"1547",2020,2,807,206,201,"51.5212","-0.20888818","Bevington Road West, North Kensington",407
"1548",2020,2,808,65,54,NA,NA,NA,119
"1549",2020,2,809,167,166,"51.5162778834","-0.118272991635","Lincoln's Inn Fields, Holborn",333
"1550",2020,2,810,213,239,"51.5067252868","-0.0988072461627","Tate Modern, Bankside",452
"1551",2020,2,811,263,269,"51.5057030357","-0.0277727426235","Westferry Circus, Canary Wharf",532
"1552",2020,2,812,49,65,"51.5487311915","-0.0226065549321","Here East North, Queen Elizabeth Olympic Park",114
"1553",2020,2,813,155,177,"51.4878074485","-0.122759625866","New Spring Gardens Walk, Vauxhall",332
"1554",2020,2,814,73,65,"51.4714330677","-0.123670735702","Clapham Road, Lingham Street, Stockwell",138
"1555",2020,2,815,303,311,"51.5000891978","-0.116628700672","Lambeth Palace Road, Waterloo",614
"1556",2020,2,816,71,77,"51.5465327935","-0.0205975904647","Here East South, Queen Elizabeth Olympic Park",148
"1557",2020,2,817,228,206,"51.4813354746","-0.138212295869","Riverlight South, Nine Elms",434
"1558",2020,2,818,395,417,"51.501513","-0.12382322","Westminster Pier, Westminster",812
"1559",2020,2,819,144,216,"51.50621","-0.114842","Belvedere Road 2, South Bank",360
"1560",2020,2,820,136,113,"51.492807","-0.091938","Victory Place, Walworth",249
"1561",2020,2,821,398,357,"51.4835074867","-0.147714557371","Battersea Power Station, Battersea Park",755
"1562",2020,2,826,498,508,"51.496863","-0.1429434","Allington Street, Victoria",1006
"1563",2020,2,827,210,205,"51.479601","-0.11147178","Cranmer Road, Stockwell",415
"1564",2020,2,828,143,129,"51.473874","-0.11258096","Normandy Road, Stockwell",272
"1565",2020,2,829,69,57,"51.469217","-0.11268674","Wynne Road, Stockwell",126
"1566",2020,2,830,116,98,"51.469202","-0.11902256","Sidney Road, Stockwell",214
"1567",2020,2,831,111,129,"51.466232","-0.11317995","St John's Crescent, Brixton",240
"1568",2020,2,832,152,183,"51.464019","-0.11578197","Ferndale Road, Brixton",335
"1569",2020,2,833,118,129,"51.460232","-0.11537509","Saltoun Road, Brixton",247
"1570",2020,2,834,156,154,"51.477966","-0.14785703","Gas Holders, Battersea Park",310
"1571",2020,2,835,170,172,"51.516785","-0.10494775","Farringdon Street, Holborn",342
"1572",2020,2,836,164,131,"51.541596","-0.12544145","York Way, Kings Cross",295
"1573",2020,2,838,187,191,"51.518093","-0.0914017","Fore Street Avenue, Guildhall",378
"1574",2020,2,839,357,377,"51.508033","-0.10682363","Sea Containers, South Bank",734
"1575",2020,3,1,146,102,"51.52916347","-0.109970527","River Street , Clerkenwell",248
"1576",2020,3,2,220,250,"51.49960695","-0.197574246","Phillimore Gardens, Kensington",470
"1577",2020,3,3,236,266,"51.52128377","-0.084605692","Christopher Street, Liverpool Street",502
"1578",2020,3,4,134,196,"51.53005939","-0.120973687","St. Chad's Street, King's Cross",330
"1579",2020,3,5,312,362,"51.49313","-0.156876","Sedding Street, Sloane Square",674
"1580",2020,3,6,231,236,"51.51811784","-0.144228881","Broadcasting House, Marylebone",467
"1581",2020,3,7,112,109,"51.53430039","-0.1680743","Charlbert Street, St. John's Wood",221
"1582",2020,3,8,158,127,"51.529857","-0.18348604","Maida Vale, Maida Vale",285
"1583",2020,3,9,177,209,"51.5073853","-0.096440751","New Globe Walk, Bankside",386
"1584",2020,3,10,101,121,"51.50597426","-0.092754157","Park Street, Bankside",222
"1585",2020,3,11,197,184,"51.52395143","-0.122502346","Brunswick Square, Bloomsbury",381
"1586",2020,3,12,518,523,"51.52168078","-0.130431727","Malet Street, Bloomsbury",1041
"1587",2020,3,13,139,165,"51.51991453","-0.136039674","Scala Street, Fitzrovia",304
"1588",2020,3,14,1410,1424,"51.52994371","-0.123616824","Belgrove Street , King's Cross",2834
"1589",2020,3,15,233,241,"51.51772703","-0.127854211","Great Russell Street, Bloomsbury",474
"1590",2020,3,16,274,253,"51.52635795","-0.125979294","Cartwright Gardens , Bloomsbury",527
"1591",2020,3,17,410,417,"51.5216612","-0.109006325","Hatton Wall, Holborn",827
"1592",2020,3,18,355,358,"51.51477076","-0.12221963","Drury Lane, Covent Garden",713
"1593",2020,3,19,264,287,"51.52505093","-0.131161087","Taviton Street, Bloomsbury",551
"1594",2020,3,20,188,138,"51.527326","-0.13605286","Drummond Street , Euston",326
"1595",2020,3,21,92,61,"51.53007835","-0.13884627","Hampstead Road (Cartmel), Euston",153
"1596",2020,3,22,257,263,"51.5222641","-0.114079481","Northington Street , Holborn",520
"1597",2020,3,23,161,166,"51.51943538","-0.119123345","Red Lion Square, Holborn",327
"1598",2020,3,24,217,317,"51.51908011","-0.124678402","British Museum, Bloomsbury",534
"1599",2020,3,25,419,344,"51.5288338","-0.132250369","Doric Way , Somers Town",763
"1600",2020,3,26,159,144,"51.52728093","-0.11829517","Ampton Street , Clerkenwell",303
"1601",2020,3,27,289,323,"51.51382102","-0.107927706","Bouverie Street, Temple",612
"1602",2020,3,28,246,230,"51.52351808","-0.143613641","Bolsover Street, Fitzrovia",476
"1603",2020,3,29,175,163,"51.513735","-0.193487","Hereford Road, Bayswater",338
"1604",2020,3,30,239,205,"51.52915444","-0.093421615","Windsor Terrace, Hoxton",444
"1605",2020,3,31,170,170,"51.52953709","-0.083353323","Fanshaw Street, Hoxton",340
"1606",2020,3,32,391,480,"51.52469624","-0.084439283","Leonard Circus , Shoreditch",871
"1607",2020,3,33,206,197,"51.5156","-0.070056","Central House, Aldgate",403
"1608",2020,3,34,148,136,"51.5341235","-0.129386874","Pancras Road, King's Cross",284
"1609",2020,3,36,176,156,"51.50173726","-0.184980612","De Vere Gardens, Kensington",332
"1610",2020,3,37,217,200,"51.49159394","-0.192369256","Penywern Road, Earl's Court",417
"1611",2020,3,38,107,116,"51.4973875","-0.197245586","Abingdon Villas, Kensington",223
"1612",2020,3,39,452,452,"51.5263778","-0.078130921","Shoreditch High Street, Shoreditch",904
"1613",2020,3,40,155,162,"51.52127071","-0.0755789","Commercial Street, Shoreditch",317
"1614",2020,3,41,346,404,"51.520955","-0.083493552","Pindar Street, Liverpool Street",750
"1615",2020,3,42,253,187,"51.53099181","-0.093903825","Wenlock Road , Hoxton",440
"1616",2020,3,43,212,221,"51.52026","-0.157183945","Crawford Street, Marylebone",433
"1617",2020,3,44,133,140,"51.51073687","-0.144165239","Bruton Street, Mayfair",273
"1618",2020,3,45,379,349,"51.522511","-0.162298","Boston Place, Marylebone",728
"1619",2020,3,46,440,426,"51.507131","-0.06691","Nesham Street, Wapping",866
"1620",2020,3,47,219,202,"51.52334476","-0.183846408","Warwick Avenue Station, Maida Vale",421
"1621",2020,3,48,297,388,"51.51248445","-0.099141408","Godliman Street, St. Paul's",685
"1622",2020,3,49,120,147,"51.50706909","-0.145904427","Curzon Street, Mayfair",267
"1623",2020,3,50,200,187,"51.52867339","-0.087459376","East Road, Hoxton",387
"1624",2020,3,51,175,159,"51.52671796","-0.104298194","Finsbury Library , Finsbury",334
"1625",2020,3,52,180,191,"51.52295439","-0.094934859","Roscoe Street, St. Luke's",371
"1626",2020,3,53,102,158,"51.5099923","-0.143495266","Grafton Street, Mayfair",260
"1627",2020,3,54,197,243,"51.52174785","-0.094475072","Golden Lane, Barbican",440
"1628",2020,3,55,543,692,"51.51707521","-0.086685542","Finsbury Circus, Liverpool Street",1235
"1629",2020,3,56,180,177,"51.52058381","-0.154701411","Paddington Street, Marylebone",357
"1630",2020,3,57,272,272,"51.52334672","-0.120202614","Guilford Street , Bloomsbury",544
"1631",2020,3,58,312,309,"51.52452699","-0.079248081","New Inn Yard, Shoreditch",621
"1632",2020,3,60,90,73,"51.52644828","-0.172190727","Lisson Grove, St. John's Wood",163
"1633",2020,3,61,197,184,"51.49738251","-0.089446947","Great Dover Street, The Borough",381
"1634",2020,3,62,82,74,"51.4907579","-0.106323685","Cotton Garden Estate, Kennington",156
"1635",2020,3,63,128,94,"51.53089041","-0.089782579","Murray Grove , Hoxton",222
"1636",2020,3,64,360,483,"51.50946212","-0.124749274","William IV Street, Strand",843
"1637",2020,3,65,218,220,NA,NA,NA,438
"1638",2020,3,66,543,810,"51.51795029","-0.108657431","Holborn Circus, Holborn",1353
"1639",2020,3,67,326,320,"51.51882555","-0.108028472","Hatton Garden, Holborn",646
"1640",2020,3,68,293,279,"51.52059681","-0.116688468","Theobald's Road , Holborn",572
"1641",2020,3,69,174,185,"51.5262363","-0.134407652","Euston Road, Euston",359
"1642",2020,3,70,122,75,"51.53136059","-0.117069978","Calshot Street , King's Cross",197
"1643",2020,3,71,543,585,"51.5154186","-0.098850915","Newgate Street , St. Paul's",1128
"1644",2020,3,72,207,211,"51.52352001","-0.108340165","Farringdon Lane, Clerkenwell",418
"1645",2020,3,73,461,453,"51.52572618","-0.088486188","Old Street Station, St. Luke's",914
"1646",2020,3,74,493,506,"51.48591714","-0.124469948","Vauxhall Cross, Vauxhall",999
"1647",2020,3,75,196,200,"51.53219984","-0.105480698","Torrens Street, Angel",396
"1648",2020,3,76,89,77,"51.52559505","-0.144083893","Longford Street, The Regent's Park",166
"1649",2020,3,77,238,216,"51.52341837","-0.124121774","Russell Square Station, Bloomsbury",454
"1650",2020,3,78,266,250,"51.52486887","-0.099489485","Sadlers Sports Centre, Finsbury",516
"1651",2020,3,79,85,119,"51.511726","-0.11385596","Arundel Street, Temple",204
"1652",2020,3,80,188,154,"51.50069361","-0.102091246","Webber Street , Southwark",342
"1653",2020,3,81,226,243,"51.52025302","-0.141327271","Great Titchfield Street, Fitzrovia",469
"1654",2020,3,82,151,171,"51.514274","-0.111257","Chancery Lane, Holborn",322
"1655",2020,3,83,228,254,"51.50963938","-0.131510949","Panton Street, West End",482
"1656",2020,3,84,204,207,"51.51593725","-0.111778348","Breams Buildings, Holborn",411
"1657",2020,3,85,254,254,"51.50064702","-0.078600401","Tanner Street, Bermondsey",508
"1658",2020,3,86,143,129,"51.48947903","-0.115156562","Sancroft Street, Vauxhall",272
"1659",2020,3,87,251,257,"51.51646835","-0.079684557","Devonshire Square, Liverpool Street",508
"1660",2020,3,88,322,371,"51.51858757","-0.132053392","Bayley Street , Bloomsbury",693
"1661",2020,3,89,246,228,"51.5262503","-0.123509611","Tavistock Place, Bloomsbury",474
"1662",2020,3,90,71,57,"51.53301907","-0.139174593","Harrington Square 1, Camden Town",128
"1663",2020,3,91,148,124,"51.49368637","-0.111014912","Walnut Tree Walk, Vauxhall",272
"1664",2020,3,92,157,174,"51.49889832","-0.100440521","Borough Road, Elephant & Castle",331
"1665",2020,3,93,175,84,"51.53440868","-0.109025404","Cloudesley Road, Angel",259
"1666",2020,3,94,272,249,"51.49506109","-0.085814489","Bricklayers Arms, Borough",521
"1667",2020,3,95,400,401,"51.5208417","-0.097340162","Aldersgate Street, Barbican",801
"1668",2020,3,96,179,184,"51.53095071","-0.078505384","Falkirk Street, Hoxton",363
"1669",2020,3,97,229,227,"51.49792478","-0.183834706","Gloucester Road (North), Kensington",456
"1670",2020,3,98,276,248,"51.52554222","-0.138231303","Hampstead Road, Euston",524
"1671",2020,3,99,303,299,"51.51457763","-0.158264483","Old Quebec Street, Marylebone",602
"1672",2020,3,100,168,177,"51.49043573","-0.122806861","Albert Embankment, Vauxhall",345
"1673",2020,3,101,616,630,"51.51155322","-0.0929401","Queen Street 1, Bank",1246
"1674",2020,3,102,276,308,"51.51340693","-0.076793375","Jewry Street, Aldgate",584
"1675",2020,3,103,110,84,"51.50472376","-0.192538767","Vicarage Gate, Kensington",194
"1676",2020,3,104,631,671,"51.51159481","-0.077121322","Crosswall, Tower",1302
"1677",2020,3,105,168,166,"51.51552971","-0.190240716","Westbourne Grove, Bayswater",334
"1678",2020,3,106,104,97,"51.51410514","-0.147301667","Woodstock Street, Mayfair",201
"1679",2020,3,107,456,461,"51.52600832","-0.096317627","Finsbury Leisure Centre, St. Luke's",917
"1680",2020,3,108,275,333,"51.49812559","-0.132102166","Abbey Orchard Street, Westminster",608
"1681",2020,3,109,472,613,"51.51563144","-0.132328837","Soho Square , Soho",1085
"1682",2020,3,110,110,86,"51.53304322","-0.172528678","Wellington Road, St. John's Wood",196
"1683",2020,3,111,271,293,"51.5100172","-0.157275636","Park Lane , Hyde Park",564
"1684",2020,3,112,180,191,"51.51580998","-0.105270275","Stonecutter Street, Holborn",371
"1685",2020,3,113,136,155,"51.49646288","-0.183289032","Gloucester Road (Central), South Kensington",291
"1686",2020,3,114,229,228,"51.52451738","-0.158963647","Park Road (Baker Street), The Regent's Park",457
"1687",2020,3,115,321,359,"51.51423368","-0.073537654","Braham Street, Aldgate",680
"1688",2020,3,116,369,415,"51.51449962","-0.141423695","Little Argyll Street, West End",784
"1689",2020,3,117,226,244,"51.49288067","-0.114934001","Lollard Street, Vauxhall",470
"1690",2020,3,118,140,185,"51.49582705","-0.13547809","Rochester Row, Westminster",325
"1691",2020,3,119,368,371,"51.52589324","-0.090847761","Bath Street, St. Luke's",739
"1692",2020,3,120,181,168,"51.51573534","-0.093080779","The Guildhall, Guildhall",349
"1693",2020,3,121,251,256,"51.51891348","-0.156166631","Baker Street, Marylebone",507
"1694",2020,3,122,251,279,"51.52111369","-0.078869751","Norton Folgate, Liverpool Street",530
"1695",2020,3,123,136,115,"51.52836014","-0.104724625","St. John Street, Finsbury",251
"1696",2020,3,124,91,84,"51.49654462","-0.150905245","Eaton Square, Belgravia",175
"1697",2020,3,125,197,200,"51.50069491","-0.094524319","Borough High Street, The Borough",397
"1698",2020,3,126,334,330,"51.51782144","-0.096496865","Museum of London, Barbican",664
"1699",2020,3,127,161,151,"51.51700801","-0.09388536","Wood Street, Guildhall",312
"1700",2020,3,128,124,136,"51.49536226","-0.185296516","Emperor's Gate, South Kensington",260
"1701",2020,3,129,213,248,"51.5118973","-0.137043852","Golden Square, Soho",461
"1702",2020,3,130,357,414,"51.50950627","-0.075459482","Tower Gardens , Tower",771
"1703",2020,3,131,120,101,"51.53300545","-0.136792671","Eversholt Street , Camden Town",221
"1704",2020,3,132,625,631,"51.52364804","-0.074754872","Bethnal Green Road, Shoreditch",1256
"1705",2020,3,133,405,406,NA,NA,NA,811
"1706",2020,3,134,115,115,"51.504904","-0.06797","Wapping High Street, Wapping",230
"1707",2020,3,135,363,368,"51.52326004","-0.104708922","Clerkenwell Green, Clerkenwell",731
"1708",2020,3,136,293,304,"51.51196176","-0.097441687","Queen Victoria Street, St. Paul's",597
"1709",2020,3,138,201,237,"51.51227622","-0.157436972","Green Street, Mayfair",438
"1710",2020,3,139,145,151,"51.49488108","-0.117974901","Lambeth Road, Vauxhall",296
"1711",2020,3,140,336,360,"51.52096262","-0.085634242","Finsbury Square , Moorgate",696
"1712",2020,3,141,224,245,"51.51530805","-0.147203711","Chapel Place, Marylebone",469
"1713",2020,3,142,125,131,"51.49372451","-0.198286569","West Cromwell Road, Earl's Court",256
"1714",2020,3,143,187,193,"51.4968865","-0.161203828","Pont Street, Knightsbridge",380
"1715",2020,3,144,337,287,"51.48894022","-0.111435796","Kennington Cross, Kennington",624
"1716",2020,3,145,40,26,"51.50074359","-0.202759212","Ilchester Place, Kensington",66
"1717",2020,3,146,99,85,"51.48836528","-0.129361842","Vauxhall Bridge , Pimlico",184
"1718",2020,3,148,240,222,"51.49211134","-0.138364847","Tachbrook Street, Victoria",462
"1719",2020,3,149,157,161,"51.48478899","-0.110683213","Kennington Road Post Office, Oval",318
"1720",2020,3,150,141,157,"51.49705603","-0.168917077","Holy Trinity Brompton, Knightsbridge",298
"1721",2020,3,151,177,131,"51.51213691","-0.201554966","Chepstow Villas, Notting Hill",308
"1722",2020,3,152,190,169,"51.49217002","-0.101536865","Hampton Street, Walworth",359
"1723",2020,3,153,389,409,"51.511933","-0.174411","Bayswater Road, Hyde Park",798
"1724",2020,3,154,1537,1479,"51.50379168","-0.11282408","Waterloo Station 3, Waterloo",3016
"1725",2020,3,155,197,169,"51.49586666","-0.191933711","Lexham Gardens, Kensington",366
"1726",2020,3,156,166,140,"51.49443626","-0.092921165","New Kent Road, The Borough",306
"1727",2020,3,157,214,211,"51.50039792","-0.193068385","Wright's Lane, Kensington",425
"1728",2020,3,158,178,166,"51.49085368","-0.196170309","Trebovir Road, Earl's Court",344
"1729",2020,3,159,348,387,"51.51461995","-0.137841333","Great Marlborough Street, Soho",735
"1730",2020,3,160,166,198,"51.50663341","-0.131773845","Waterloo Place, St. James's",364
"1731",2020,3,161,28,32,"51.49234577","-0.141334487","Guildhouse Street, Victoria",60
"1732",2020,3,162,214,238,"51.51760685","-0.121328408","Southampton Place, Holborn",452
"1733",2020,3,163,277,299,"51.4931848","-0.167894973","Sloane Avenue, Knightsbridge",576
"1734",2020,3,164,147,116,"51.515607","-0.183118788","Cleveland Gardens, Bayswater",263
"1735",2020,3,165,70,44,"51.517932","-0.183716959","Orsett Terrace, Bayswater",114
"1736",2020,3,166,116,175,"51.50185512","-0.159237081","Seville Street, Knightsbridge",291
"1737",2020,3,167,378,406,"51.49395092","-0.147624377","Eccleston Place, Victoria",784
"1738",2020,3,168,125,118,"51.50040123","-0.195455928","Argyll Road, Kensington",243
"1739",2020,3,169,215,207,"51.51474612","-0.165164288","Porchester Place, Paddington",422
"1740",2020,3,170,121,92,"51.52784273","-0.108068155","Hardwick Street, Clerkenwell",213
"1741",2020,3,171,132,123,"51.4916156","-0.186753859","Collingham Gardens, Earl's Court",255
"1742",2020,3,172,128,135,"51.49121192","-0.173715911","Sumner Place, South Kensington",263
"1743",2020,3,173,184,209,"51.50486","-0.113001","Waterloo Road, South Bank",393
"1744",2020,3,174,219,260,"51.512529","-0.115163","Strand, Strand",479
"1745",2020,3,175,291,308,"51.521668","-0.079608554","Worship Street, Shoreditch",599
"1746",2020,3,176,139,120,"51.51791921","-0.188098863","Gloucester Terrace, Bayswater",259
"1747",2020,3,177,405,425,"51.49616092","-0.140947636","Ashley Place, Victoria",830
"1748",2020,3,178,214,182,"51.48985626","-0.141923621","Warwick Square, Pimlico",396
"1749",2020,3,180,157,201,"51.5129118","-0.153645496","North Audley Street, Mayfair",358
"1750",2020,3,181,107,107,"51.49941247","-0.152317537","Belgrave Square, Belgravia",214
"1751",2020,3,182,191,174,"51.52202903","-0.165842551","Bell Street , Marylebone",365
"1752",2020,3,183,247,229,"51.482362","-0.13612398","Riverlight North, Nine Elms",476
"1753",2020,3,184,179,175,"51.52071513","-0.14521173","Portland Place, Marylebone",354
"1754",2020,3,185,244,233,"51.48805753","-0.140741432","Alderney Street, Pimlico",477
"1755",2020,3,186,571,539,"51.51733558","-0.175810943","South Wharf Road, Paddington",1110
"1756",2020,3,187,173,193,"51.49247977","-0.178433004","Queen's Gate (South), South Kensington",366
"1757",2020,3,188,127,111,"51.5165179","-0.164393768","Nutford Place, Marylebone",238
"1758",2020,3,189,159,75,"51.53166681","-0.109914711","Claremont Square, Angel",234
"1759",2020,3,190,231,216,"51.48997562","-0.132845681","Rampayne Street, Pimlico",447
"1760",2020,3,191,796,800,"51.50311799","-0.153520935","Hyde Park Corner, Hyde Park",1596
"1761",2020,3,192,364,379,"51.51251523","-0.133201961","Wardour Street, Soho",743
"1762",2020,3,193,358,408,"51.50581776","-0.100186337","Bankside Mix, Bankside",766
"1763",2020,3,194,675,968,"51.50462759","-0.091773776","Hop Exchange, The Borough",1643
"1764",2020,3,195,280,282,"51.50724437","-0.106237501","Milroy Walk, South Bank",562
"1765",2020,3,196,224,243,"51.50368837","-0.098497684","Union Street, The Borough",467
"1766",2020,3,197,306,370,"51.50556905","-0.111606696","Stamford Street, South Bank",676
"1767",2020,3,199,469,521,"51.51048489","-0.082989638","Great Tower Street, Monument",990
"1768",2020,3,200,242,222,"51.51492456","-0.066078037","LMU Commercial Road, Whitechapel",464
"1769",2020,3,201,261,272,"51.5225965","-0.161113413","Dorset Square, Marylebone",533
"1770",2020,3,202,411,409,"51.51236389","-0.06954201","Leman Street, Aldgate",820
"1771",2020,3,203,311,312,"51.51821864","-0.100791005","West Smithfield Rotunda, Farringdon",623
"1772",2020,3,204,148,144,"51.52659961","-0.112432615","Margery Street, Clerkenwell",292
"1773",2020,3,206,246,238,"51.518154","-0.062697","New Road 1 , Whitechapel",484
"1774",2020,3,207,65,63,"51.50135267","-0.153194766","Grosvenor Crescent, Belgravia",128
"1775",2020,3,208,69,63,"51.52505151","-0.166304359","Mallory Street, Marylebone",132
"1776",2020,3,209,99,100,"51.49358391","-0.165101392","Denyer Street, Knightsbridge",199
"1777",2020,3,210,279,318,"51.51681444","-0.151926305","Hinde Street, Marylebone",597
"1778",2020,3,211,146,164,"51.49464523","-0.158105512","Cadogan Place, Knightsbridge",310
"1779",2020,3,212,96,61,"51.50658458","-0.199004026","Campden Hill Road, Notting Hill",157
"1780",2020,3,213,490,461,"51.50274025","-0.149569201","Wellington Arch, Hyde Park",951
"1781",2020,3,214,403,395,"51.52683806","-0.130504336","Endsleigh Gardens, Euston",798
"1782",2020,3,215,458,509,"51.51906932","-0.088285377","Moorfields, Moorgate",967
"1783",2020,3,216,207,194,"51.49094565","-0.181190899","Old Brompton Road, South Kensington",401
"1784",2020,3,217,798,836,"51.51615461","-0.082422399","Wormwood Street, Liverpool Street",1634
"1785",2020,3,218,166,176,"51.48971651","-0.170194408","St. Luke's Church, Chelsea",342
"1786",2020,3,219,227,188,"51.49016361","-0.19039362","Bramham Gardens, Earl's Court",415
"1787",2020,3,220,104,111,"51.49066456","-0.166485083","Chelsea Green, Chelsea",215
"1788",2020,3,221,263,280,"51.49481649","-0.13045856","Horseferry Road, Westminster",543
"1789",2020,3,222,82,47,"51.50275704","-0.155349725","Knightsbridge, Hyde Park",129
"1790",2020,3,223,220,179,"51.49148474","-0.090220911","Rodney Road , Walworth",399
"1791",2020,3,224,231,228,"51.51031","-0.18740235","Queensway, Kensington Gardens",459
"1792",2020,3,225,400,302,"51.50935342","-0.196422","Notting Hill Gate Station, Notting Hill",702
"1793",2020,3,226,184,218,"51.50844614","-0.131961389","Charles II Street, West End",402
"1794",2020,3,227,204,185,"51.52891573","-0.115480888","Great Percy Street, Clerkenwell",389
"1795",2020,3,228,398,585,"51.50742485","-0.134621209","St. James's Square, St. James's",983
"1796",2020,3,229,369,399,"51.50654321","-0.123179697","Whitehall Place, Strand",768
"1797",2020,3,230,149,191,"51.50669284","-0.103137426","Poured Lines, Bankside",340
"1798",2020,3,231,214,241,"51.49396755","-0.17873226","Queen's Gate (Central), South Kensington",455
"1799",2020,3,232,93,108,"51.51501025","-0.112753217","Carey Street, Holborn",201
"1800",2020,3,233,216,335,"51.50777049","-0.130699733","Pall Mall East, West End",551
"1801",2020,3,234,264,258,"51.53450449","-0.106992706","Liverpool Road (N1 Centre), Angel",522
"1802",2020,3,235,126,125,"51.49571828","-0.110889274","Kennington Road  , Vauxhall",251
"1803",2020,3,236,135,142,"51.51838043","-0.073438925","Fashion Street, Whitechapel",277
"1804",2020,3,237,182,184,"51.5097860151","-0.0681619805156","Dock Street, Wapping",366
"1805",2020,3,238,108,70,"51.5233534","-0.175116099","Frampton Street, Paddington",178
"1806",2020,3,239,327,334,"51.52443845","-0.138019439","Warren Street Station, Euston",661
"1807",2020,3,240,81,85,"51.50545935","-0.10569204","Colombo Street, Southwark",166
"1808",2020,3,242,184,208,"51.52200801","-0.151359288","Beaumont Street, Marylebone",392
"1809",2020,3,243,260,233,"51.49096258","-0.139625122","Gloucester Street, Pimlico",493
"1810",2020,3,244,250,278,"51.51611887","-0.128585022","Earnshaw Street , Covent Garden",528
"1811",2020,3,245,107,77,"51.4853572","-0.142207481","Grosvenor Road, Pimlico",184
"1812",2020,3,246,344,365,"51.52285301","-0.099994052","Berry Street, Clerkenwell",709
"1813",2020,3,247,94,49,"51.530529","-0.167515","St. John's Wood Church, The Regent's Park",143
"1814",2020,3,248,368,369,"51.50645179","-0.170279555","Triangle Car Park, Hyde Park",737
"1815",2020,3,249,132,122,"51.49859784","-0.096191134","Harper Road, The Borough",254
"1816",2020,3,250,75,84,"51.489932","-0.162727","Royal Avenue 1, Chelsea",159
"1817",2020,3,251,583,739,"51.518908","-0.079249","Brushfield Street, Liverpool Street",1322
"1818",2020,3,252,362,364,"51.5046364","-0.116542278","Jubilee Gardens, South Bank",726
"1819",2020,3,253,284,205,"51.53404294","-0.086379717","Shoreditch Park, Hoxton",489
"1820",2020,3,254,274,230,"51.53051587","-0.106408455","Chadwell Street, Angel",504
"1821",2020,3,255,138,132,"51.52557531","-0.179592915","Clifton Road, Maida Vale",270
"1822",2020,3,256,112,111,"51.51362054","-0.116764211","Houghton Street, Strand",223
"1823",2020,3,257,111,100,"51.52248185","-0.154907218","Westminster University, Marylebone",211
"1824",2020,3,258,136,133,NA,NA,NA,269
"1825",2020,3,259,152,155,"51.490959","-0.1532331","Bourne Street, Belgravia",307
"1826",2020,3,260,205,247,"51.5136846","-0.135580879","Broadwick Street, Soho",452
"1827",2020,3,261,94,75,"51.5134891","-0.191351186","Princes Square, Bayswater",169
"1828",2020,3,262,167,144,"51.49874469","-0.103132904","LSBU (Borough Road), Elephant & Castle",311
"1829",2020,3,263,202,232,"51.51422502","-0.080660083","St. Mary Axe, Aldgate",434
"1830",2020,3,264,295,309,"51.52644342","-0.109256828","Tysoe Street, Clerkenwell",604
"1831",2020,3,265,184,164,"51.51595344","-0.169249375","Southwick Street, Paddington",348
"1832",2020,3,266,296,272,"51.50102668","-0.180246101","Queen's Gate (North), Kensington",568
"1833",2020,3,267,179,179,"51.49206037","-0.132224622","Regency Street, Westminster",358
"1834",2020,3,268,307,311,"51.49320445","-0.144132875","Belgrave Road, Victoria",618
"1835",2020,3,269,203,211,"51.50082346","-0.089740764","Empire Square, The Borough",414
"1836",2020,3,270,541,539,"51.4863434","-0.122492418","Kennington Lane Rail Bridge, Vauxhall",1080
"1837",2020,3,271,110,85,"51.53583617","-0.156285395","London Zoo,  The Regent's Park",195
"1838",2020,3,272,419,454,"51.50144456","-0.110699309","Baylis Road, Waterloo",873
"1839",2020,3,273,293,346,"51.50613324","-0.114686385","Belvedere Road 1, South Bank",639
"1840",2020,3,274,146,148,"51.49671237","-0.20528437","Warwick Road, Olympia",294
"1841",2020,3,275,236,258,"51.52004497","-0.092176447","Barbican Centre, Barbican",494
"1842",2020,3,276,137,147,"51.50930161","-0.084985356","Lower Thames Street, Monument",284
"1843",2020,3,277,199,186,"51.50315739","-0.191496313","Kensington Church Street, Kensington",385
"1844",2020,3,278,586,594,"51.5034938","-0.07962099","Tooley Street, Bermondsey",1180
"1845",2020,3,279,253,237,"51.51862243","-0.176645823","North Wharf Road, Paddington",490
"1846",2020,3,280,190,185,"51.490083","-0.162418","Royal Avenue 2, Chelsea",375
"1847",2020,3,281,193,187,"51.49580589","-0.127575233","Smith Square, Westminster",380
"1848",2020,3,282,418,405,"51.51906446","-0.059642081","Royal London Hospital, Whitechapel",823
"1849",2020,3,283,55,58,"51.51440928","-0.118478757","Kingsway, Covent Garden",113
"1850",2020,3,284,160,152,"51.49914063","-0.112031483","Lambeth North Station, Waterloo",312
"1851",2020,3,286,104,54,"51.5272947","-0.174653609","St. John's Wood Road, St. John's Wood",158
"1852",2020,3,287,174,157,"51.52367314","-0.128377673","Bedford Way, Bloomsbury",331
"1853",2020,3,288,276,285,"51.49236962","-0.147478734","Elizabeth Bridge, Victoria",561
"1854",2020,3,289,77,72,"51.50923022","-0.151296092","South Audley Street, Mayfair",149
"1855",2020,3,290,150,114,"51.518268","-0.17110323","St Mary's Hospital, Paddington",264
"1856",2020,3,291,186,153,"51.48483991","-0.138089062","Claverton Street, Pimlico",339
"1857",2020,3,292,175,210,"51.49888404","-0.165471605","Montpelier Street, Knightsbridge",385
"1858",2020,3,293,110,99,"51.49815779","-0.209494128","Kensington Olympia Station, Olympia",209
"1859",2020,3,294,249,232,"51.488226","-0.135635511","St. George's Square, Pimlico",481
"1860",2020,3,295,213,189,"51.50029631","-0.092762704","Swan Street, The Borough",402
"1861",2020,3,296,124,122,"51.49363156","-0.190603326","Knaresborough Place, Earl's Court",246
"1862",2020,3,297,47,40,"51.49612799","-0.106000855","Geraldine Street, Elephant & Castle",87
"1863",2020,3,298,356,369,"51.50227992","-0.074189225","Curlew Street, Shad Thames",725
"1864",2020,3,299,97,114,"51.49398524","-0.136928582","Vincent Square, Westminster",211
"1865",2020,3,300,389,397,"51.505014","-0.17306032","Serpentine Car Park, Hyde Park",786
"1866",2020,3,301,233,293,"51.51475963","-0.148105415","Marylebone Lane, Marylebone",526
"1867",2020,3,302,121,142,"51.466907","-0.216573","Putney Pier, Wandsworth",263
"1868",2020,3,303,514,494,"51.50295379","-0.158456089","Albert Gate, Hyde Park",1008
"1869",2020,3,306,185,184,"51.51816295","-0.135025698","Rathbone Street, Fitzrovia",369
"1870",2020,3,307,433,438,"51.50990837","-0.187842717","Black Lion Gate, Kensington Gardens",871
"1871",2020,3,308,189,162,"51.49907558","-0.085666316","Long Lane , Bermondsey",351
"1872",2020,3,309,107,121,"51.50963123","-0.119047563","Embankment (Savoy), Strand",228
"1873",2020,3,310,231,209,"51.4908679","-0.116911864","Black Prince Road, Vauxhall",440
"1874",2020,3,311,203,212,"51.51918144","-0.140485596","Foley Street, Fitzrovia",415
"1875",2020,3,312,120,96,"51.53088935","-0.176770502","Grove End Road, St. John's Wood",216
"1876",2020,3,313,296,308,"51.51734403","-0.138072691","Wells Street, Fitzrovia",604
"1877",2020,3,314,195,189,"51.50088934","-0.083159352","Tyers Gate, Bermondsey",384
"1878",2020,3,315,125,117,"51.52536703","-0.153463612","The Tennis Courts, The Regent's Park",242
"1879",2020,3,316,152,148,NA,NA,NA,300
"1880",2020,3,317,94,77,"51.49679128","-0.093913472","Dickens Square, Borough",171
"1881",2020,3,318,208,262,"51.51004801","-0.138846453","Sackville Street, Mayfair",470
"1882",2020,3,319,243,246,"51.52702563","-0.088542771","Baldwin Street, St. Luke's",489
"1883",2020,3,320,331,331,"51.49357351","-0.139956043","Queen Mother Sports Centre, Victoria",662
"1884",2020,3,321,332,318,"51.49785559","-0.081608045","Bermondsey Street, Bermondsey",650
"1885",2020,3,322,135,119,"51.526293","-0.073955","Palissy Street, Shoreditch",254
"1886",2020,3,323,158,150,"51.523196","-0.083067","Clifton Street, Shoreditch",308
"1887",2020,3,324,193,199,"51.49652013","-0.101384068","Ontario Street, Elephant & Castle",392
"1888",2020,3,325,129,151,"51.50908747","-0.129697889","St. Martin's Street, West End",280
"1889",2020,3,326,286,269,"51.53266186","-0.099981142","Graham Street, Angel",555
"1890",2020,3,327,69,39,"51.53095","-0.085603","New North Road 1, Hoxton",108
"1891",2020,3,328,104,73,"51.53114","-0.086016","New North Road 2, Hoxton",177
"1892",2020,3,329,153,148,"51.53589283","-0.160854428","Prince Albert Road, The Regent's Park",301
"1893",2020,3,330,296,236,"51.51641749","-0.179135079","Eastbourne Mews, Paddington",532
"1894",2020,3,331,373,393,"51.52085887","-0.089887855","Bunhill Row, Moorgate",766
"1895",2020,3,332,85,52,"51.49334336","-0.194757949","Nevern Place, Earl's Court",137
"1896",2020,3,333,216,171,"51.50860544","-0.193764092","Palace Gardens Terrace, Notting Hill",387
"1897",2020,3,334,150,162,"51.505044","-0.115851","Concert Hall Approach 1, South Bank",312
"1898",2020,3,335,229,286,"51.51196803","-0.120718759","Tavistock Street, Covent Garden",515
"1899",2020,3,336,120,203,"51.504942","-0.115533","Concert Hall Approach 2, South Bank",323
"1900",2020,3,337,105,99,"51.51108452","-0.197524944","Pembridge Villas, Notting Hill",204
"1901",2020,3,338,373,402,"51.51175646","-0.119643424","Wellington Street , Strand",775
"1902",2020,3,339,130,81,"51.5333196","-0.1117812","Risinghill Street, Angel",211
"1903",2020,3,340,451,467,"51.51444134","-0.087587447","Bank of England Museum, Bank",918
"1904",2020,3,341,495,535,"51.50810309","-0.12602103","Craven Street, Strand",1030
"1905",2020,3,343,128,111,"51.53692216","-0.150181444","London Zoo Car Park, The Regent's Park",239
"1906",2020,3,344,164,144,"51.528246","-0.10102611","Goswell Road (City Uni), Finsbury",308
"1907",2020,3,345,377,373,"51.48802358","-0.166878535","Flood Street, Chelsea",750
"1908",2020,3,347,192,209,"51.50013942","-0.113936001","Lower Marsh, Waterloo",401
"1909",2020,3,348,149,205,"51.51217033","-0.150481272","Grosvenor Square, Mayfair",354
"1910",2020,3,349,161,213,"51.51196","-0.142783033","St. George Street, Mayfair",374
"1911",2020,3,350,256,285,"51.5017154373867","-0.1798541843891","Queen's Gate, Kensington Gardens",541
"1912",2020,3,351,240,185,"51.529423","-0.097122","Macclesfield Rd, St Lukes",425
"1913",2020,3,352,153,153,"51.486965","-0.116625","Vauxhall Street, Vauxhall",306
"1914",2020,3,353,111,116,"51.49459148","-0.134234258","Greycoat Street , Westminster",227
"1915",2020,3,354,247,346,"51.506767","-0.123702","Northumberland Avenue, Strand",593
"1916",2020,3,355,71,76,NA,NA,NA,147
"1917",2020,3,356,440,475,"51.494412","-0.173881","South Kensington Station, South Kensington",915
"1918",2020,3,357,285,338,"51.520994","-0.139016","Howland Street, Fitzrovia",623
"1919",2020,3,358,224,225,"51.516226","-0.124826","High Holborn , Covent Garden",449
"1920",2020,3,359,26,11,"51.49782999","-0.135440826","Butler Place, Westminster",37
"1921",2020,3,360,295,383,"51.49675303","-0.138733562","Howick Place, Westminster",678
"1922",2020,3,361,554,471,"51.50391973","-0.11342629","Waterloo Station 2, Waterloo",1025
"1923",2020,3,362,192,152,"51.536264","-0.133952","Royal College Street, Camden Town",344
"1924",2020,3,363,62,46,"51.5291212008901","-0.171185284853","Lord's, St. John's Wood",108
"1925",2020,3,364,253,247,"51.519656","-0.132339","Alfred Place, Bloomsbury",500
"1926",2020,3,365,251,169,"51.530344","-0.100168","City Road, Angel",420
"1927",2020,3,366,78,123,"51.5109192966489","-0.1511263847351","Millennium Hotel, Mayfair",201
"1928",2020,3,367,129,102,"51.5173721","-0.1642075","Harrowby Street, Marylebone",231
"1929",2020,3,368,228,248,"51.50024195","-0.15934065","Harriet Street, Knightsbridge",476
"1930",2020,3,370,80,53,"51.520205","-0.174593","Paddington Green, Paddington",133
"1931",2020,3,371,86,78,"51.49775","-0.10988","King Edward Walk, Waterloo",164
"1932",2020,3,372,145,188,"51.515208","-0.117863","Sardinia Street, Holborn",333
"1933",2020,3,373,138,196,"51.49980661","-0.176415994","Prince Consort Road, Knightsbridge",334
"1934",2020,3,374,1216,1247,"51.50402794","-0.11386436","Waterloo Station 1, Waterloo",2463
"1935",2020,3,375,91,96,"51.50194596","-0.194392952","Kensington Town Hall, Kensington",187
"1936",2020,3,376,264,292,"51.49188409","-0.125674815","Millbank Tower, Pimlico",556
"1937",2020,3,377,98,103,"51.50535447","-0.113656543","Waterloo Bridge, South Bank",201
"1938",2020,3,378,122,160,"51.49559291","-0.179077626","Natural History Museum, South Kensington",282
"1939",2020,3,379,186,153,"51.51431171","-0.200838199","Turquoise Island, Notting Hill",339
"1940",2020,3,380,94,115,"51.50686435","-0.150666888","Stanhope Gate, Mayfair",209
"1941",2020,3,381,180,199,"51.51953043","-0.13577731","Charlotte Street, Fitzrovia",379
"1942",2020,3,382,101,111,"51.50935171","-0.14744969","Farm Street, Mayfair",212
"1943",2020,3,383,220,257,"51.51310333","-0.13121385","Frith Street, Soho",477
"1944",2020,3,384,74,67,"51.496481","-0.192404","Marloes Road, Kensington",141
"1945",2020,3,386,316,323,"51.51352755","-0.130110822","Moor Street, Soho",639
"1946",2020,3,387,208,191,"51.49369988","-0.121394101","Fire Brigade Pier, Vauxhall",399
"1947",2020,3,388,238,265,"51.51070161","-0.121723604","Southampton Street, Strand",503
"1948",2020,3,389,29,21,"51.51013066","-0.155757901","Upper Grosvenor Street, Mayfair",50
"1949",2020,3,390,90,93,"51.521776","-0.068856","Buxton Street 1, Shoreditch",183
"1950",2020,3,392,310,397,"51.49942855","-0.179702476","Imperial College, Knightsbridge",707
"1951",2020,3,393,342,351,"51.51733427","-0.103604248","Snow Hill, Farringdon",693
"1952",2020,3,394,117,57,"51.524826","-0.176268","Aberdeen Place, St. John's Wood",174
"1953",2020,3,395,242,247,"51.492462","-0.159919","Cadogan Gardens, Chelsea",489
"1954",2020,3,396,142,137,"51.51809","-0.163609","Shouldham Street, Marylebone",279
"1955",2020,3,397,233,198,"51.51348","-0.17977","Devonshire Terrace, Bayswater",431
"1956",2020,3,398,129,83,"51.502319","-0.200742","Holland Park, Kensington",212
"1957",2020,3,399,212,223,"51.52261762","-0.071653961","Brick Lane Market, Shoreditch",435
"1958",2020,3,400,156,193,"51.517703","-0.154106","George Street, Marylebone",349
"1959",2020,3,401,247,211,"51.528187","-0.075375","Columbia Road, Shoreditch",458
"1960",2020,3,402,95,75,"51.52289229","-0.171681991","Penfold Street, Marylebone",170
"1961",2020,3,403,143,138,"51.51689296","-0.158249929","George Place Mews, Marylebone",281
"1962",2020,3,404,319,311,"51.50204238","-0.184400221","Palace Gate, Kensington Gardens",630
"1963",2020,3,405,358,361,"51.49418566","-0.18267094","Gloucester Road Station, South Kensington",719
"1964",2020,3,408,69,63,NA,NA,NA,132
"1965",2020,3,409,226,210,"51.493146","-0.099828","Strata, Elephant & Castle",436
"1966",2020,3,410,139,142,"51.519968","-0.169774","Edgware Road Station, Marylebone",281
"1967",2020,3,411,263,252,"51.49337264","-0.09968067","Walworth Road, Elephant & Castle",515
"1968",2020,3,412,97,82,"51.488105","-0.110121","Cleaver Street, Kennington",179
"1969",2020,3,419,122,126,"51.485821","-0.149004","Chelsea Bridge, Pimlico",248
"1970",2020,3,420,137,148,"51.504043","-0.105312","Southwark Station 1, Southwark",285
"1971",2020,3,421,262,271,"51.504044","-0.104778","Southwark Station 2, Southwark",533
"1972",2020,3,423,88,85,"51.49456127","-0.15393398","Eaton Square (South), Belgravia",173
"1973",2020,3,424,181,159,"51.490491","-0.149186","Ebury Bridge, Pimlico",340
"1974",2020,3,425,189,151,"51.533379","-0.139159","Harrington Square 2, Camden Town",340
"1975",2020,3,426,130,128,"51.493072","-0.129925","Vincent Street, Pimlico",258
"1976",2020,3,427,561,626,"51.51397065","-0.09294031","Cheapside, Bank",1187
"1977",2020,3,428,469,585,"51.499917","-0.174554","Exhibition Road, Knightsbridge",1054
"1978",2020,3,430,93,94,"51.48902","-0.17524","South Parade, Chelsea",187
"1979",2020,3,431,101,111,"51.534474","-0.122203","Crinan Street, King's Cross",212
"1980",2020,3,432,286,294,"51.496957","-0.173894","Exhibition Road Museums, South Kensington",580
"1981",2020,3,433,332,316,"51.524564","-0.116279","Wren Street, Holborn",648
"1982",2020,3,435,181,164,"51.488852","-0.105593","Kennington Station, Kennington",345
"1983",2020,3,436,421,415,"51.51824","-0.11655","Red Lion Street, Holborn",836
"1984",2020,3,437,151,160,"51.488124","-0.120903","Vauxhall Walk, Vauxhall",311
"1985",2020,3,439,107,81,"51.5338","-0.118677","Killick Street, King's Cross",188
"1986",2020,3,440,151,123,"51.483145","-0.113134","Kennington Oval, Oval",274
"1987",2020,3,441,164,164,"51.495656","-0.114605","Sail Street, Vauxhall",328
"1988",2020,3,442,87,81,"51.510101","-0.211358","Walmer Road, Avondale",168
"1989",2020,3,443,224,199,"51.515256","-0.058641","Philpot Street, Whitechapel",423
"1990",2020,3,444,214,192,"51.52568","-0.055312","Bethnal Green Garden, Bethnal Green",406
"1991",2020,3,445,120,130,"51.52388","-0.065076","Cheshire Street, Bethnal Green",250
"1992",2020,3,446,211,233,"51.528936","-0.055894","York Hall, Bethnal Green",444
"1993",2020,3,447,30,31,"51.493381","-0.007542","Jubilee Crescent, Cubitt Town",61
"1994",2020,3,448,178,175,"51.50623","-0.02296","Fisherman's Walk West, Canary Wharf",353
"1995",2020,3,449,251,246,"51.511088","-0.057159","Shadwell Station, Shadwell",497
"1996",2020,3,450,190,138,"51.515975","-0.053177","Jubilee Street, Stepney",328
"1997",2020,3,451,206,189,"51.504719","-0.063531","Hermitage Court, Wapping",395
"1998",2020,3,452,182,157,"51.505697","-0.070542","St. Katharine's Way, Tower",339
"1999",2020,3,453,165,152,"51.508447","-0.055167","Garnet Street, Shadwell",317
"2000",2020,3,454,61,54,"51.487679","-0.021582","Napier Avenue, Millwall",115
"2001",2020,3,455,53,53,"51.49447","-0.014409","East Ferry Road, Cubitt Town",106
"2002",2020,3,456,105,139,"51.538071","-0.144664","Parkway, Camden Town",244
"2003",2020,3,457,182,176,"51.542138","-0.145393","Castlehaven Road, Camden Town",358
"2004",2020,3,458,199,189,"51.504749","-0.057544","Wapping Lane, Wapping",388
"2005",2020,3,459,178,168,"51.535179","-0.03338","Gunmakers Lane, Old Ford",346
"2006",2020,3,460,143,123,"51.516196","-0.029138","Burdett Road, Mile End",266
"2007",2020,3,461,115,94,"51.516","-0.038775","Aston Street, Stepney",209
"2008",2020,3,462,272,233,"51.541603","-0.138853","Bonny Street, Camden Town",505
"2009",2020,3,463,124,86,"51.534776","-0.071881","Thurtle Road, Haggerston",210
"2010",2020,3,464,54,43,"51.51417","-0.052099","St. Mary & St. Michael Church, Stepney",97
"2011",2020,3,465,286,236,"51.53558","-0.08249","Pitfield Street North,Hoxton",522
"2012",2020,3,466,167,124,"51.534464","-0.076341","Whiston Road, Haggerston",291
"2013",2020,3,467,117,101,"51.523538","-0.030556","Southern Grove, Bow",218
"2014",2020,3,468,38,38,"51.521564","-0.022694","Cantrell Road, Bow",76
"2015",2020,3,469,113,96,"51.513757","-0.020467","Lindfield Street, Poplar",209
"2016",2020,3,470,112,106,"51.530535","-0.025492","Mostyn Grove, Bow",218
"2017",2020,3,471,152,154,"51.533283","-0.028155","Hewison Street, Old Ford",306
"2018",2020,3,472,33,26,"51.529452","-0.027616","Malmesbury Road, Bow",59
"2019",2020,3,473,48,36,"51.496137","-0.019355","Millharbour, Millwall",84
"2020",2020,3,475,38,42,"51.499041","-0.020157","Lightermans Road, Millwall",80
"2021",2020,3,476,34,32,"51.489096","-0.009205","Stebondale Street, Cubitt Town",66
"2022",2020,3,477,60,59,"51.49109","-0.018716","Spindrift Avenue, Millwall",119
"2023",2020,3,478,308,291,"51.521889","-0.04667","Stepney Green Station, Stepney",599
"2024",2020,3,479,201,210,"51.527152","-0.058005","Pott Street, Bethnal Green",411
"2025",2020,3,480,332,304,"51.5128711","-0.0389866","Flamborough Street, Limehouse",636
"2026",2020,3,481,116,138,"51.487129","-0.009001","Saunders Ness Road, Cubitt Town",254
"2027",2020,3,483,178,164,"51.51328","-0.047784","Albert Gardens, Stepney",342
"2028",2020,3,484,87,83,"51.528828","-0.013258","Bromley High Street, Bow",170
"2029",2020,3,485,163,144,"51.531127","-0.048017","Old Ford Road, Bethnal Green",307
"2030",2020,3,486,275,276,"51.525645","-0.069543","Granby Street, Shoreditch",551
"2031",2020,3,487,36,33,"51.511811","-0.025626","Canton Street, Poplar",69
"2032",2020,3,488,168,163,"51.506946","-0.058681","Reardon Street, Wapping",331
"2033",2020,3,489,212,189,"51.513074","-0.064094","Christian Street, Whitechapel",401
"2034",2020,3,490,80,72,"51.508622","-0.065006","Pennington Street, Wapping",152
"2035",2020,3,491,244,244,"51.522507","-0.041378","Queen Mary's, Mile End",488
"2036",2020,3,492,52,52,"51.525501","-0.032267204","Maplin Street, Mile End",104
"2037",2020,3,494,8,7,"51.50196","-0.016251","South Quay East, Canary Wharf",15
"2038",2020,3,495,154,140,"51.528169","-0.018703","Bow Church Station, Bow",294
"2039",2020,3,496,93,82,"51.52512","-0.015578","Devons Road, Bow",175
"2040",2020,3,497,100,94,"51.526149","-0.027396845","Merchant Street, Bow",194
"2041",2020,3,498,148,145,"51.527058","-0.025296","Bow Road Station, Bow",293
"2042",2020,3,499,190,167,"51.519265","-0.021345","Furze Green, Bow",357
"2043",2020,3,500,274,267,"51.519806","-0.055731","Ansell House, Stepney",541
"2044",2020,3,501,122,105,"51.522561","-0.054883","Cephas Street, Bethnal Green",227
"2045",2020,3,502,212,198,"51.53341","-0.049591815","Bonner Gate, Victoria Park",410
"2046",2020,3,503,343,342,"51.520893","-0.051394","Cleveland Way, Stepney",685
"2047",2020,3,504,26,21,"51.496454","-0.009506","St. John's Park, Cubitt Town",47
"2048",2020,3,505,120,114,"51.520398","-0.026768","Ackroyd Drive, Bow",234
"2049",2020,3,506,190,224,"51.517475","-0.075855","Bell Lane, Liverpool Street",414
"2050",2020,3,507,117,81,"51.528692","-0.059091","Clarkson Street, Bethnal Green",198
"2051",2020,3,508,270,292,"51.519362","-0.074431","Fournier Street, Whitechapel",562
"2052",2020,3,509,171,199,"51.517842","-0.090075","Fore Street, Guildhall",370
"2053",2020,3,510,176,251,"51.509303","-0.025996","Westferry DLR, Limehouse",427
"2054",2020,3,511,228,194,"51.511066","-0.053558","Sutton Street, Shadwell",422
"2055",2020,3,512,392,336,"51.532091","-0.06142","Pritchard's Road, Bethnal Green",728
"2056",2020,3,513,143,126,"51.5142228","-0.055656","Watney Market, Stepney",269
"2057",2020,3,514,176,191,"51.516204","-0.155525","Portman Square, Marylebone",367
"2058",2020,3,515,71,67,"51.500088","-0.211316","Russell Gardens, Olympia",138
"2059",2020,3,516,88,89,"51.5112","-0.014438","Chrisp Street Market, Poplar",177
"2060",2020,3,517,114,126,"51.532513","-0.033085","Ford Road, Old Ford",240
"2061",2020,3,518,150,152,"51.528224","-0.037471","Antill Road, Mile End",302
"2062",2020,3,519,16,11,"51.518811","-0.011662","Teviot Street, Poplar",27
"2063",2020,3,520,172,155,"51.526041","-0.047218","Bancroft Road, Bethnal Green",327
"2064",2020,3,521,172,168,"51.534137","-0.037366","Driffield Road, Old Ford",340
"2065",2020,3,522,238,253,"51.525941","-0.036017","Clinton Road, Mile End",491
"2066",2020,3,523,28,30,"51.51549","-0.013475","Langdon Park, Poplar",58
"2067",2020,3,524,212,164,"51.511654","-0.179668","Lancaster Gate , Bayswater",376
"2068",2020,3,526,73,77,"51.503143","-0.008428","Lancaster Drive, Blackwall",150
"2069",2020,3,527,87,74,"51.503802","-0.215808","Hansard Mews, Holland Park",161
"2070",2020,3,528,87,90,"51.507326","-0.145827","Clarges Street, Mayfair",177
"2071",2020,3,529,136,128,"51.486892","-0.170983","Manresa Road, Chelsea",264
"2072",2020,3,530,58,59,"51.508896","-0.012413","Newby Place, Poplar",117
"2073",2020,3,531,230,198,"51.530326","-0.042744","Twig Folly Bridge, Mile End",428
"2074",2020,3,532,129,134,"51.50357","-0.020068","Jubilee Plaza, Canary Wharf",263
"2075",2020,3,533,202,179,"51.528222","-0.069743","Wellington Row, Bethnal Green",381
"2076",2020,3,534,237,198,"51.531864","-0.066035","Goldsmith's Row, Haggerston",435
"2077",2020,3,535,163,144,"51.537349","-0.147154","Gloucester Avenue, Camden Town",307
"2078",2020,3,536,111,91,"51.53385","-0.06992","Queensbridge Road, Haggerston",202
"2079",2020,3,537,247,236,"51.51793","-0.067937","Old Montague Street, Whitechapel",483
"2080",2020,3,538,51,46,"51.508981","-0.00699","Naval Row, Blackwall",97
"2081",2020,3,540,166,140,"51.528302","-0.144466","Albany Street, The Regent's Park",306
"2082",2020,3,541,394,389,"51.506613","-0.142844","Green Park Station, Mayfair",783
"2083",2020,3,542,163,136,"51.514115","-0.033828","Salmon Lane, Limehouse",299
"2084",2020,3,543,42,31,"51.509591","-0.204666","Lansdowne Walk, Ladbroke Grove",73
"2085",2020,3,544,168,141,"51.526153","-0.102208","Percival Street, Finsbury",309
"2086",2020,3,545,124,128,"51.539957","-0.145246","Arlington Road, Camden Town",252
"2087",2020,3,546,338,325,"51.517428","-0.107987","New Fetter Lane, Holborn",663
"2088",2020,3,547,61,61,"51.509474","-0.002275","East India DLR, Blackwall",122
"2089",2020,3,548,74,58,"51.498386","-0.107913","Westminster Bridge Road, Elephant & Castle",132
"2090",2020,3,549,127,115,"51.49605","-0.104193","Gaywood  Street, Elephant & Castle",242
"2091",2020,3,550,157,127,"51.521564","-0.039264","Harford Street, Mile End",284
"2092",2020,3,551,123,109,"51.505772","-0.016460175","Import Dock, Canary Wharf",232
"2093",2020,3,552,255,238,"51.511542","-0.056667","Watney Street, Shadwell",493
"2094",2020,3,553,577,574,"51.535678","-0.062546","Regent's Row , Haggerston",1151
"2095",2020,3,554,30,27,"51.513548","-0.005659","Aberfeldy Street, Poplar",57
"2096",2020,3,556,69,68,"51.502661","-0.021596","Heron Quays DLR, Canary Wharf",137
"2097",2020,3,557,140,170,"51.51601","-0.0985","King Edward Street, St Pauls",310
"2098",2020,3,558,317,316,"51.493978","-0.127554","Page Street, Westminster",633
"2099",2020,3,559,45,36,"51.501391","-0.205991","Abbotsbury Road, Holland Park",81
"2100",2020,3,560,54,16,"51.511624","-0.205921","Ladbroke Grove Central, Ladbroke Grove",70
"2101",2020,3,561,117,90,"51.518369","-0.043371","Rectory Square, Stepney",207
"2102",2020,3,562,172,176,"51.51746","-0.12335","Bury Place, Holborn",348
"2103",2020,3,563,38,43,"51.499286","-0.009152","Preston's Road, Cubitt Town",81
"2104",2020,3,564,327,419,"51.509943","-0.117619","Somerset House, Strand",746
"2105",2020,3,565,104,98,"51.521905","-0.063386","Selby Street, Whitechapel",202
"2106",2020,3,566,111,124,"51.509158","-0.224103","Westfield Ariel Way, White City",235
"2107",2020,3,568,250,231,"51.51616","-0.18697","Bishop's Bridge Road West, Bayswater",481
"2108",2020,3,569,198,170,"51.53213","-0.08299","Pitfield Street Central, Hoxton",368
"2109",2020,3,570,193,201,"51.503083","-0.017676","Upper Bank Street, Canary Wharf",394
"2110",2020,3,571,84,94,"51.506256","-0.218337","Westfield Southern Terrace ,Shepherd's Bush",178
"2111",2020,3,572,192,224,"51.539099","-0.141728","Greenland Road, Camden Town",416
"2112",2020,3,573,397,397,"51.485587","-0.18119","Limerston Street, West Chelsea",794
"2113",2020,3,574,500,397,"51.53356","-0.09315","Eagle Wharf Road, Hoxton",897
"2114",2020,3,576,31,33,"51.497304","-0.022793","Alpha Grove, Millwall",64
"2115",2020,3,577,195,187,"51.528869","-0.047548","Globe Town Market, Bethnal Green",382
"2116",2020,3,578,112,111,"51.527607","-0.057133","Hollybush Gardens, Bethnal Green",223
"2117",2020,3,579,422,608,"51.511246","-0.093051","Queen Street 2, Bank",1030
"2118",2020,3,580,170,161,"51.48692917","-0.102996299","Doddington Grove, Kennington",331
"2119",2020,3,581,248,263,"51.519167","-0.147983","New Cavendish Street, Marylebone",511
"2120",2020,3,583,235,300,"51.497622","-0.125978","Abingdon Green, Westminster",535
"2121",2020,3,584,229,182,"51.51244","-0.19096","Ilchester Gardens, Bayswater",411
"2122",2020,3,586,48,48,"51.490645","-0.014582","Mudchute DLR, Cubitt Town",96
"2123",2020,3,587,336,353,"51.50964","-0.08497","Monument Street, Monument",689
"2124",2020,3,588,137,107,"51.52959","-0.0801","Hoxton Street, Hoxton",244
"2125",2020,3,589,308,295,"51.487196","-0.179369","Drayton Gardens, West Chelsea",603
"2126",2020,3,590,69,32,"51.53256","-0.16862","Greenberry Street, St.John's Wood",101
"2127",2020,3,592,127,97,"51.5171","-0.18377","Bishop's Bridge Road East, Bayswater",224
"2128",2020,3,593,164,147,"51.531066","-0.11934","Northdown Street, King's Cross",311
"2129",2020,3,594,186,193,"51.513875","-0.117774","Kingsway Southbound, Strand",379
"2130",2020,3,595,228,195,"51.493267","-0.21985","Hammersmith Road, Hammersmith",423
"2131",2020,3,596,220,211,"51.472817","-0.199783","Parson's Green , Parson's Green",431
"2132",2020,3,597,153,122,"51.473471","-0.20782","Fulham Park Road, Fulham",275
"2133",2020,3,598,140,138,"51.494499","-0.228188","Southerton Road, Hammersmith",278
"2134",2020,3,599,111,101,"51.485743","-0.223616","Manbre Road, Hammersmith",212
"2135",2020,3,600,214,226,"51.481747","-0.124642","South Lambeth Road, Vauxhall",440
"2136",2020,3,601,131,140,"51.514767","-0.225787","BBC White City, White City",271
"2137",2020,3,602,194,168,"51.472993","-0.133972","Union Grove, Wandsworth Road",362
"2138",2020,3,603,195,150,"51.477839","-0.116493","Caldwell Street, Stockwell",345
"2139",2020,3,604,82,72,"51.538792","-0.138535","St Martins Close, Camden Town",154
"2140",2020,3,605,167,169,"51.520331","-0.163667","Seymour Place, Marylebone",336
"2141",2020,3,606,71,63,"51.504199","-0.210941","Addison Road, Holland Park",134
"2142",2020,3,607,144,138,"51.468814","-0.210279","Putney Bridge Station, Fulham",282
"2143",2020,3,608,15,19,"51.491093","-0.216493","Colet Gardens, Hammersmith",34
"2144",2020,3,609,75,59,"51.46512358","-0.157788279","Sugden Road, Clapham",134
"2145",2020,3,610,142,128,"51.48256792","-0.172078187","Danvers Street, West Chelsea",270
"2146",2020,3,611,103,112,"51.50646524","-0.208486599","Princedale Road , Holland Park",215
"2147",2020,3,612,162,153,"51.46925984","-0.141812513","Wandsworth Rd, Isley Court, Wandsworth Road",315
"2148",2020,3,613,289,292,"51.50403821","-0.217400093","Woodstock Grove, Shepherd's Bush",581
"2149",2020,3,614,106,78,"51.47817208","-0.144690541","Bradmead, Battersea Park",184
"2150",2020,3,615,187,185,"51.4768851","-0.215895601","Finlay Street, Fulham",372
"2151",2020,3,616,186,173,"51.48102131","-0.209973497","Aintree Street, Fulham",359
"2152",2020,3,617,93,87,"51.47107905","-0.207842908","Elysium Place, Fulham",180
"2153",2020,3,618,151,126,"51.47625965","-0.193254007","Eel Brook Common, Walham Green",277
"2154",2020,3,619,146,103,"51.4737636","-0.197010096","Irene Road, Parsons Green",249
"2155",2020,3,620,173,131,"51.47518024","-0.167160736","Surrey Lane, Battersea",304
"2156",2020,3,621,222,222,"51.46086446","-0.187427294","Wandsworth Town Station, Wandsworth",444
"2157",2020,3,622,166,175,"51.50748124","-0.205535908","Lansdowne Road, Ladbroke Grove",341
"2158",2020,3,623,75,65,"51.46193072","-0.180791784","Nantes Close, Wandsworth",140
"2159",2020,3,624,105,83,"51.4729184","-0.132102704","Courland Grove, Wandsworth Road",188
"2160",2020,3,625,278,247,"51.47761941","-0.149551631","Queen's Circus, Battersea Park",525
"2161",2020,3,626,247,241,"51.48438657","-0.20481514","Normand Park, West Kensington",488
"2162",2020,3,627,71,52,"51.4687905","-0.158230901","Holden Street, Battersea",123
"2163",2020,3,628,174,182,"51.46881971","-0.184318843","William Morris Way, Sands End",356
"2164",2020,3,629,50,31,"51.45995384","-0.190184054","Morie Street, Wandsworth",81
"2165",2020,3,630,97,78,"51.47073264","-0.126994068","Clarence Walk, Stockwell",175
"2166",2020,3,631,200,184,"51.4795017","-0.141770709","Battersea Park Road, Nine Elms",384
"2167",2020,3,632,108,100,"51.47053858","-0.163041605","Sheepcote Lane, Battersea",208
"2168",2020,3,633,139,120,"51.48959104","-0.209378594","Vereker Road, West Kensington",259
"2169",2020,3,634,98,115,"51.49434708","-0.215804559","Brook Green South, Brook Green",213
"2170",2020,3,635,171,165,"51.48606206","-0.214428378","Greyhound Road, Hammersmith",336
"2171",2020,3,636,210,191,"51.46706414","-0.193502076","South Park, Sands End",401
"2172",2020,3,637,55,44,"51.45787019","-0.174691623","Spencer Park, Wandsworth Common",99
"2173",2020,3,638,338,326,"51.46663393","-0.169821175","Falcon Road, Clapham Junction",664
"2174",2020,3,639,239,226,"51.48357068","-0.202038682","Coomer Place, West Kensington",465
"2175",2020,3,640,122,98,"51.47286577","-0.148059277","Silverthorne Road, Battersea",220
"2176",2020,3,641,104,123,"51.49824168","-0.117495865","Archbishop's Park, Waterloo",227
"2177",2020,3,642,59,52,"51.46916161","-0.174485792","Fawcett Close, Battersea",111
"2178",2020,3,643,82,69,"51.5190427","-0.204764421","All Saints' Road, Portobello",151
"2179",2020,3,644,173,190,"51.48373225","-0.223852256","Rainville Road, Hammersmith",363
"2180",2020,3,645,200,193,"51.50173215","-0.100292412","Great Suffolk Street, The Borough",393
"2181",2020,3,646,249,309,"51.49886563","-0.137424571","Buckingham Gate, Westminster",558
"2182",2020,3,647,120,109,"51.50035306","-0.217515071","Richmond Way, Shepherd's Bush",229
"2183",2020,3,648,81,73,"51.46904022","-0.19627483","Peterborough Road, Sands End",154
"2184",2020,3,649,149,153,"51.48180515","-0.18027465","World's End Place, West Chelsea",302
"2185",2020,3,650,127,112,"51.51687069","-0.213872396","St. Mark's Road, North Kensington",239
"2186",2020,3,651,118,104,"51.48089844","-0.183853573","Thorndike Close, West Chelsea",222
"2187",2020,3,652,45,54,"51.51148696","-0.218190203","Evesham Street, Avondale",99
"2188",2020,3,653,221,206,"51.47084722","-0.17070367","Simpson Street, Clapham Junction",427
"2189",2020,3,654,137,130,"51.48267821","-0.117661574","Ashmole Estate, Oval",267
"2190",2020,3,655,114,87,"51.48294452","-0.219346128","Crabtree Lane, Fulham",201
"2191",2020,3,656,63,63,"51.46841875","-0.199135704","Broomhouse Lane, Parsons Green",126
"2192",2020,3,657,94,97,"51.4996806","-0.221791552","Blythe Road West, Shepherd's Bush",191
"2193",2020,3,658,344,346,"51.47729232","-0.16478637","Ethelburga Estate, Battersea Park",690
"2194",2020,3,659,217,223,"51.511934","-0.10307894","Blackfriars Station, St. Paul's",440
"2195",2020,3,660,108,84,"51.49087074","-0.206029743","West Kensington Station, West Kensington",192
"2196",2020,3,661,333,312,"51.51632095","-0.202608612","All Saints Church, Portobello",645
"2197",2020,3,662,177,175,"51.48498496","-0.167919869","Phene Street, Chelsea",352
"2198",2020,3,663,93,82,"51.51323001","-0.211593602","Clarendon Road, Avondale",175
"2199",2020,3,664,145,142,"51.474376","-0.155442787","Austin Road, Battersea Park",287
"2200",2020,3,665,104,116,"51.46108367","-0.191722864","Smugglers Way, Wandsworth",220
"2201",2020,3,666,161,137,"51.49610093","-0.208158259","Olympia Way, Olympia",298
"2202",2020,3,667,113,124,"51.5015946","-0.222293381","Shepherd's Bush Road North, Shepherd's Bush",237
"2203",2020,3,668,195,177,"51.49422354","-0.236769936","Ravenscourt Park Station, Hammersmith",372
"2204",2020,3,669,79,58,"51.47614939","-0.1232585","Teversham Lane, Stockwell",137
"2205",2020,3,670,127,124,"51.46718562","-0.152248582","Ashley Crescent, Battersea",251
"2206",2020,3,671,331,326,"51.475089","-0.201968","Parsons Green Station, Parsons Green",657
"2207",2020,3,673,181,174,"51.46517078","-0.18038939","Hibbert Street, Battersea",355
"2208",2020,3,674,145,82,"51.53546778","-0.11619105","Carnegie Street, King's Cross",227
"2209",2020,3,675,110,102,"51.46348914","-0.182126248","Usk Road, Clapham Junction",212
"2210",2020,3,676,193,179,"51.47787084","-0.126874471","Hartington Road, Stockwell",372
"2211",2020,3,677,73,54,"51.46866929","-0.146544642","Heath Road, Battersea",127
"2212",2020,3,678,51,43,"51.46231278","-0.211468596","Esmond Street, Putney",94
"2213",2020,3,679,127,109,"51.47453545","-0.170210533","Orbel Street, Battersea",236
"2214",2020,3,680,278,269,"51.47768469","-0.170329317","Westbridge Road, Battersea",547
"2215",2020,3,681,89,141,"51.47303687","-0.214749808","Bishop's Avenue, Fulham",230
"2216",2020,3,682,242,243,"51.48810829","-0.22660621","Crisp Road, Hammersmith",485
"2217",2020,3,683,88,83,"51.46506424","-0.163750945","Dorothy Road, Clapham Junction",171
"2218",2020,3,684,86,90,"51.45475251","-0.195197203","Neville Gill Close, Wandsworth",176
"2219",2020,3,685,138,137,"51.46067005","-0.198735357","Osiers Road, Wandsworth",275
"2220",2020,3,686,148,155,"51.48814438","-0.222456468","Beryl Road, Hammersmith",303
"2221",2020,3,687,178,164,"51.49760804","-0.21145598","Maclise Road, Olympia",342
"2222",2020,3,688,71,53,"51.46095151","-0.20066766","Northfields, Wandsworth",124
"2223",2020,3,689,39,26,"51.45922541","-0.180884959","Spanish Road, Clapham Junction",65
"2224",2020,3,690,69,52,"51.47047503","-0.152130083","Stanley Grove, Battersea",121
"2225",2020,3,691,150,186,"51.47946386","-0.195777222","Erin Close, Walham Green",336
"2226",2020,3,692,242,235,"51.54211855","-0.028941601","Cadogan Close, Victoria Park",477
"2227",2020,3,693,79,75,"51.464786","-0.215618902","Felsham Road, Putney",154
"2228",2020,3,694,56,51,"51.46071722","-0.216526155","Putney Rail Station, Putney",107
"2229",2020,3,695,389,374,"51.53638435","-0.102757578","Islington Green, Angel",763
"2230",2020,3,696,201,183,"51.48728535","-0.217995921","Charing Cross Hospital, Hammersmith",384
"2231",2020,3,697,131,89,"51.53639219","-0.112721065","Charlotte Terrace, Angel",220
"2232",2020,3,698,185,115,"51.53908372","-0.070329419","Shoreditch Court, Haggerston",300
"2233",2020,3,699,132,71,"51.5366541","-0.07023031","Belford House, Haggerston",203
"2234",2020,3,700,160,129,"51.47696496","-0.174347066","Battersea Church Road, Battersea",289
"2235",2020,3,701,224,202,"51.47287627","-0.176267008","Vicarage Crescent, Battersea",426
"2236",2020,3,702,204,184,"51.52868155","-0.065550321","Durant Street, Bethnal Green",388
"2237",2020,3,703,307,413,"51.51505991","-0.10534448","St. Bride Street, Holborn",720
"2238",2020,3,704,37,23,"51.45682071","-0.202802098","Mexfield Road, East Putney",60
"2239",2020,3,705,51,48,NA,NA,NA,99
"2240",2020,3,706,226,264,"51.50215353","-0.083632928","Snowsfields, London Bridge",490
"2241",2020,3,707,303,284,"51.49021762","-0.215087092","Barons Court Station, West Kensington",587
"2242",2020,3,708,100,90,"51.46161068","-0.21614583","Disraeli Road, Putney",190
"2243",2020,3,709,35,35,"51.46321128","-0.215550761","Montserrat Road , Putney",70
"2244",2020,3,710,174,198,"51.47439218","-0.163347594","Albert Bridge Road, Battersea Park",372
"2245",2020,3,711,132,118,"51.48335692","-0.216305546","Everington Street, Fulham",250
"2246",2020,3,712,194,167,"51.51854104","-0.034903714","Mile End Stadium, Mile End",361
"2247",2020,3,713,75,74,"51.54100708","-0.14326094","Hawley Crescent, Camden Town",149
"2248",2020,3,714,73,50,"51.47311696","-0.137235175","Stewart's Road, Wandsworth Road",123
"2249",2020,3,715,109,72,"51.51563007","-0.049067243","Aylward Street, Stepney",181
"2250",2020,3,716,125,109,"51.51542791","-0.02356501","Stainsby Road , Poplar",234
"2251",2020,3,717,417,379,"51.53658514","-0.075885686","Dunston Road , Haggerston",796
"2252",2020,3,718,224,231,"51.53571683","-0.060291813","Ada Street, Hackney Central",455
"2253",2020,3,719,219,225,"51.53642464","-0.054162264","Victoria Park Road, Hackney Central",444
"2254",2020,3,720,131,104,"51.48724429","-0.205279052","Star Road, West Kensington",235
"2255",2020,3,721,96,94,"51.53603947","-0.026262677","Wendon Street, Old Ford",190
"2256",2020,3,722,160,130,"51.52458353","-0.058631453","Finnis Street, Bethnal Green",290
"2257",2020,3,723,243,233,"51.46822047","-0.190346493","Stephendale Road, Sands End",476
"2258",2020,3,724,60,36,"51.45799126","-0.184806157","Alma Road, Wandsworth",96
"2259",2020,3,725,194,181,"51.491327","-0.096518684","Walworth Square, Walworth",375
"2260",2020,3,726,159,155,"51.47505096","-0.150908371","Alfreda Street, Battersea Park",314
"2261",2020,3,727,176,155,"51.47569809","-0.20587627","Chesilton Road, Fulham",331
"2262",2020,3,728,47,30,"51.46199911","-0.206240805","Putney Bridge Road, East Putney",77
"2263",2020,3,729,240,232,"51.47893931","-0.208485293","St. Peter's Terrace, Fulham",472
"2264",2020,3,730,176,178,"51.49208492","-0.229116862","Bridge Avenue, Hammersmith",354
"2265",2020,3,731,132,138,"51.47727637","-0.189210466","Michael Road, Walham Green",270
"2266",2020,3,732,619,697,"51.50630441","-0.087262995","Duke Street Hill, London Bridge",1316
"2267",2020,3,733,92,110,"51.50542628","-0.150817316","Park Lane, Mayfair",202
"2268",2020,3,734,85,73,"51.46230566","-0.175407201","Plough Terrace, Clapham Junction",158
"2269",2020,3,735,203,207,"51.46489445","-0.17302926","Grant Road East, Clapham Junction",410
"2270",2020,3,736,63,54,"51.50659035","-0.216104479","Queensdale Road, Shepherd's Bush",117
"2271",2020,3,737,537,531,"51.47993289","-0.19411695","Fulham Broadway, Walham Green",1068
"2272",2020,3,738,135,138,"51.47514228","-0.187278987","Imperial Road, Sands End",273
"2273",2020,3,739,141,130,"51.48176572","-0.185273723","Hortensia Road, West Brompton",271
"2274",2020,3,740,46,33,"51.51092871","-0.214594781","Sirdar Road, Avondale",79
"2275",2020,3,741,50,55,"51.5129814","-0.219486603","Freston Road, Avondale",105
"2276",2020,3,742,137,147,"51.51510818","-0.208565479","Blenheim Crescent, Ladbroke Grove",284
"2277",2020,3,743,37,36,"51.46079243","-0.212607684","Oxford Road, Putney",73
"2278",2020,3,744,42,52,"51.46745485","-0.172293499","Ingrave Street, Clapham Junction",94
"2279",2020,3,745,106,113,"51.47816972","-0.18243547","Upcerne Road, West Chelsea",219
"2280",2020,3,746,158,154,"51.4795738","-0.17903854","Lots Road, West Chelsea",312
"2281",2020,3,747,130,128,"51.48796408","-0.161765173","Ormonde Gate, Chelsea",258
"2282",2020,3,748,263,209,"51.53727795","-0.079201849","Hertford Road, De Beauvoir Town",472
"2283",2020,3,749,237,196,"51.53932857","-0.074284675","Haggerston Road, Haggerston",433
"2284",2020,3,750,68,55,"51.4710956","-0.157850096","Culvert Road, Battersea",123
"2285",2020,3,751,138,155,"51.51612862","-0.120909408","Newton Street, Covent Garden",293
"2286",2020,3,754,72,79,"51.5129006","-0.214762686","Grenfell Road, Avondale",151
"2287",2020,3,755,199,179,"51.48512191","-0.174971902","The Vale, Chelsea",378
"2288",2020,3,756,172,155,"51.47515398","-0.159169801","Prince of Wales Drive, Battersea Park",327
"2289",2020,3,757,205,172,"51.48795853","-0.187404506","Harcourt Terrace, West Brompton",377
"2290",2020,3,758,149,120,"51.51787005","-0.201005397","Westbourne Park Road, Portobello",269
"2291",2020,3,759,94,60,"51.52456169","-0.165668686","Broadley Terrace, Marylebone",154
"2292",2020,3,760,77,54,"51.52526975","-0.163795009","Rossmore Road, Marylebone",131
"2293",2020,3,761,152,125,"51.48321729","-0.211860644","Humbolt Road, Fulham",277
"2294",2020,3,762,415,453,"51.50070305","-0.129698963","Storey's Gate, Westminster",868
"2295",2020,3,763,138,150,"51.52059714","-0.032566533","Mile End Park Leisure Centre, Mile End",288
"2296",2020,3,764,152,165,"51.46239255","-0.16829214","St. John's Road, Clapham Junction",317
"2297",2020,3,765,82,69,"51.46760141","-0.20682737","Ranelagh Gardens, Fulham",151
"2298",2020,3,766,209,203,"51.45752945","-0.192165613","Ram Street, Wandsworth",412
"2299",2020,3,767,27,16,"51.45705988","-0.200806304","Santos Road, Wandsworth",43
"2300",2020,3,768,165,144,"51.46134382","-0.159322467","Clapham Common North Side, Clapham Common",309
"2301",2020,3,769,179,158,"51.473611","-0.191803","Sandilands Road, Walham Green",337
"2302",2020,3,770,103,81,"51.491026","-0.209121","Gwendwr Road, West Kensington",184
"2303",2020,3,771,47,52,"51.509224","-0.216016","Rifle Place, Avondale",99
"2304",2020,3,772,318,281,"51.47250956","-0.122831913","Binfield Road, Stockwell",599
"2305",2020,3,773,300,360,"51.511891","-0.107349","Tallis Street, Temple",660
"2306",2020,3,774,55,52,"51.470131","-0.20464","Hurlingham Park, Parsons Green",107
"2307",2020,3,775,83,121,"51.496664","-0.223868","Little Brook Green, Brook Green",204
"2308",2020,3,776,107,121,"51.460333","-0.167029","Abyssinia Close, Clapham Junction",228
"2309",2020,3,777,36,32,"51.4619230679","-0.165297856693","Limburg Road, Clapham Junction",68
"2310",2020,3,779,234,249,"51.514449","-0.077178979","Houndsditch, Aldgate",483
"2311",2020,3,780,286,269,"51.474665","-0.18316517","Imperial Wharf Station, Sands End",555
"2312",2020,3,781,176,200,"51.495898","-0.173009","Victoria & Albert Museum, South Kensington",376
"2313",2020,3,782,194,176,"51.483911","-0.19760944","Halford Road, West Kensington",370
"2314",2020,3,783,262,243,"51.5403115","-0.021630359","Monier Road, Hackney Wick",505
"2315",2020,3,784,127,133,"51.546326","-0.00993526","East Village, Queen Elizabeth Olympic Park",260
"2316",2020,3,785,389,439,"51.54094","-0.010510565","Aquatic Centre, Queen Elizabeth Olympic Park",828
"2317",2020,3,786,121,116,"51.549369","-0.015717614","Lee Valley VeloPark, Queen Elizabeth Olympic Park",237
"2318",2020,3,787,110,108,"51.546805","-0.01469126","Timber Lodge, Queen Elizabeth Olympic Park",218
"2319",2020,3,789,158,169,"51.538718","-0.011889482","Podium, Queen Elizabeth Olympic Park",327
"2320",2020,3,790,190,214,"51.541793","-0.00481","Stratford Station, Stratford",404
"2321",2020,3,792,198,225,"51.505461","-0.10454093","Blackfriars Road, Southwark",423
"2322",2020,3,793,103,106,"51.528279","-0.11955857","Cromer Street, Bloomsbury",209
"2323",2020,3,794,39,46,NA,NA,NA,85
"2324",2020,3,795,154,141,"51.527068","-0.13186102","Euston Square Gardens, Euston",295
"2325",2020,3,796,173,167,"51.524","-0.12640984","Coram Street, Bloomsbury",340
"2326",2020,3,797,244,236,"51.5293","-0.12827903","Ossulston Street, Somers Town",480
"2327",2020,3,798,268,293,"51.5301998755","-0.122299440803","Birkenhead Street, King's Cross",561
"2328",2020,3,799,181,193,"51.4976984561","-0.137598896295","Kings Gate House, Westminster",374
"2329",2020,3,800,195,197,"51.4811219398","-0.149035374873","Sopwith Way, Battersea Park",392
"2330",2020,3,801,244,274,"51.5052241745","-0.0980318118664","Lavington Street, Bankside",518
"2331",2020,3,802,132,104,"51.4765900593","-0.118256789081","Albert Square, Stockwell",236
"2332",2020,3,803,166,166,"51.5054099403","-0.0983410884509","Southwark Street, Bankside",332
"2333",2020,3,804,305,315,"51.5346677396","-0.125078652873","Good's Way, King's Cross",620
"2334",2020,3,806,180,186,"51.5372405623","-0.124807385707","Handyside Street, King's Cross",366
"2335",2020,3,807,201,201,"51.5212","-0.20888818","Bevington Road West, North Kensington",402
"2336",2020,3,808,55,54,NA,NA,NA,109
"2337",2020,3,809,129,157,"51.5162778834","-0.118272991635","Lincoln's Inn Fields, Holborn",286
"2338",2020,3,810,232,277,"51.5067252868","-0.0988072461627","Tate Modern, Bankside",509
"2339",2020,3,811,269,291,"51.5057030357","-0.0277727426235","Westferry Circus, Canary Wharf",560
"2340",2020,3,812,67,53,"51.5487311915","-0.0226065549321","Here East North, Queen Elizabeth Olympic Park",120
"2341",2020,3,813,136,139,"51.4878074485","-0.122759625866","New Spring Gardens Walk, Vauxhall",275
"2342",2020,3,814,65,68,"51.4714330677","-0.123670735702","Clapham Road, Lingham Street, Stockwell",133
"2343",2020,3,815,284,298,"51.5000891978","-0.116628700672","Lambeth Palace Road, Waterloo",582
"2344",2020,3,816,73,89,"51.5465327935","-0.0205975904647","Here East South, Queen Elizabeth Olympic Park",162
"2345",2020,3,817,190,180,"51.4813354746","-0.138212295869","Riverlight South, Nine Elms",370
"2346",2020,3,818,389,423,"51.501513","-0.12382322","Westminster Pier, Westminster",812
"2347",2020,3,819,198,205,"51.50621","-0.114842","Belvedere Road 2, South Bank",403
"2348",2020,3,820,129,110,"51.492807","-0.091938","Victory Place, Walworth",239
"2349",2020,3,821,353,335,"51.4835074867","-0.147714557371","Battersea Power Station, Battersea Park",688
"2350",2020,3,826,446,447,"51.496863","-0.1429434","Allington Street, Victoria",893
"2351",2020,3,827,217,212,"51.479601","-0.11147178","Cranmer Road, Stockwell",429
"2352",2020,3,828,125,144,"51.473874","-0.11258096","Normandy Road, Stockwell",269
"2353",2020,3,829,77,75,"51.469217","-0.11268674","Wynne Road, Stockwell",152
"2354",2020,3,830,96,85,"51.469202","-0.11902256","Sidney Road, Stockwell",181
"2355",2020,3,831,99,85,"51.466232","-0.11317995","St John's Crescent, Brixton",184
"2356",2020,3,832,139,141,"51.464019","-0.11578197","Ferndale Road, Brixton",280
"2357",2020,3,833,112,106,"51.460232","-0.11537509","Saltoun Road, Brixton",218
"2358",2020,3,834,175,178,"51.477966","-0.14785703","Gas Holders, Battersea Park",353
"2359",2020,3,835,168,175,"51.516785","-0.10494775","Farringdon Street, Holborn",343
"2360",2020,3,836,167,119,"51.541596","-0.12544145","York Way, Kings Cross",286
"2361",2020,3,838,175,190,"51.518093","-0.0914017","Fore Street Avenue, Guildhall",365
"2362",2020,3,839,337,332,"51.508033","-0.10682363","Sea Containers, South Bank",669
"2363",2020,4,1,160,106,"51.52916347","-0.109970527","River Street , Clerkenwell",266
"2364",2020,4,2,202,229,"51.49960695","-0.197574246","Phillimore Gardens, Kensington",431
"2365",2020,4,3,240,274,"51.52128377","-0.084605692","Christopher Street, Liverpool Street",514
"2366",2020,4,4,140,166,"51.53005939","-0.120973687","St. Chad's Street, King's Cross",306
"2367",2020,4,5,343,371,"51.49313","-0.156876","Sedding Street, Sloane Square",714
"2368",2020,4,6,273,272,"51.51811784","-0.144228881","Broadcasting House, Marylebone",545
"2369",2020,4,7,145,112,"51.53430039","-0.1680743","Charlbert Street, St. John's Wood",257
"2370",2020,4,8,134,117,"51.529857","-0.18348604","Maida Vale, Maida Vale",251
"2371",2020,4,9,235,238,"51.5073853","-0.096440751","New Globe Walk, Bankside",473
"2372",2020,4,10,107,103,"51.50597426","-0.092754157","Park Street, Bankside",210
"2373",2020,4,11,262,253,"51.52395143","-0.122502346","Brunswick Square, Bloomsbury",515
"2374",2020,4,12,508,519,"51.52168078","-0.130431727","Malet Street, Bloomsbury",1027
"2375",2020,4,13,183,186,"51.51991453","-0.136039674","Scala Street, Fitzrovia",369
"2376",2020,4,14,1604,1546,"51.52994371","-0.123616824","Belgrove Street , King's Cross",3150
"2377",2020,4,15,264,284,"51.51772703","-0.127854211","Great Russell Street, Bloomsbury",548
"2378",2020,4,16,293,272,"51.52635795","-0.125979294","Cartwright Gardens , Bloomsbury",565
"2379",2020,4,17,461,489,"51.5216612","-0.109006325","Hatton Wall, Holborn",950
"2380",2020,4,18,416,424,"51.51477076","-0.12221963","Drury Lane, Covent Garden",840
"2381",2020,4,19,356,363,"51.52505093","-0.131161087","Taviton Street, Bloomsbury",719
"2382",2020,4,20,184,141,"51.527326","-0.13605286","Drummond Street , Euston",325
"2383",2020,4,21,82,77,"51.53007835","-0.13884627","Hampstead Road (Cartmel), Euston",159
"2384",2020,4,22,321,321,"51.5222641","-0.114079481","Northington Street , Holborn",642
"2385",2020,4,23,173,174,"51.51943538","-0.119123345","Red Lion Square, Holborn",347
"2386",2020,4,24,356,381,"51.51908011","-0.124678402","British Museum, Bloomsbury",737
"2387",2020,4,25,455,370,"51.5288338","-0.132250369","Doric Way , Somers Town",825
"2388",2020,4,26,177,171,"51.52728093","-0.11829517","Ampton Street , Clerkenwell",348
"2389",2020,4,27,302,302,"51.51382102","-0.107927706","Bouverie Street, Temple",604
"2390",2020,4,28,257,255,"51.52351808","-0.143613641","Bolsover Street, Fitzrovia",512
"2391",2020,4,29,201,152,"51.513735","-0.193487","Hereford Road, Bayswater",353
"2392",2020,4,30,272,223,"51.52915444","-0.093421615","Windsor Terrace, Hoxton",495
"2393",2020,4,31,191,198,"51.52953709","-0.083353323","Fanshaw Street, Hoxton",389
"2394",2020,4,32,445,500,"51.52469624","-0.084439283","Leonard Circus , Shoreditch",945
"2395",2020,4,33,219,224,"51.5156","-0.070056","Central House, Aldgate",443
"2396",2020,4,34,150,147,"51.5341235","-0.129386874","Pancras Road, King's Cross",297
"2397",2020,4,36,188,191,"51.50173726","-0.184980612","De Vere Gardens, Kensington",379
"2398",2020,4,37,230,221,"51.49159394","-0.192369256","Penywern Road, Earl's Court",451
"2399",2020,4,38,104,95,"51.4973875","-0.197245586","Abingdon Villas, Kensington",199
"2400",2020,4,39,455,464,"51.5263778","-0.078130921","Shoreditch High Street, Shoreditch",919
"2401",2020,4,40,150,141,"51.52127071","-0.0755789","Commercial Street, Shoreditch",291
"2402",2020,4,41,389,417,"51.520955","-0.083493552","Pindar Street, Liverpool Street",806
"2403",2020,4,42,258,210,"51.53099181","-0.093903825","Wenlock Road , Hoxton",468
"2404",2020,4,43,293,294,"51.52026","-0.157183945","Crawford Street, Marylebone",587
"2405",2020,4,44,159,144,"51.51073687","-0.144165239","Bruton Street, Mayfair",303
"2406",2020,4,45,426,326,"51.522511","-0.162298","Boston Place, Marylebone",752
"2407",2020,4,46,420,395,"51.507131","-0.06691","Nesham Street, Wapping",815
"2408",2020,4,47,208,203,"51.52334476","-0.183846408","Warwick Avenue Station, Maida Vale",411
"2409",2020,4,48,315,375,"51.51248445","-0.099141408","Godliman Street, St. Paul's",690
"2410",2020,4,49,121,143,"51.50706909","-0.145904427","Curzon Street, Mayfair",264
"2411",2020,4,50,196,192,"51.52867339","-0.087459376","East Road, Hoxton",388
"2412",2020,4,51,221,209,"51.52671796","-0.104298194","Finsbury Library , Finsbury",430
"2413",2020,4,52,194,190,"51.52295439","-0.094934859","Roscoe Street, St. Luke's",384
"2414",2020,4,53,121,164,"51.5099923","-0.143495266","Grafton Street, Mayfair",285
"2415",2020,4,54,251,256,"51.52174785","-0.094475072","Golden Lane, Barbican",507
"2416",2020,4,55,620,763,"51.51707521","-0.086685542","Finsbury Circus, Liverpool Street",1383
"2417",2020,4,56,180,209,"51.52058381","-0.154701411","Paddington Street, Marylebone",389
"2418",2020,4,57,271,271,"51.52334672","-0.120202614","Guilford Street , Bloomsbury",542
"2419",2020,4,58,323,348,"51.52452699","-0.079248081","New Inn Yard, Shoreditch",671
"2420",2020,4,60,114,80,"51.52644828","-0.172190727","Lisson Grove, St. John's Wood",194
"2421",2020,4,61,254,224,"51.49738251","-0.089446947","Great Dover Street, The Borough",478
"2422",2020,4,62,95,80,"51.4907579","-0.106323685","Cotton Garden Estate, Kennington",175
"2423",2020,4,63,131,94,"51.53089041","-0.089782579","Murray Grove , Hoxton",225
"2424",2020,4,64,395,493,"51.50946212","-0.124749274","William IV Street, Strand",888
"2425",2020,4,65,221,228,NA,NA,NA,449
"2426",2020,4,66,732,910,"51.51795029","-0.108657431","Holborn Circus, Holborn",1642
"2427",2020,4,67,351,316,"51.51882555","-0.108028472","Hatton Garden, Holborn",667
"2428",2020,4,68,357,335,"51.52059681","-0.116688468","Theobald's Road , Holborn",692
"2429",2020,4,69,204,191,"51.5262363","-0.134407652","Euston Road, Euston",395
"2430",2020,4,70,119,73,"51.53136059","-0.117069978","Calshot Street , King's Cross",192
"2431",2020,4,71,484,642,"51.5154186","-0.098850915","Newgate Street , St. Paul's",1126
"2432",2020,4,72,211,208,"51.52352001","-0.108340165","Farringdon Lane, Clerkenwell",419
"2433",2020,4,73,516,528,"51.52572618","-0.088486188","Old Street Station, St. Luke's",1044
"2434",2020,4,74,516,513,"51.48591714","-0.124469948","Vauxhall Cross, Vauxhall",1029
"2435",2020,4,75,259,261,"51.53219984","-0.105480698","Torrens Street, Angel",520
"2436",2020,4,76,128,102,"51.52559505","-0.144083893","Longford Street, The Regent's Park",230
"2437",2020,4,77,257,258,"51.52341837","-0.124121774","Russell Square Station, Bloomsbury",515
"2438",2020,4,78,245,235,"51.52486887","-0.099489485","Sadlers Sports Centre, Finsbury",480
"2439",2020,4,79,120,152,"51.511726","-0.11385596","Arundel Street, Temple",272
"2440",2020,4,80,212,193,"51.50069361","-0.102091246","Webber Street , Southwark",405
"2441",2020,4,81,236,250,"51.52025302","-0.141327271","Great Titchfield Street, Fitzrovia",486
"2442",2020,4,82,157,163,"51.514274","-0.111257","Chancery Lane, Holborn",320
"2443",2020,4,83,290,300,"51.50963938","-0.131510949","Panton Street, West End",590
"2444",2020,4,84,221,237,"51.51593725","-0.111778348","Breams Buildings, Holborn",458
"2445",2020,4,85,297,302,"51.50064702","-0.078600401","Tanner Street, Bermondsey",599
"2446",2020,4,86,156,166,"51.48947903","-0.115156562","Sancroft Street, Vauxhall",322
"2447",2020,4,87,318,328,"51.51646835","-0.079684557","Devonshire Square, Liverpool Street",646
"2448",2020,4,88,366,421,"51.51858757","-0.132053392","Bayley Street , Bloomsbury",787
"2449",2020,4,89,244,229,"51.5262503","-0.123509611","Tavistock Place, Bloomsbury",473
"2450",2020,4,90,85,69,"51.53301907","-0.139174593","Harrington Square 1, Camden Town",154
"2451",2020,4,91,153,134,"51.49368637","-0.111014912","Walnut Tree Walk, Vauxhall",287
"2452",2020,4,92,188,191,"51.49889832","-0.100440521","Borough Road, Elephant & Castle",379
"2453",2020,4,93,234,114,"51.53440868","-0.109025404","Cloudesley Road, Angel",348
"2454",2020,4,94,293,254,"51.49506109","-0.085814489","Bricklayers Arms, Borough",547
"2455",2020,4,95,439,463,"51.5208417","-0.097340162","Aldersgate Street, Barbican",902
"2456",2020,4,96,178,157,"51.53095071","-0.078505384","Falkirk Street, Hoxton",335
"2457",2020,4,97,210,225,"51.49792478","-0.183834706","Gloucester Road (North), Kensington",435
"2458",2020,4,98,327,250,"51.52554222","-0.138231303","Hampstead Road, Euston",577
"2459",2020,4,99,256,271,"51.51457763","-0.158264483","Old Quebec Street, Marylebone",527
"2460",2020,4,100,161,160,"51.49043573","-0.122806861","Albert Embankment, Vauxhall",321
"2461",2020,4,101,729,732,"51.51155322","-0.0929401","Queen Street 1, Bank",1461
"2462",2020,4,102,297,322,"51.51340693","-0.076793375","Jewry Street, Aldgate",619
"2463",2020,4,103,101,93,"51.50472376","-0.192538767","Vicarage Gate, Kensington",194
"2464",2020,4,104,673,731,"51.51159481","-0.077121322","Crosswall, Tower",1404
"2465",2020,4,105,199,213,"51.51552971","-0.190240716","Westbourne Grove, Bayswater",412
"2466",2020,4,106,121,122,"51.51410514","-0.147301667","Woodstock Street, Mayfair",243
"2467",2020,4,107,536,521,"51.52600832","-0.096317627","Finsbury Leisure Centre, St. Luke's",1057
"2468",2020,4,108,164,174,"51.49812559","-0.132102166","Abbey Orchard Street, Westminster",338
"2469",2020,4,109,526,650,"51.51563144","-0.132328837","Soho Square , Soho",1176
"2470",2020,4,110,134,127,"51.53304322","-0.172528678","Wellington Road, St. John's Wood",261
"2471",2020,4,111,272,296,"51.5100172","-0.157275636","Park Lane , Hyde Park",568
"2472",2020,4,112,169,246,"51.51580998","-0.105270275","Stonecutter Street, Holborn",415
"2473",2020,4,113,152,152,"51.49646288","-0.183289032","Gloucester Road (Central), South Kensington",304
"2474",2020,4,114,203,209,"51.52451738","-0.158963647","Park Road (Baker Street), The Regent's Park",412
"2475",2020,4,115,370,404,"51.51423368","-0.073537654","Braham Street, Aldgate",774
"2476",2020,4,116,419,471,"51.51449962","-0.141423695","Little Argyll Street, West End",890
"2477",2020,4,117,281,244,"51.49288067","-0.114934001","Lollard Street, Vauxhall",525
"2478",2020,4,118,166,185,"51.49582705","-0.13547809","Rochester Row, Westminster",351
"2479",2020,4,119,381,369,"51.52589324","-0.090847761","Bath Street, St. Luke's",750
"2480",2020,4,120,167,197,"51.51573534","-0.093080779","The Guildhall, Guildhall",364
"2481",2020,4,121,268,270,"51.51891348","-0.156166631","Baker Street, Marylebone",538
"2482",2020,4,122,264,318,"51.52111369","-0.078869751","Norton Folgate, Liverpool Street",582
"2483",2020,4,123,143,135,"51.52836014","-0.104724625","St. John Street, Finsbury",278
"2484",2020,4,124,94,90,"51.49654462","-0.150905245","Eaton Square, Belgravia",184
"2485",2020,4,125,227,229,"51.50069491","-0.094524319","Borough High Street, The Borough",456
"2486",2020,4,126,389,390,"51.51782144","-0.096496865","Museum of London, Barbican",779
"2487",2020,4,127,159,213,"51.51700801","-0.09388536","Wood Street, Guildhall",372
"2488",2020,4,128,171,160,"51.49536226","-0.185296516","Emperor's Gate, South Kensington",331
"2489",2020,4,129,222,255,"51.5118973","-0.137043852","Golden Square, Soho",477
"2490",2020,4,130,353,430,"51.50950627","-0.075459482","Tower Gardens , Tower",783
"2491",2020,4,131,134,122,"51.53300545","-0.136792671","Eversholt Street , Camden Town",256
"2492",2020,4,132,685,698,"51.52364804","-0.074754872","Bethnal Green Road, Shoreditch",1383
"2493",2020,4,133,422,427,NA,NA,NA,849
"2494",2020,4,134,117,116,"51.504904","-0.06797","Wapping High Street, Wapping",233
"2495",2020,4,135,398,395,"51.52326004","-0.104708922","Clerkenwell Green, Clerkenwell",793
"2496",2020,4,136,326,329,"51.51196176","-0.097441687","Queen Victoria Street, St. Paul's",655
"2497",2020,4,138,214,214,"51.51227622","-0.157436972","Green Street, Mayfair",428
"2498",2020,4,139,144,140,"51.49488108","-0.117974901","Lambeth Road, Vauxhall",284
"2499",2020,4,140,384,434,"51.52096262","-0.085634242","Finsbury Square , Moorgate",818
"2500",2020,4,141,234,259,"51.51530805","-0.147203711","Chapel Place, Marylebone",493
"2501",2020,4,142,135,121,"51.49372451","-0.198286569","West Cromwell Road, Earl's Court",256
"2502",2020,4,143,164,158,"51.4968865","-0.161203828","Pont Street, Knightsbridge",322
"2503",2020,4,144,327,329,"51.48894022","-0.111435796","Kennington Cross, Kennington",656
"2504",2020,4,145,36,23,"51.50074359","-0.202759212","Ilchester Place, Kensington",59
"2505",2020,4,146,82,81,"51.48836528","-0.129361842","Vauxhall Bridge , Pimlico",163
"2506",2020,4,148,280,278,"51.49211134","-0.138364847","Tachbrook Street, Victoria",558
"2507",2020,4,149,177,167,"51.48478899","-0.110683213","Kennington Road Post Office, Oval",344
"2508",2020,4,150,152,185,"51.49705603","-0.168917077","Holy Trinity Brompton, Knightsbridge",337
"2509",2020,4,151,138,99,"51.51213691","-0.201554966","Chepstow Villas, Notting Hill",237
"2510",2020,4,152,182,160,"51.49217002","-0.101536865","Hampton Street, Walworth",342
"2511",2020,4,153,373,351,"51.511933","-0.174411","Bayswater Road, Hyde Park",724
"2512",2020,4,154,1519,1557,"51.50379168","-0.11282408","Waterloo Station 3, Waterloo",3076
"2513",2020,4,155,172,184,"51.49586666","-0.191933711","Lexham Gardens, Kensington",356
"2514",2020,4,156,169,179,"51.49443626","-0.092921165","New Kent Road, The Borough",348
"2515",2020,4,157,252,252,"51.50039792","-0.193068385","Wright's Lane, Kensington",504
"2516",2020,4,158,203,188,"51.49085368","-0.196170309","Trebovir Road, Earl's Court",391
"2517",2020,4,159,422,489,"51.51461995","-0.137841333","Great Marlborough Street, Soho",911
"2518",2020,4,160,223,244,"51.50663341","-0.131773845","Waterloo Place, St. James's",467
"2519",2020,4,162,235,268,"51.51760685","-0.121328408","Southampton Place, Holborn",503
"2520",2020,4,163,305,305,"51.4931848","-0.167894973","Sloane Avenue, Knightsbridge",610
"2521",2020,4,164,174,133,"51.515607","-0.183118788","Cleveland Gardens, Bayswater",307
"2522",2020,4,165,81,58,"51.517932","-0.183716959","Orsett Terrace, Bayswater",139
"2523",2020,4,166,74,102,"51.50185512","-0.159237081","Seville Street, Knightsbridge",176
"2524",2020,4,167,441,473,"51.49395092","-0.147624377","Eccleston Place, Victoria",914
"2525",2020,4,168,111,107,"51.50040123","-0.195455928","Argyll Road, Kensington",218
"2526",2020,4,169,256,235,"51.51474612","-0.165164288","Porchester Place, Paddington",491
"2527",2020,4,170,140,105,"51.52784273","-0.108068155","Hardwick Street, Clerkenwell",245
"2528",2020,4,171,125,124,"51.4916156","-0.186753859","Collingham Gardens, Earl's Court",249
"2529",2020,4,172,130,133,"51.49121192","-0.173715911","Sumner Place, South Kensington",263
"2530",2020,4,173,206,236,"51.50486","-0.113001","Waterloo Road, South Bank",442
"2531",2020,4,174,311,314,"51.512529","-0.115163","Strand, Strand",625
"2532",2020,4,175,301,346,"51.521668","-0.079608554","Worship Street, Shoreditch",647
"2533",2020,4,176,149,141,"51.51791921","-0.188098863","Gloucester Terrace, Bayswater",290
"2534",2020,4,177,409,417,"51.49616092","-0.140947636","Ashley Place, Victoria",826
"2535",2020,4,178,247,204,"51.48985626","-0.141923621","Warwick Square, Pimlico",451
"2536",2020,4,180,172,210,"51.5129118","-0.153645496","North Audley Street, Mayfair",382
"2537",2020,4,181,131,122,"51.49941247","-0.152317537","Belgrave Square, Belgravia",253
"2538",2020,4,182,191,185,"51.52202903","-0.165842551","Bell Street , Marylebone",376
"2539",2020,4,183,255,264,"51.482362","-0.13612398","Riverlight North, Nine Elms",519
"2540",2020,4,184,205,201,"51.52071513","-0.14521173","Portland Place, Marylebone",406
"2541",2020,4,185,227,193,"51.48805753","-0.140741432","Alderney Street, Pimlico",420
"2542",2020,4,186,618,560,"51.51733558","-0.175810943","South Wharf Road, Paddington",1178
"2543",2020,4,187,195,197,"51.49247977","-0.178433004","Queen's Gate (South), South Kensington",392
"2544",2020,4,188,98,87,"51.5165179","-0.164393768","Nutford Place, Marylebone",185
"2545",2020,4,189,148,84,"51.53166681","-0.109914711","Claremont Square, Angel",232
"2546",2020,4,190,270,260,"51.48997562","-0.132845681","Rampayne Street, Pimlico",530
"2547",2020,4,191,791,785,"51.50311799","-0.153520935","Hyde Park Corner, Hyde Park",1576
"2548",2020,4,192,353,356,"51.51251523","-0.133201961","Wardour Street, Soho",709
"2549",2020,4,193,421,446,"51.50581776","-0.100186337","Bankside Mix, Bankside",867
"2550",2020,4,194,797,1178,"51.50462759","-0.091773776","Hop Exchange, The Borough",1975
"2551",2020,4,195,270,265,"51.50724437","-0.106237501","Milroy Walk, South Bank",535
"2552",2020,4,196,256,256,"51.50368837","-0.098497684","Union Street, The Borough",512
"2553",2020,4,197,342,387,"51.50556905","-0.111606696","Stamford Street, South Bank",729
"2554",2020,4,199,553,618,"51.51048489","-0.082989638","Great Tower Street, Monument",1171
"2555",2020,4,200,287,256,"51.51492456","-0.066078037","LMU Commercial Road, Whitechapel",543
"2556",2020,4,201,267,297,"51.5225965","-0.161113413","Dorset Square, Marylebone",564
"2557",2020,4,202,443,432,"51.51236389","-0.06954201","Leman Street, Aldgate",875
"2558",2020,4,203,362,364,"51.51821864","-0.100791005","West Smithfield Rotunda, Farringdon",726
"2559",2020,4,204,186,183,"51.52659961","-0.112432615","Margery Street, Clerkenwell",369
"2560",2020,4,206,304,304,"51.518154","-0.062697","New Road 1 , Whitechapel",608
"2561",2020,4,207,81,80,"51.50135267","-0.153194766","Grosvenor Crescent, Belgravia",161
"2562",2020,4,208,73,48,"51.52505151","-0.166304359","Mallory Street, Marylebone",121
"2563",2020,4,209,131,150,"51.49358391","-0.165101392","Denyer Street, Knightsbridge",281
"2564",2020,4,210,339,386,"51.51681444","-0.151926305","Hinde Street, Marylebone",725
"2565",2020,4,211,120,164,"51.49464523","-0.158105512","Cadogan Place, Knightsbridge",284
"2566",2020,4,212,86,64,"51.50658458","-0.199004026","Campden Hill Road, Notting Hill",150
"2567",2020,4,213,606,589,"51.50274025","-0.149569201","Wellington Arch, Hyde Park",1195
"2568",2020,4,214,425,475,"51.52683806","-0.130504336","Endsleigh Gardens, Euston",900
"2569",2020,4,215,534,565,"51.51906932","-0.088285377","Moorfields, Moorgate",1099
"2570",2020,4,216,236,226,"51.49094565","-0.181190899","Old Brompton Road, South Kensington",462
"2571",2020,4,217,832,876,"51.51615461","-0.082422399","Wormwood Street, Liverpool Street",1708
"2572",2020,4,218,173,171,"51.48971651","-0.170194408","St. Luke's Church, Chelsea",344
"2573",2020,4,219,238,222,"51.49016361","-0.19039362","Bramham Gardens, Earl's Court",460
"2574",2020,4,220,123,132,"51.49066456","-0.166485083","Chelsea Green, Chelsea",255
"2575",2020,4,221,255,272,"51.49481649","-0.13045856","Horseferry Road, Westminster",527
"2576",2020,4,222,73,56,"51.50275704","-0.155349725","Knightsbridge, Hyde Park",129
"2577",2020,4,223,198,185,"51.49148474","-0.090220911","Rodney Road , Walworth",383
"2578",2020,4,224,217,196,"51.51031","-0.18740235","Queensway, Kensington Gardens",413
"2579",2020,4,225,387,294,"51.50935342","-0.196422","Notting Hill Gate Station, Notting Hill",681
"2580",2020,4,226,194,192,"51.50844614","-0.131961389","Charles II Street, West End",386
"2581",2020,4,227,253,232,"51.52891573","-0.115480888","Great Percy Street, Clerkenwell",485
"2582",2020,4,228,453,629,"51.50742485","-0.134621209","St. James's Square, St. James's",1082
"2583",2020,4,229,429,497,"51.50654321","-0.123179697","Whitehall Place, Strand",926
"2584",2020,4,230,170,171,"51.50669284","-0.103137426","Poured Lines, Bankside",341
"2585",2020,4,231,263,276,"51.49396755","-0.17873226","Queen's Gate (Central), South Kensington",539
"2586",2020,4,232,112,104,"51.51501025","-0.112753217","Carey Street, Holborn",216
"2587",2020,4,233,284,331,"51.50777049","-0.130699733","Pall Mall East, West End",615
"2588",2020,4,234,291,293,"51.53450449","-0.106992706","Liverpool Road (N1 Centre), Angel",584
"2589",2020,4,235,160,128,"51.49571828","-0.110889274","Kennington Road  , Vauxhall",288
"2590",2020,4,236,143,148,"51.51838043","-0.073438925","Fashion Street, Whitechapel",291
"2591",2020,4,237,225,217,"51.5097860151","-0.0681619805156","Dock Street, Wapping",442
"2592",2020,4,238,71,42,"51.5233534","-0.175116099","Frampton Street, Paddington",113
"2593",2020,4,239,338,331,"51.52443845","-0.138019439","Warren Street Station, Euston",669
"2594",2020,4,240,99,104,"51.50545935","-0.10569204","Colombo Street, Southwark",203
"2595",2020,4,242,208,205,"51.52200801","-0.151359288","Beaumont Street, Marylebone",413
"2596",2020,4,243,278,260,"51.49096258","-0.139625122","Gloucester Street, Pimlico",538
"2597",2020,4,244,266,273,"51.51611887","-0.128585022","Earnshaw Street , Covent Garden",539
"2598",2020,4,245,117,84,"51.4853572","-0.142207481","Grosvenor Road, Pimlico",201
"2599",2020,4,246,362,418,"51.52285301","-0.099994052","Berry Street, Clerkenwell",780
"2600",2020,4,247,97,53,"51.530529","-0.167515","St. John's Wood Church, The Regent's Park",150
"2601",2020,4,248,312,311,"51.50645179","-0.170279555","Triangle Car Park, Hyde Park",623
"2602",2020,4,249,130,110,"51.49859784","-0.096191134","Harper Road, The Borough",240
"2603",2020,4,250,105,108,"51.489932","-0.162727","Royal Avenue 1, Chelsea",213
"2604",2020,4,251,609,824,"51.518908","-0.079249","Brushfield Street, Liverpool Street",1433
"2605",2020,4,252,390,412,"51.5046364","-0.116542278","Jubilee Gardens, South Bank",802
"2606",2020,4,253,294,204,"51.53404294","-0.086379717","Shoreditch Park, Hoxton",498
"2607",2020,4,254,261,198,"51.53051587","-0.106408455","Chadwell Street, Angel",459
"2608",2020,4,255,135,139,"51.52557531","-0.179592915","Clifton Road, Maida Vale",274
"2609",2020,4,256,135,130,"51.51362054","-0.116764211","Houghton Street, Strand",265
"2610",2020,4,257,107,109,"51.52248185","-0.154907218","Westminster University, Marylebone",216
"2611",2020,4,258,146,156,NA,NA,NA,302
"2612",2020,4,259,176,175,"51.490959","-0.1532331","Bourne Street, Belgravia",351
"2613",2020,4,260,230,239,"51.5136846","-0.135580879","Broadwick Street, Soho",469
"2614",2020,4,261,118,83,"51.5134891","-0.191351186","Princes Square, Bayswater",201
"2615",2020,4,262,171,156,"51.49874469","-0.103132904","LSBU (Borough Road), Elephant & Castle",327
"2616",2020,4,263,255,266,"51.51422502","-0.080660083","St. Mary Axe, Aldgate",521
"2617",2020,4,264,328,311,"51.52644342","-0.109256828","Tysoe Street, Clerkenwell",639
"2618",2020,4,265,202,168,"51.51595344","-0.169249375","Southwick Street, Paddington",370
"2619",2020,4,266,301,354,"51.50102668","-0.180246101","Queen's Gate (North), Kensington",655
"2620",2020,4,267,200,177,"51.49206037","-0.132224622","Regency Street, Westminster",377
"2621",2020,4,268,302,354,"51.49320445","-0.144132875","Belgrave Road, Victoria",656
"2622",2020,4,269,214,227,"51.50082346","-0.089740764","Empire Square, The Borough",441
"2623",2020,4,270,559,556,"51.4863434","-0.122492418","Kennington Lane Rail Bridge, Vauxhall",1115
"2624",2020,4,271,99,81,"51.53583617","-0.156285395","London Zoo,  The Regent's Park",180
"2625",2020,4,272,493,515,"51.50144456","-0.110699309","Baylis Road, Waterloo",1008
"2626",2020,4,273,306,364,"51.50613324","-0.114686385","Belvedere Road 1, South Bank",670
"2627",2020,4,274,152,160,"51.49671237","-0.20528437","Warwick Road, Olympia",312
"2628",2020,4,275,242,248,"51.52004497","-0.092176447","Barbican Centre, Barbican",490
"2629",2020,4,276,152,139,"51.50930161","-0.084985356","Lower Thames Street, Monument",291
"2630",2020,4,277,236,239,"51.50315739","-0.191496313","Kensington Church Street, Kensington",475
"2631",2020,4,278,592,622,"51.5034938","-0.07962099","Tooley Street, Bermondsey",1214
"2632",2020,4,279,307,277,"51.51862243","-0.176645823","North Wharf Road, Paddington",584
"2633",2020,4,280,199,202,"51.490083","-0.162418","Royal Avenue 2, Chelsea",401
"2634",2020,4,281,192,213,"51.49580589","-0.127575233","Smith Square, Westminster",405
"2635",2020,4,282,451,457,"51.51906446","-0.059642081","Royal London Hospital, Whitechapel",908
"2636",2020,4,283,75,74,"51.51440928","-0.118478757","Kingsway, Covent Garden",149
"2637",2020,4,284,153,160,"51.49914063","-0.112031483","Lambeth North Station, Waterloo",313
"2638",2020,4,286,118,73,"51.5272947","-0.174653609","St. John's Wood Road, St. John's Wood",191
"2639",2020,4,287,189,186,"51.52367314","-0.128377673","Bedford Way, Bloomsbury",375
"2640",2020,4,288,272,315,"51.49236962","-0.147478734","Elizabeth Bridge, Victoria",587
"2641",2020,4,289,86,84,"51.50923022","-0.151296092","South Audley Street, Mayfair",170
"2642",2020,4,290,158,161,"51.518268","-0.17110323","St Mary's Hospital, Paddington",319
"2643",2020,4,291,221,213,"51.48483991","-0.138089062","Claverton Street, Pimlico",434
"2644",2020,4,292,252,251,"51.49888404","-0.165471605","Montpelier Street, Knightsbridge",503
"2645",2020,4,293,118,111,"51.49815779","-0.209494128","Kensington Olympia Station, Olympia",229
"2646",2020,4,294,258,244,"51.488226","-0.135635511","St. George's Square, Pimlico",502
"2647",2020,4,295,217,203,"51.50029631","-0.092762704","Swan Street, The Borough",420
"2648",2020,4,296,134,130,"51.49363156","-0.190603326","Knaresborough Place, Earl's Court",264
"2649",2020,4,297,63,48,"51.49612799","-0.106000855","Geraldine Street, Elephant & Castle",111
"2650",2020,4,298,398,405,"51.50227992","-0.074189225","Curlew Street, Shad Thames",803
"2651",2020,4,299,107,120,"51.49398524","-0.136928582","Vincent Square, Westminster",227
"2652",2020,4,300,364,359,"51.505014","-0.17306032","Serpentine Car Park, Hyde Park",723
"2653",2020,4,301,261,267,"51.51475963","-0.148105415","Marylebone Lane, Marylebone",528
"2654",2020,4,302,127,138,"51.466907","-0.216573","Putney Pier, Wandsworth",265
"2655",2020,4,303,572,574,"51.50295379","-0.158456089","Albert Gate, Hyde Park",1146
"2656",2020,4,306,188,184,"51.51816295","-0.135025698","Rathbone Street, Fitzrovia",372
"2657",2020,4,307,439,433,"51.50990837","-0.187842717","Black Lion Gate, Kensington Gardens",872
"2658",2020,4,308,213,186,"51.49907558","-0.085666316","Long Lane , Bermondsey",399
"2659",2020,4,309,170,152,"51.50963123","-0.119047563","Embankment (Savoy), Strand",322
"2660",2020,4,310,238,218,"51.4908679","-0.116911864","Black Prince Road, Vauxhall",456
"2661",2020,4,311,226,214,"51.51918144","-0.140485596","Foley Street, Fitzrovia",440
"2662",2020,4,312,141,125,"51.53088935","-0.176770502","Grove End Road, St. John's Wood",266
"2663",2020,4,313,293,312,"51.51734403","-0.138072691","Wells Street, Fitzrovia",605
"2664",2020,4,314,219,223,"51.50088934","-0.083159352","Tyers Gate, Bermondsey",442
"2665",2020,4,315,93,94,"51.52536703","-0.153463612","The Tennis Courts, The Regent's Park",187
"2666",2020,4,316,163,195,NA,NA,NA,358
"2667",2020,4,317,94,79,"51.49679128","-0.093913472","Dickens Square, Borough",173
"2668",2020,4,318,227,247,"51.51004801","-0.138846453","Sackville Street, Mayfair",474
"2669",2020,4,319,281,287,"51.52702563","-0.088542771","Baldwin Street, St. Luke's",568
"2670",2020,4,320,306,316,"51.49357351","-0.139956043","Queen Mother Sports Centre, Victoria",622
"2671",2020,4,321,361,332,"51.49785559","-0.081608045","Bermondsey Street, Bermondsey",693
"2672",2020,4,322,117,122,"51.526293","-0.073955","Palissy Street, Shoreditch",239
"2673",2020,4,323,159,172,"51.523196","-0.083067","Clifton Street, Shoreditch",331
"2674",2020,4,324,282,278,"51.49652013","-0.101384068","Ontario Street, Elephant & Castle",560
"2675",2020,4,325,152,181,"51.50908747","-0.129697889","St. Martin's Street, West End",333
"2676",2020,4,326,329,280,"51.53266186","-0.099981142","Graham Street, Angel",609
"2677",2020,4,327,78,43,"51.53095","-0.085603","New North Road 1, Hoxton",121
"2678",2020,4,328,74,68,"51.53114","-0.086016","New North Road 2, Hoxton",142
"2679",2020,4,329,138,135,"51.53589283","-0.160854428","Prince Albert Road, The Regent's Park",273
"2680",2020,4,330,294,268,"51.51641749","-0.179135079","Eastbourne Mews, Paddington",562
"2681",2020,4,331,411,419,"51.52085887","-0.089887855","Bunhill Row, Moorgate",830
"2682",2020,4,332,112,92,"51.49334336","-0.194757949","Nevern Place, Earl's Court",204
"2683",2020,4,333,211,145,"51.50860544","-0.193764092","Palace Gardens Terrace, Notting Hill",356
"2684",2020,4,334,170,178,"51.505044","-0.115851","Concert Hall Approach 1, South Bank",348
"2685",2020,4,335,231,332,"51.51196803","-0.120718759","Tavistock Street, Covent Garden",563
"2686",2020,4,336,123,200,"51.504942","-0.115533","Concert Hall Approach 2, South Bank",323
"2687",2020,4,337,107,77,"51.51108452","-0.197524944","Pembridge Villas, Notting Hill",184
"2688",2020,4,338,398,448,"51.51175646","-0.119643424","Wellington Street , Strand",846
"2689",2020,4,339,134,84,"51.5333196","-0.1117812","Risinghill Street, Angel",218
"2690",2020,4,340,441,499,"51.51444134","-0.087587447","Bank of England Museum, Bank",940
"2691",2020,4,341,643,665,"51.50810309","-0.12602103","Craven Street, Strand",1308
"2692",2020,4,343,135,121,"51.53692216","-0.150181444","London Zoo Car Park, The Regent's Park",256
"2693",2020,4,344,182,151,"51.528246","-0.10102611","Goswell Road (City Uni), Finsbury",333
"2694",2020,4,345,399,395,"51.48802358","-0.166878535","Flood Street, Chelsea",794
"2695",2020,4,347,235,238,"51.50013942","-0.113936001","Lower Marsh, Waterloo",473
"2696",2020,4,348,153,236,"51.51217033","-0.150481272","Grosvenor Square, Mayfair",389
"2697",2020,4,349,189,261,"51.51196","-0.142783033","St. George Street, Mayfair",450
"2698",2020,4,350,220,221,"51.5017154373867","-0.1798541843891","Queen's Gate, Kensington Gardens",441
"2699",2020,4,351,235,174,"51.529423","-0.097122","Macclesfield Rd, St Lukes",409
"2700",2020,4,352,147,143,"51.486965","-0.116625","Vauxhall Street, Vauxhall",290
"2701",2020,4,353,89,117,"51.49459148","-0.134234258","Greycoat Street , Westminster",206
"2702",2020,4,354,282,387,"51.506767","-0.123702","Northumberland Avenue, Strand",669
"2703",2020,4,355,50,66,NA,NA,NA,116
"2704",2020,4,356,494,506,"51.494412","-0.173881","South Kensington Station, South Kensington",1000
"2705",2020,4,357,308,335,"51.520994","-0.139016","Howland Street, Fitzrovia",643
"2706",2020,4,358,248,262,"51.516226","-0.124826","High Holborn , Covent Garden",510
"2707",2020,4,359,133,145,"51.49782999","-0.135440826","Butler Place, Westminster",278
"2708",2020,4,360,311,423,"51.49675303","-0.138733562","Howick Place, Westminster",734
"2709",2020,4,361,603,514,"51.50391973","-0.11342629","Waterloo Station 2, Waterloo",1117
"2710",2020,4,362,224,144,"51.536264","-0.133952","Royal College Street, Camden Town",368
"2711",2020,4,363,41,40,"51.5291212008901","-0.171185284853","Lord's, St. John's Wood",81
"2712",2020,4,364,282,300,"51.519656","-0.132339","Alfred Place, Bloomsbury",582
"2713",2020,4,365,228,191,"51.530344","-0.100168","City Road, Angel",419
"2714",2020,4,366,106,135,"51.5109192966489","-0.1511263847351","Millennium Hotel, Mayfair",241
"2715",2020,4,367,100,105,"51.5173721","-0.1642075","Harrowby Street, Marylebone",205
"2716",2020,4,368,192,214,"51.50024195","-0.15934065","Harriet Street, Knightsbridge",406
"2717",2020,4,370,56,35,"51.520205","-0.174593","Paddington Green, Paddington",91
"2718",2020,4,371,102,88,"51.49775","-0.10988","King Edward Walk, Waterloo",190
"2719",2020,4,372,205,231,"51.515208","-0.117863","Sardinia Street, Holborn",436
"2720",2020,4,373,172,187,"51.49980661","-0.176415994","Prince Consort Road, Knightsbridge",359
"2721",2020,4,374,1368,1268,"51.50402794","-0.11386436","Waterloo Station 1, Waterloo",2636
"2722",2020,4,375,107,107,"51.50194596","-0.194392952","Kensington Town Hall, Kensington",214
"2723",2020,4,376,266,294,"51.49188409","-0.125674815","Millbank Tower, Pimlico",560
"2724",2020,4,377,148,139,"51.50535447","-0.113656543","Waterloo Bridge, South Bank",287
"2725",2020,4,378,73,91,"51.49559291","-0.179077626","Natural History Museum, South Kensington",164
"2726",2020,4,379,191,194,"51.51431171","-0.200838199","Turquoise Island, Notting Hill",385
"2727",2020,4,380,120,132,"51.50686435","-0.150666888","Stanhope Gate, Mayfair",252
"2728",2020,4,381,219,221,"51.51953043","-0.13577731","Charlotte Street, Fitzrovia",440
"2729",2020,4,382,106,122,"51.50935171","-0.14744969","Farm Street, Mayfair",228
"2730",2020,4,383,267,286,"51.51310333","-0.13121385","Frith Street, Soho",553
"2731",2020,4,384,87,85,"51.496481","-0.192404","Marloes Road, Kensington",172
"2732",2020,4,386,385,408,"51.51352755","-0.130110822","Moor Street, Soho",793
"2733",2020,4,387,250,219,"51.49369988","-0.121394101","Fire Brigade Pier, Vauxhall",469
"2734",2020,4,388,264,296,"51.51070161","-0.121723604","Southampton Street, Strand",560
"2735",2020,4,389,41,42,"51.51013066","-0.155757901","Upper Grosvenor Street, Mayfair",83
"2736",2020,4,390,96,97,"51.521776","-0.068856","Buxton Street 1, Shoreditch",193
"2737",2020,4,392,380,399,"51.49942855","-0.179702476","Imperial College, Knightsbridge",779
"2738",2020,4,393,356,362,"51.51733427","-0.103604248","Snow Hill, Farringdon",718
"2739",2020,4,394,101,75,"51.524826","-0.176268","Aberdeen Place, St. John's Wood",176
"2740",2020,4,395,277,279,"51.492462","-0.159919","Cadogan Gardens, Chelsea",556
"2741",2020,4,396,152,150,"51.51809","-0.163609","Shouldham Street, Marylebone",302
"2742",2020,4,397,281,236,"51.51348","-0.17977","Devonshire Terrace, Bayswater",517
"2743",2020,4,398,103,67,"51.502319","-0.200742","Holland Park, Kensington",170
"2744",2020,4,399,230,233,"51.52261762","-0.071653961","Brick Lane Market, Shoreditch",463
"2745",2020,4,401,217,196,"51.528187","-0.075375","Columbia Road, Shoreditch",413
"2746",2020,4,402,106,95,"51.52289229","-0.171681991","Penfold Street, Marylebone",201
"2747",2020,4,403,185,198,"51.51689296","-0.158249929","George Place Mews, Marylebone",383
"2748",2020,4,404,302,304,"51.50204238","-0.184400221","Palace Gate, Kensington Gardens",606
"2749",2020,4,405,416,407,"51.49418566","-0.18267094","Gloucester Road Station, South Kensington",823
"2750",2020,4,408,70,50,NA,NA,NA,120
"2751",2020,4,409,291,260,"51.493146","-0.099828","Strata, Elephant & Castle",551
"2752",2020,4,410,169,117,"51.519968","-0.169774","Edgware Road Station, Marylebone",286
"2753",2020,4,411,252,273,"51.49337264","-0.09968067","Walworth Road, Elephant & Castle",525
"2754",2020,4,412,118,117,"51.488105","-0.110121","Cleaver Street, Kennington",235
"2755",2020,4,419,160,147,"51.485821","-0.149004","Chelsea Bridge, Pimlico",307
"2756",2020,4,420,3,4,"51.504043","-0.105312","Southwark Station 1, Southwark",7
"2757",2020,4,421,426,401,"51.504044","-0.104778","Southwark Station 2, Southwark",827
"2758",2020,4,423,101,107,"51.49456127","-0.15393398","Eaton Square (South), Belgravia",208
"2759",2020,4,424,189,164,"51.490491","-0.149186","Ebury Bridge, Pimlico",353
"2760",2020,4,425,195,162,"51.533379","-0.139159","Harrington Square 2, Camden Town",357
"2761",2020,4,426,172,189,"51.493072","-0.129925","Vincent Street, Pimlico",361
"2762",2020,4,427,606,662,"51.51397065","-0.09294031","Cheapside, Bank",1268
"2763",2020,4,428,473,568,"51.499917","-0.174554","Exhibition Road, Knightsbridge",1041
"2764",2020,4,430,101,108,"51.48902","-0.17524","South Parade, Chelsea",209
"2765",2020,4,431,141,137,"51.534474","-0.122203","Crinan Street, King's Cross",278
"2766",2020,4,432,278,290,"51.496957","-0.173894","Exhibition Road Museums, South Kensington",568
"2767",2020,4,433,366,348,"51.524564","-0.116279","Wren Street, Holborn",714
"2768",2020,4,435,196,188,"51.488852","-0.105593","Kennington Station, Kennington",384
"2769",2020,4,436,455,460,"51.51824","-0.11655","Red Lion Street, Holborn",915
"2770",2020,4,437,179,183,"51.488124","-0.120903","Vauxhall Walk, Vauxhall",362
"2771",2020,4,439,100,76,"51.5338","-0.118677","Killick Street, King's Cross",176
"2772",2020,4,440,147,142,"51.483145","-0.113134","Kennington Oval, Oval",289
"2773",2020,4,441,189,172,"51.495656","-0.114605","Sail Street, Vauxhall",361
"2774",2020,4,442,64,65,"51.510101","-0.211358","Walmer Road, Avondale",129
"2775",2020,4,443,261,216,"51.515256","-0.058641","Philpot Street, Whitechapel",477
"2776",2020,4,444,216,208,"51.52568","-0.055312","Bethnal Green Garden, Bethnal Green",424
"2777",2020,4,445,140,123,"51.52388","-0.065076","Cheshire Street, Bethnal Green",263
"2778",2020,4,446,254,258,"51.528936","-0.055894","York Hall, Bethnal Green",512
"2779",2020,4,447,40,39,"51.493381","-0.007542","Jubilee Crescent, Cubitt Town",79
"2780",2020,4,448,142,151,"51.50623","-0.02296","Fisherman's Walk West, Canary Wharf",293
"2781",2020,4,449,264,260,"51.511088","-0.057159","Shadwell Station, Shadwell",524
"2782",2020,4,450,181,127,"51.515975","-0.053177","Jubilee Street, Stepney",308
"2783",2020,4,451,175,169,"51.504719","-0.063531","Hermitage Court, Wapping",344
"2784",2020,4,452,148,144,"51.505697","-0.070542","St. Katharine's Way, Tower",292
"2785",2020,4,453,158,142,"51.508447","-0.055167","Garnet Street, Shadwell",300
"2786",2020,4,454,60,52,"51.487679","-0.021582","Napier Avenue, Millwall",112
"2787",2020,4,455,50,46,"51.49447","-0.014409","East Ferry Road, Cubitt Town",96
"2788",2020,4,456,150,158,"51.538071","-0.144664","Parkway, Camden Town",308
"2789",2020,4,457,233,194,"51.542138","-0.145393","Castlehaven Road, Camden Town",427
"2790",2020,4,458,200,196,"51.504749","-0.057544","Wapping Lane, Wapping",396
"2791",2020,4,459,198,171,"51.535179","-0.03338","Gunmakers Lane, Old Ford",369
"2792",2020,4,460,187,164,"51.516196","-0.029138","Burdett Road, Mile End",351
"2793",2020,4,461,106,115,"51.516","-0.038775","Aston Street, Stepney",221
"2794",2020,4,462,300,258,"51.541603","-0.138853","Bonny Street, Camden Town",558
"2795",2020,4,463,131,94,"51.534776","-0.071881","Thurtle Road, Haggerston",225
"2796",2020,4,464,53,47,"51.51417","-0.052099","St. Mary & St. Michael Church, Stepney",100
"2797",2020,4,465,292,251,"51.53558","-0.08249","Pitfield Street North,Hoxton",543
"2798",2020,4,466,160,131,"51.534464","-0.076341","Whiston Road, Haggerston",291
"2799",2020,4,467,87,87,"51.523538","-0.030556","Southern Grove, Bow",174
"2800",2020,4,468,41,38,"51.521564","-0.022694","Cantrell Road, Bow",79
"2801",2020,4,469,126,132,"51.513757","-0.020467","Lindfield Street, Poplar",258
"2802",2020,4,470,184,155,"51.530535","-0.025492","Mostyn Grove, Bow",339
"2803",2020,4,471,153,133,"51.533283","-0.028155","Hewison Street, Old Ford",286
"2804",2020,4,472,32,41,"51.529452","-0.027616","Malmesbury Road, Bow",73
"2805",2020,4,473,70,72,"51.496137","-0.019355","Millharbour, Millwall",142
"2806",2020,4,476,27,41,"51.489096","-0.009205","Stebondale Street, Cubitt Town",68
"2807",2020,4,477,67,55,"51.49109","-0.018716","Spindrift Avenue, Millwall",122
"2808",2020,4,478,302,313,"51.521889","-0.04667","Stepney Green Station, Stepney",615
"2809",2020,4,479,250,240,"51.527152","-0.058005","Pott Street, Bethnal Green",490
"2810",2020,4,480,324,320,"51.5128711","-0.0389866","Flamborough Street, Limehouse",644
"2811",2020,4,481,119,126,"51.487129","-0.009001","Saunders Ness Road, Cubitt Town",245
"2812",2020,4,483,160,147,"51.51328","-0.047784","Albert Gardens, Stepney",307
"2813",2020,4,484,79,74,"51.528828","-0.013258","Bromley High Street, Bow",153
"2814",2020,4,485,147,124,"51.531127","-0.048017","Old Ford Road, Bethnal Green",271
"2815",2020,4,486,264,265,"51.525645","-0.069543","Granby Street, Shoreditch",529
"2816",2020,4,488,190,181,"51.506946","-0.058681","Reardon Street, Wapping",371
"2817",2020,4,489,256,240,"51.513074","-0.064094","Christian Street, Whitechapel",496
"2818",2020,4,490,81,74,"51.508622","-0.065006","Pennington Street, Wapping",155
"2819",2020,4,491,279,334,"51.522507","-0.041378","Queen Mary's, Mile End",613
"2820",2020,4,492,190,204,"51.525501","-0.032267204","Maplin Street, Mile End",394
"2821",2020,4,494,3,14,"51.50196","-0.016251","South Quay East, Canary Wharf",17
"2822",2020,4,495,176,161,"51.528169","-0.018703","Bow Church Station, Bow",337
"2823",2020,4,496,93,90,"51.52512","-0.015578","Devons Road, Bow",183
"2824",2020,4,497,62,69,"51.526149","-0.027396845","Merchant Street, Bow",131
"2825",2020,4,498,197,176,"51.527058","-0.025296","Bow Road Station, Bow",373
"2826",2020,4,499,211,195,"51.519265","-0.021345","Furze Green, Bow",406
"2827",2020,4,500,310,268,"51.519806","-0.055731","Ansell House, Stepney",578
"2828",2020,4,501,126,96,"51.522561","-0.054883","Cephas Street, Bethnal Green",222
"2829",2020,4,502,220,200,"51.53341","-0.049591815","Bonner Gate, Victoria Park",420
"2830",2020,4,503,382,394,"51.520893","-0.051394","Cleveland Way, Stepney",776
"2831",2020,4,504,17,15,"51.496454","-0.009506","St. John's Park, Cubitt Town",32
"2832",2020,4,505,94,89,"51.520398","-0.026768","Ackroyd Drive, Bow",183
"2833",2020,4,506,219,242,"51.517475","-0.075855","Bell Lane, Liverpool Street",461
"2834",2020,4,507,141,112,"51.528692","-0.059091","Clarkson Street, Bethnal Green",253
"2835",2020,4,508,316,310,"51.519362","-0.074431","Fournier Street, Whitechapel",626
"2836",2020,4,509,202,220,"51.517842","-0.090075","Fore Street, Guildhall",422
"2837",2020,4,510,240,265,"51.509303","-0.025996","Westferry DLR, Limehouse",505
"2838",2020,4,511,216,219,"51.511066","-0.053558","Sutton Street, Shadwell",435
"2839",2020,4,512,410,369,"51.532091","-0.06142","Pritchard's Road, Bethnal Green",779
"2840",2020,4,513,165,156,"51.5142228","-0.055656","Watney Market, Stepney",321
"2841",2020,4,514,190,213,"51.516204","-0.155525","Portman Square, Marylebone",403
"2842",2020,4,515,80,70,"51.500088","-0.211316","Russell Gardens, Olympia",150
"2843",2020,4,516,122,127,"51.5112","-0.014438","Chrisp Street Market, Poplar",249
"2844",2020,4,517,142,144,"51.532513","-0.033085","Ford Road, Old Ford",286
"2845",2020,4,518,185,157,"51.528224","-0.037471","Antill Road, Mile End",342
"2846",2020,4,519,8,11,"51.518811","-0.011662","Teviot Street, Poplar",19
"2847",2020,4,520,189,149,"51.526041","-0.047218","Bancroft Road, Bethnal Green",338
"2848",2020,4,521,153,149,"51.534137","-0.037366","Driffield Road, Old Ford",302
"2849",2020,4,522,244,256,"51.525941","-0.036017","Clinton Road, Mile End",500
"2850",2020,4,523,43,39,"51.51549","-0.013475","Langdon Park, Poplar",82
"2851",2020,4,524,189,141,"51.511654","-0.179668","Lancaster Gate , Bayswater",330
"2852",2020,4,526,71,67,"51.503143","-0.008428","Lancaster Drive, Blackwall",138
"2853",2020,4,527,117,128,"51.503802","-0.215808","Hansard Mews, Holland Park",245
"2854",2020,4,528,96,117,"51.507326","-0.145827","Clarges Street, Mayfair",213
"2855",2020,4,529,172,166,"51.486892","-0.170983","Manresa Road, Chelsea",338
"2856",2020,4,530,48,54,"51.508896","-0.012413","Newby Place, Poplar",102
"2857",2020,4,531,224,179,"51.530326","-0.042744","Twig Folly Bridge, Mile End",403
"2858",2020,4,532,154,201,"51.50357","-0.020068","Jubilee Plaza, Canary Wharf",355
"2859",2020,4,533,199,192,"51.528222","-0.069743","Wellington Row, Bethnal Green",391
"2860",2020,4,534,253,196,"51.531864","-0.066035","Goldsmith's Row, Haggerston",449
"2861",2020,4,535,166,155,"51.537349","-0.147154","Gloucester Avenue, Camden Town",321
"2862",2020,4,536,90,79,"51.53385","-0.06992","Queensbridge Road, Haggerston",169
"2863",2020,4,537,273,267,"51.51793","-0.067937","Old Montague Street, Whitechapel",540
"2864",2020,4,538,56,58,"51.508981","-0.00699","Naval Row, Blackwall",114
"2865",2020,4,540,182,139,"51.528302","-0.144466","Albany Street, The Regent's Park",321
"2866",2020,4,541,410,413,"51.506613","-0.142844","Green Park Station, Mayfair",823
"2867",2020,4,542,169,177,"51.514115","-0.033828","Salmon Lane, Limehouse",346
"2868",2020,4,543,36,27,"51.509591","-0.204666","Lansdowne Walk, Ladbroke Grove",63
"2869",2020,4,544,189,180,"51.526153","-0.102208","Percival Street, Finsbury",369
"2870",2020,4,545,119,112,"51.539957","-0.145246","Arlington Road, Camden Town",231
"2871",2020,4,546,343,321,"51.517428","-0.107987","New Fetter Lane, Holborn",664
"2872",2020,4,547,44,43,"51.509474","-0.002275","East India DLR, Blackwall",87
"2873",2020,4,548,93,72,"51.498386","-0.107913","Westminster Bridge Road, Elephant & Castle",165
"2874",2020,4,549,193,187,"51.49605","-0.104193","Gaywood  Street, Elephant & Castle",380
"2875",2020,4,550,179,167,"51.521564","-0.039264","Harford Street, Mile End",346
"2876",2020,4,551,120,145,"51.505772","-0.016460175","Import Dock, Canary Wharf",265
"2877",2020,4,552,271,265,"51.511542","-0.056667","Watney Street, Shadwell",536
"2878",2020,4,553,493,477,"51.535678","-0.062546","Regent's Row , Haggerston",970
"2879",2020,4,554,31,32,"51.513548","-0.005659","Aberfeldy Street, Poplar",63
"2880",2020,4,556,87,85,"51.502661","-0.021596","Heron Quays DLR, Canary Wharf",172
"2881",2020,4,557,132,164,"51.51601","-0.0985","King Edward Street, St Pauls",296
"2882",2020,4,558,360,361,"51.493978","-0.127554","Page Street, Westminster",721
"2883",2020,4,559,48,37,"51.501391","-0.205991","Abbotsbury Road, Holland Park",85
"2884",2020,4,560,72,40,"51.511624","-0.205921","Ladbroke Grove Central, Ladbroke Grove",112
"2885",2020,4,561,97,84,"51.518369","-0.043371","Rectory Square, Stepney",181
"2886",2020,4,562,212,225,"51.51746","-0.12335","Bury Place, Holborn",437
"2887",2020,4,563,35,30,"51.499286","-0.009152","Preston's Road, Cubitt Town",65
"2888",2020,4,564,377,465,"51.509943","-0.117619","Somerset House, Strand",842
"2889",2020,4,565,109,98,"51.521905","-0.063386","Selby Street, Whitechapel",207
"2890",2020,4,566,137,144,"51.509158","-0.224103","Westfield Ariel Way, White City",281
"2891",2020,4,568,278,251,"51.51616","-0.18697","Bishop's Bridge Road West, Bayswater",529
"2892",2020,4,569,190,156,"51.53213","-0.08299","Pitfield Street Central, Hoxton",346
"2893",2020,4,570,198,214,"51.503083","-0.017676","Upper Bank Street, Canary Wharf",412
"2894",2020,4,571,94,117,"51.506256","-0.218337","Westfield Southern Terrace ,Shepherd's Bush",211
"2895",2020,4,572,220,229,"51.539099","-0.141728","Greenland Road, Camden Town",449
"2896",2020,4,573,464,477,"51.485587","-0.18119","Limerston Street, West Chelsea",941
"2897",2020,4,574,532,416,"51.53356","-0.09315","Eagle Wharf Road, Hoxton",948
"2898",2020,4,576,60,58,"51.497304","-0.022793","Alpha Grove, Millwall",118
"2899",2020,4,577,205,201,"51.528869","-0.047548","Globe Town Market, Bethnal Green",406
"2900",2020,4,578,93,105,"51.527607","-0.057133","Hollybush Gardens, Bethnal Green",198
"2901",2020,4,579,465,617,"51.511246","-0.093051","Queen Street 2, Bank",1082
"2902",2020,4,580,134,146,"51.48692917","-0.102996299","Doddington Grove, Kennington",280
"2903",2020,4,581,258,279,"51.519167","-0.147983","New Cavendish Street, Marylebone",537
"2904",2020,4,583,234,323,"51.497622","-0.125978","Abingdon Green, Westminster",557
"2905",2020,4,584,187,159,"51.51244","-0.19096","Ilchester Gardens, Bayswater",346
"2906",2020,4,586,36,25,"51.490645","-0.014582","Mudchute DLR, Cubitt Town",61
"2907",2020,4,587,342,377,"51.50964","-0.08497","Monument Street, Monument",719
"2908",2020,4,588,144,127,"51.52959","-0.0801","Hoxton Street, Hoxton",271
"2909",2020,4,589,295,288,"51.487196","-0.179369","Drayton Gardens, West Chelsea",583
"2910",2020,4,590,77,50,"51.53256","-0.16862","Greenberry Street, St.John's Wood",127
"2911",2020,4,592,123,106,"51.5171","-0.18377","Bishop's Bridge Road East, Bayswater",229
"2912",2020,4,593,175,141,"51.531066","-0.11934","Northdown Street, King's Cross",316
"2913",2020,4,594,240,267,"51.513875","-0.117774","Kingsway Southbound, Strand",507
"2914",2020,4,595,225,220,"51.493267","-0.21985","Hammersmith Road, Hammersmith",445
"2915",2020,4,596,245,235,"51.472817","-0.199783","Parson's Green , Parson's Green",480
"2916",2020,4,597,121,116,"51.473471","-0.20782","Fulham Park Road, Fulham",237
"2917",2020,4,598,133,147,"51.494499","-0.228188","Southerton Road, Hammersmith",280
"2918",2020,4,599,95,87,"51.485743","-0.223616","Manbre Road, Hammersmith",182
"2919",2020,4,600,253,246,"51.481747","-0.124642","South Lambeth Road, Vauxhall",499
"2920",2020,4,601,138,142,"51.514767","-0.225787","BBC White City, White City",280
"2921",2020,4,602,220,217,"51.472993","-0.133972","Union Grove, Wandsworth Road",437
"2922",2020,4,603,146,162,"51.477839","-0.116493","Caldwell Street, Stockwell",308
"2923",2020,4,604,88,72,"51.538792","-0.138535","St Martins Close, Camden Town",160
"2924",2020,4,605,186,177,"51.520331","-0.163667","Seymour Place, Marylebone",363
"2925",2020,4,606,79,70,"51.504199","-0.210941","Addison Road, Holland Park",149
"2926",2020,4,607,142,138,"51.468814","-0.210279","Putney Bridge Station, Fulham",280
"2927",2020,4,608,17,23,"51.491093","-0.216493","Colet Gardens, Hammersmith",40
"2928",2020,4,609,98,69,"51.46512358","-0.157788279","Sugden Road, Clapham",167
"2929",2020,4,610,124,121,"51.48256792","-0.172078187","Danvers Street, West Chelsea",245
"2930",2020,4,611,110,107,"51.50646524","-0.208486599","Princedale Road , Holland Park",217
"2931",2020,4,612,197,177,"51.46925984","-0.141812513","Wandsworth Rd, Isley Court, Wandsworth Road",374
"2932",2020,4,613,330,351,"51.50403821","-0.217400093","Woodstock Grove, Shepherd's Bush",681
"2933",2020,4,614,97,74,"51.47817208","-0.144690541","Bradmead, Battersea Park",171
"2934",2020,4,615,171,170,"51.4768851","-0.215895601","Finlay Street, Fulham",341
"2935",2020,4,616,192,168,"51.48102131","-0.209973497","Aintree Street, Fulham",360
"2936",2020,4,617,84,61,"51.47107905","-0.207842908","Elysium Place, Fulham",145
"2937",2020,4,618,165,159,"51.47625965","-0.193254007","Eel Brook Common, Walham Green",324
"2938",2020,4,619,161,125,"51.4737636","-0.197010096","Irene Road, Parsons Green",286
"2939",2020,4,620,151,138,"51.47518024","-0.167160736","Surrey Lane, Battersea",289
"2940",2020,4,621,189,209,"51.46086446","-0.187427294","Wandsworth Town Station, Wandsworth",398
"2941",2020,4,622,197,171,"51.50748124","-0.205535908","Lansdowne Road, Ladbroke Grove",368
"2942",2020,4,623,82,73,"51.46193072","-0.180791784","Nantes Close, Wandsworth",155
"2943",2020,4,624,109,89,"51.4729184","-0.132102704","Courland Grove, Wandsworth Road",198
"2944",2020,4,625,288,271,"51.47761941","-0.149551631","Queen's Circus, Battersea Park",559
"2945",2020,4,626,271,263,"51.48438657","-0.20481514","Normand Park, West Kensington",534
"2946",2020,4,627,71,62,"51.4687905","-0.158230901","Holden Street, Battersea",133
"2947",2020,4,628,185,188,"51.46881971","-0.184318843","William Morris Way, Sands End",373
"2948",2020,4,629,32,49,"51.45995384","-0.190184054","Morie Street, Wandsworth",81
"2949",2020,4,630,92,65,"51.47073264","-0.126994068","Clarence Walk, Stockwell",157
"2950",2020,4,631,179,170,"51.4795017","-0.141770709","Battersea Park Road, Nine Elms",349
"2951",2020,4,632,133,114,"51.47053858","-0.163041605","Sheepcote Lane, Battersea",247
"2952",2020,4,633,150,139,"51.48959104","-0.209378594","Vereker Road, West Kensington",289
"2953",2020,4,634,115,102,"51.49434708","-0.215804559","Brook Green South, Brook Green",217
"2954",2020,4,635,194,183,"51.48606206","-0.214428378","Greyhound Road, Hammersmith",377
"2955",2020,4,636,196,189,"51.46706414","-0.193502076","South Park, Sands End",385
"2956",2020,4,637,40,39,"51.45787019","-0.174691623","Spencer Park, Wandsworth Common",79
"2957",2020,4,638,359,358,"51.46663393","-0.169821175","Falcon Road, Clapham Junction",717
"2958",2020,4,639,233,215,"51.48357068","-0.202038682","Coomer Place, West Kensington",448
"2959",2020,4,640,126,126,"51.47286577","-0.148059277","Silverthorne Road, Battersea",252
"2960",2020,4,641,102,119,"51.49824168","-0.117495865","Archbishop's Park, Waterloo",221
"2961",2020,4,642,60,56,"51.46916161","-0.174485792","Fawcett Close, Battersea",116
"2962",2020,4,643,82,91,"51.5190427","-0.204764421","All Saints' Road, Portobello",173
"2963",2020,4,644,192,183,"51.48373225","-0.223852256","Rainville Road, Hammersmith",375
"2964",2020,4,645,205,200,"51.50173215","-0.100292412","Great Suffolk Street, The Borough",405
"2965",2020,4,646,214,296,"51.49886563","-0.137424571","Buckingham Gate, Westminster",510
"2966",2020,4,647,145,141,"51.50035306","-0.217515071","Richmond Way, Shepherd's Bush",286
"2967",2020,4,648,84,86,"51.46904022","-0.19627483","Peterborough Road, Sands End",170
"2968",2020,4,649,143,145,"51.48180515","-0.18027465","World's End Place, West Chelsea",288
"2969",2020,4,650,131,135,"51.51687069","-0.213872396","St. Mark's Road, North Kensington",266
"2970",2020,4,651,115,85,"51.48089844","-0.183853573","Thorndike Close, West Chelsea",200
"2971",2020,4,652,51,76,"51.51148696","-0.218190203","Evesham Street, Avondale",127
"2972",2020,4,653,189,200,"51.47084722","-0.17070367","Simpson Street, Clapham Junction",389
"2973",2020,4,654,124,131,"51.48267821","-0.117661574","Ashmole Estate, Oval",255
"2974",2020,4,655,125,110,"51.48294452","-0.219346128","Crabtree Lane, Fulham",235
"2975",2020,4,656,71,62,"51.46841875","-0.199135704","Broomhouse Lane, Parsons Green",133
"2976",2020,4,657,79,85,"51.4996806","-0.221791552","Blythe Road West, Shepherd's Bush",164
"2977",2020,4,658,313,322,"51.47729232","-0.16478637","Ethelburga Estate, Battersea Park",635
"2978",2020,4,659,301,298,"51.511934","-0.10307894","Blackfriars Station, St. Paul's",599
"2979",2020,4,660,114,112,"51.49087074","-0.206029743","West Kensington Station, West Kensington",226
"2980",2020,4,661,309,292,"51.51632095","-0.202608612","All Saints Church, Portobello",601
"2981",2020,4,662,190,179,"51.48498496","-0.167919869","Phene Street, Chelsea",369
"2982",2020,4,663,109,101,"51.51323001","-0.211593602","Clarendon Road, Avondale",210
"2983",2020,4,664,160,161,"51.474376","-0.155442787","Austin Road, Battersea Park",321
"2984",2020,4,665,104,96,"51.46108367","-0.191722864","Smugglers Way, Wandsworth",200
"2985",2020,4,666,171,149,"51.49610093","-0.208158259","Olympia Way, Olympia",320
"2986",2020,4,667,120,137,"51.5015946","-0.222293381","Shepherd's Bush Road North, Shepherd's Bush",257
"2987",2020,4,668,180,174,"51.49422354","-0.236769936","Ravenscourt Park Station, Hammersmith",354
"2988",2020,4,669,70,61,"51.47614939","-0.1232585","Teversham Lane, Stockwell",131
"2989",2020,4,670,138,123,"51.46718562","-0.152248582","Ashley Crescent, Battersea",261
"2990",2020,4,671,350,336,"51.475089","-0.201968","Parsons Green Station, Parsons Green",686
"2991",2020,4,673,174,172,"51.46517078","-0.18038939","Hibbert Street, Battersea",346
"2992",2020,4,674,179,111,"51.53546778","-0.11619105","Carnegie Street, King's Cross",290
"2993",2020,4,675,136,140,"51.46348914","-0.182126248","Usk Road, Clapham Junction",276
"2994",2020,4,676,210,185,"51.47787084","-0.126874471","Hartington Road, Stockwell",395
"2995",2020,4,677,84,66,"51.46866929","-0.146544642","Heath Road, Battersea",150
"2996",2020,4,678,47,45,"51.46231278","-0.211468596","Esmond Street, Putney",92
"2997",2020,4,679,143,141,"51.47453545","-0.170210533","Orbel Street, Battersea",284
"2998",2020,4,680,349,329,"51.47768469","-0.170329317","Westbridge Road, Battersea",678
"2999",2020,4,681,165,152,"51.47303687","-0.214749808","Bishop's Avenue, Fulham",317
"3000",2020,4,682,232,216,"51.48810829","-0.22660621","Crisp Road, Hammersmith",448
"3001",2020,4,683,100,82,"51.46506424","-0.163750945","Dorothy Road, Clapham Junction",182
"3002",2020,4,684,63,67,"51.45475251","-0.195197203","Neville Gill Close, Wandsworth",130
"3003",2020,4,685,131,134,"51.46067005","-0.198735357","Osiers Road, Wandsworth",265
"3004",2020,4,686,155,137,"51.48814438","-0.222456468","Beryl Road, Hammersmith",292
"3005",2020,4,687,187,179,"51.49760804","-0.21145598","Maclise Road, Olympia",366
"3006",2020,4,688,43,41,"51.46095151","-0.20066766","Northfields, Wandsworth",84
"3007",2020,4,689,48,30,"51.45922541","-0.180884959","Spanish Road, Clapham Junction",78
"3008",2020,4,690,77,77,"51.47047503","-0.152130083","Stanley Grove, Battersea",154
"3009",2020,4,691,257,236,"51.47946386","-0.195777222","Erin Close, Walham Green",493
"3010",2020,4,692,230,213,"51.54211855","-0.028941601","Cadogan Close, Victoria Park",443
"3011",2020,4,693,61,63,"51.464786","-0.215618902","Felsham Road, Putney",124
"3012",2020,4,694,59,61,"51.46071722","-0.216526155","Putney Rail Station, Putney",120
"3013",2020,4,695,421,419,"51.53638435","-0.102757578","Islington Green, Angel",840
"3014",2020,4,696,190,178,"51.48728535","-0.217995921","Charing Cross Hospital, Hammersmith",368
"3015",2020,4,697,158,109,"51.53639219","-0.112721065","Charlotte Terrace, Angel",267
"3016",2020,4,698,151,116,"51.53908372","-0.070329419","Shoreditch Court, Haggerston",267
"3017",2020,4,699,110,78,"51.5366541","-0.07023031","Belford House, Haggerston",188
"3018",2020,4,700,163,142,"51.47696496","-0.174347066","Battersea Church Road, Battersea",305
"3019",2020,4,701,213,230,"51.47287627","-0.176267008","Vicarage Crescent, Battersea",443
"3020",2020,4,702,220,171,"51.52868155","-0.065550321","Durant Street, Bethnal Green",391
"3021",2020,4,703,347,468,"51.51505991","-0.10534448","St. Bride Street, Holborn",815
"3022",2020,4,704,35,33,"51.45682071","-0.202802098","Mexfield Road, East Putney",68
"3023",2020,4,705,47,45,NA,NA,NA,92
"3024",2020,4,706,247,285,"51.50215353","-0.083632928","Snowsfields, London Bridge",532
"3025",2020,4,707,333,340,"51.49021762","-0.215087092","Barons Court Station, West Kensington",673
"3026",2020,4,708,108,115,"51.46161068","-0.21614583","Disraeli Road, Putney",223
"3027",2020,4,709,57,64,"51.46321128","-0.215550761","Montserrat Road , Putney",121
"3028",2020,4,710,195,182,"51.47439218","-0.163347594","Albert Bridge Road, Battersea Park",377
"3029",2020,4,711,125,118,"51.48335692","-0.216305546","Everington Street, Fulham",243
"3030",2020,4,712,178,167,"51.51854104","-0.034903714","Mile End Stadium, Mile End",345
"3031",2020,4,713,88,88,"51.54100708","-0.14326094","Hawley Crescent, Camden Town",176
"3032",2020,4,714,78,62,"51.47311696","-0.137235175","Stewart's Road, Wandsworth Road",140
"3033",2020,4,715,114,77,"51.51563007","-0.049067243","Aylward Street, Stepney",191
"3034",2020,4,716,99,88,"51.51542791","-0.02356501","Stainsby Road , Poplar",187
"3035",2020,4,717,420,357,"51.53658514","-0.075885686","Dunston Road , Haggerston",777
"3036",2020,4,718,237,253,"51.53571683","-0.060291813","Ada Street, Hackney Central",490
"3037",2020,4,719,252,219,"51.53642464","-0.054162264","Victoria Park Road, Hackney Central",471
"3038",2020,4,720,147,126,"51.48724429","-0.205279052","Star Road, West Kensington",273
"3039",2020,4,721,97,99,"51.53603947","-0.026262677","Wendon Street, Old Ford",196
"3040",2020,4,722,152,131,"51.52458353","-0.058631453","Finnis Street, Bethnal Green",283
"3041",2020,4,723,265,283,"51.46822047","-0.190346493","Stephendale Road, Sands End",548
"3042",2020,4,724,31,48,"51.45799126","-0.184806157","Alma Road, Wandsworth",79
"3043",2020,4,725,209,194,"51.491327","-0.096518684","Walworth Square, Walworth",403
"3044",2020,4,726,191,182,"51.47505096","-0.150908371","Alfreda Street, Battersea Park",373
"3045",2020,4,727,176,169,"51.47569809","-0.20587627","Chesilton Road, Fulham",345
"3046",2020,4,728,42,41,"51.46199911","-0.206240805","Putney Bridge Road, East Putney",83
"3047",2020,4,729,286,246,"51.47893931","-0.208485293","St. Peter's Terrace, Fulham",532
"3048",2020,4,730,184,181,"51.49208492","-0.229116862","Bridge Avenue, Hammersmith",365
"3049",2020,4,731,178,150,"51.47727637","-0.189210466","Michael Road, Walham Green",328
"3050",2020,4,732,719,765,"51.50630441","-0.087262995","Duke Street Hill, London Bridge",1484
"3051",2020,4,733,123,116,"51.50542628","-0.150817316","Park Lane, Mayfair",239
"3052",2020,4,734,77,68,"51.46230566","-0.175407201","Plough Terrace, Clapham Junction",145
"3053",2020,4,735,202,208,"51.46489445","-0.17302926","Grant Road East, Clapham Junction",410
"3054",2020,4,736,49,51,"51.50659035","-0.216104479","Queensdale Road, Shepherd's Bush",100
"3055",2020,4,737,508,526,"51.47993289","-0.19411695","Fulham Broadway, Walham Green",1034
"3056",2020,4,738,162,151,"51.47514228","-0.187278987","Imperial Road, Sands End",313
"3057",2020,4,739,168,150,"51.48176572","-0.185273723","Hortensia Road, West Brompton",318
"3058",2020,4,740,49,46,"51.51092871","-0.214594781","Sirdar Road, Avondale",95
"3059",2020,4,741,45,46,"51.5129814","-0.219486603","Freston Road, Avondale",91
"3060",2020,4,742,144,141,"51.51510818","-0.208565479","Blenheim Crescent, Ladbroke Grove",285
"3061",2020,4,743,30,37,"51.46079243","-0.212607684","Oxford Road, Putney",67
"3062",2020,4,744,35,38,"51.46745485","-0.172293499","Ingrave Street, Clapham Junction",73
"3063",2020,4,745,130,115,"51.47816972","-0.18243547","Upcerne Road, West Chelsea",245
"3064",2020,4,746,153,140,"51.4795738","-0.17903854","Lots Road, West Chelsea",293
"3065",2020,4,747,163,152,"51.48796408","-0.161765173","Ormonde Gate, Chelsea",315
"3066",2020,4,748,300,257,"51.53727795","-0.079201849","Hertford Road, De Beauvoir Town",557
"3067",2020,4,749,250,236,"51.53932857","-0.074284675","Haggerston Road, Haggerston",486
"3068",2020,4,750,71,59,"51.4710956","-0.157850096","Culvert Road, Battersea",130
"3069",2020,4,751,160,155,"51.51612862","-0.120909408","Newton Street, Covent Garden",315
"3070",2020,4,754,66,74,"51.5129006","-0.214762686","Grenfell Road, Avondale",140
"3071",2020,4,755,214,192,"51.48512191","-0.174971902","The Vale, Chelsea",406
"3072",2020,4,756,180,149,"51.47515398","-0.159169801","Prince of Wales Drive, Battersea Park",329
"3073",2020,4,757,210,186,"51.48795853","-0.187404506","Harcourt Terrace, West Brompton",396
"3074",2020,4,758,133,127,"51.51787005","-0.201005397","Westbourne Park Road, Portobello",260
"3075",2020,4,759,82,64,"51.52456169","-0.165668686","Broadley Terrace, Marylebone",146
"3076",2020,4,760,75,68,"51.52526975","-0.163795009","Rossmore Road, Marylebone",143
"3077",2020,4,761,183,164,"51.48321729","-0.211860644","Humbolt Road, Fulham",347
"3078",2020,4,762,441,534,"51.50070305","-0.129698963","Storey's Gate, Westminster",975
"3079",2020,4,763,197,166,"51.52059714","-0.032566533","Mile End Park Leisure Centre, Mile End",363
"3080",2020,4,764,157,169,"51.46239255","-0.16829214","St. John's Road, Clapham Junction",326
"3081",2020,4,765,78,68,"51.46760141","-0.20682737","Ranelagh Gardens, Fulham",146
"3082",2020,4,766,183,204,"51.45752945","-0.192165613","Ram Street, Wandsworth",387
"3083",2020,4,767,30,28,"51.45705988","-0.200806304","Santos Road, Wandsworth",58
"3084",2020,4,768,101,116,"51.46134382","-0.159322467","Clapham Common North Side, Clapham Common",217
"3085",2020,4,769,205,202,"51.473611","-0.191803","Sandilands Road, Walham Green",407
"3086",2020,4,770,99,105,"51.491026","-0.209121","Gwendwr Road, West Kensington",204
"3087",2020,4,771,61,65,"51.509224","-0.216016","Rifle Place, Avondale",126
"3088",2020,4,772,284,264,"51.47250956","-0.122831913","Binfield Road, Stockwell",548
"3089",2020,4,773,358,390,"51.511891","-0.107349","Tallis Street, Temple",748
"3090",2020,4,774,61,62,"51.470131","-0.20464","Hurlingham Park, Parsons Green",123
"3091",2020,4,775,112,115,"51.496664","-0.223868","Little Brook Green, Brook Green",227
"3092",2020,4,776,99,94,"51.460333","-0.167029","Abyssinia Close, Clapham Junction",193
"3093",2020,4,777,39,19,"51.4619230679","-0.165297856693","Limburg Road, Clapham Junction",58
"3094",2020,4,779,243,264,"51.514449","-0.077178979","Houndsditch, Aldgate",507
"3095",2020,4,780,269,278,"51.474665","-0.18316517","Imperial Wharf Station, Sands End",547
"3096",2020,4,781,176,235,"51.495898","-0.173009","Victoria & Albert Museum, South Kensington",411
"3097",2020,4,782,180,167,"51.483911","-0.19760944","Halford Road, West Kensington",347
"3098",2020,4,783,273,245,"51.5403115","-0.021630359","Monier Road, Hackney Wick",518
"3099",2020,4,784,152,154,"51.546326","-0.00993526","East Village, Queen Elizabeth Olympic Park",306
"3100",2020,4,785,354,351,"51.54094","-0.010510565","Aquatic Centre, Queen Elizabeth Olympic Park",705
"3101",2020,4,786,120,117,"51.549369","-0.015717614","Lee Valley VeloPark, Queen Elizabeth Olympic Park",237
"3102",2020,4,787,107,113,"51.546805","-0.01469126","Timber Lodge, Queen Elizabeth Olympic Park",220
"3103",2020,4,789,103,118,"51.538718","-0.011889482","Podium, Queen Elizabeth Olympic Park",221
"3104",2020,4,790,191,206,"51.541793","-0.00481","Stratford Station, Stratford",397
"3105",2020,4,792,241,221,"51.505461","-0.10454093","Blackfriars Road, Southwark",462
"3106",2020,4,793,117,103,"51.528279","-0.11955857","Cromer Street, Bloomsbury",220
"3107",2020,4,794,38,51,NA,NA,NA,89
"3108",2020,4,795,187,165,"51.527068","-0.13186102","Euston Square Gardens, Euston",352
"3109",2020,4,796,190,153,"51.524","-0.12640984","Coram Street, Bloomsbury",343
"3110",2020,4,797,240,255,"51.5293","-0.12827903","Ossulston Street, Somers Town",495
"3111",2020,4,798,284,347,"51.5301998755","-0.122299440803","Birkenhead Street, King's Cross",631
"3112",2020,4,799,164,206,"51.4976984561","-0.137598896295","Kings Gate House, Westminster",370
"3113",2020,4,800,199,208,"51.4811219398","-0.149035374873","Sopwith Way, Battersea Park",407
"3114",2020,4,801,259,261,"51.5052241745","-0.0980318118664","Lavington Street, Bankside",520
"3115",2020,4,802,159,135,"51.4765900593","-0.118256789081","Albert Square, Stockwell",294
"3116",2020,4,803,194,200,"51.5054099403","-0.0983410884509","Southwark Street, Bankside",394
"3117",2020,4,804,330,339,"51.5346677396","-0.125078652873","Good's Way, King's Cross",669
"3118",2020,4,806,221,203,"51.5372405623","-0.124807385707","Handyside Street, King's Cross",424
"3119",2020,4,807,203,184,"51.5212","-0.20888818","Bevington Road West, North Kensington",387
"3120",2020,4,808,56,50,NA,NA,NA,106
"3121",2020,4,809,182,203,"51.5162778834","-0.118272991635","Lincoln's Inn Fields, Holborn",385
"3122",2020,4,810,284,309,"51.5067252868","-0.0988072461627","Tate Modern, Bankside",593
"3123",2020,4,811,279,275,"51.5057030357","-0.0277727426235","Westferry Circus, Canary Wharf",554
"3124",2020,4,812,49,64,"51.5487311915","-0.0226065549321","Here East North, Queen Elizabeth Olympic Park",113
"3125",2020,4,813,156,175,"51.4878074485","-0.122759625866","New Spring Gardens Walk, Vauxhall",331
"3126",2020,4,814,91,95,"51.4714330677","-0.123670735702","Clapham Road, Lingham Street, Stockwell",186
"3127",2020,4,815,334,336,"51.5000891978","-0.116628700672","Lambeth Palace Road, Waterloo",670
"3128",2020,4,816,74,73,"51.5465327935","-0.0205975904647","Here East South, Queen Elizabeth Olympic Park",147
"3129",2020,4,817,240,217,"51.4813354746","-0.138212295869","Riverlight South, Nine Elms",457
"3130",2020,4,818,496,499,"51.501513","-0.12382322","Westminster Pier, Westminster",995
"3131",2020,4,819,210,190,"51.50621","-0.114842","Belvedere Road 2, South Bank",400
"3132",2020,4,820,146,110,"51.492807","-0.091938","Victory Place, Walworth",256
"3133",2020,4,821,379,365,"51.4835074867","-0.147714557371","Battersea Power Station, Battersea Park",744
"3134",2020,4,826,449,465,"51.496863","-0.1429434","Allington Street, Victoria",914
"3135",2020,4,827,215,217,"51.479601","-0.11147178","Cranmer Road, Stockwell",432
"3136",2020,4,828,148,146,"51.473874","-0.11258096","Normandy Road, Stockwell",294
"3137",2020,4,829,71,61,"51.469217","-0.11268674","Wynne Road, Stockwell",132
"3138",2020,4,830,98,104,"51.469202","-0.11902256","Sidney Road, Stockwell",202
"3139",2020,4,831,91,102,"51.466232","-0.11317995","St John's Crescent, Brixton",193
"3140",2020,4,832,156,158,"51.464019","-0.11578197","Ferndale Road, Brixton",314
"3141",2020,4,833,124,137,"51.460232","-0.11537509","Saltoun Road, Brixton",261
"3142",2020,4,834,166,154,"51.477966","-0.14785703","Gas Holders, Battersea Park",320
"3143",2020,4,835,176,170,"51.516785","-0.10494775","Farringdon Street, Holborn",346
"3144",2020,4,836,155,142,"51.541596","-0.12544145","York Way, Kings Cross",297
"3145",2020,4,838,181,212,"51.518093","-0.0914017","Fore Street Avenue, Guildhall",393
"3146",2020,4,839,407,396,"51.508033","-0.10682363","Sea Containers, South Bank",803
"3147",2020,5,1,162,115,"51.52916347","-0.109970527","River Street , Clerkenwell",277
"3148",2020,5,2,197,213,"51.49960695","-0.197574246","Phillimore Gardens, Kensington",410
"3149",2020,5,3,211,271,"51.52128377","-0.084605692","Christopher Street, Liverpool Street",482
"3150",2020,5,4,135,162,"51.53005939","-0.120973687","St. Chad's Street, King's Cross",297
"3151",2020,5,5,291,370,"51.49313","-0.156876","Sedding Street, Sloane Square",661
"3152",2020,5,6,243,246,"51.51811784","-0.144228881","Broadcasting House, Marylebone",489
"3153",2020,5,7,113,86,"51.53430039","-0.1680743","Charlbert Street, St. John's Wood",199
"3154",2020,5,8,197,158,"51.529857","-0.18348604","Maida Vale, Maida Vale",355
"3155",2020,5,9,194,204,"51.5073853","-0.096440751","New Globe Walk, Bankside",398
"3156",2020,5,10,91,105,"51.50597426","-0.092754157","Park Street, Bankside",196
"3157",2020,5,11,250,233,"51.52395143","-0.122502346","Brunswick Square, Bloomsbury",483
"3158",2020,5,12,483,520,"51.52168078","-0.130431727","Malet Street, Bloomsbury",1003
"3159",2020,5,13,160,171,"51.51991453","-0.136039674","Scala Street, Fitzrovia",331
"3160",2020,5,14,1631,1549,"51.52994371","-0.123616824","Belgrove Street , King's Cross",3180
"3161",2020,5,15,250,267,"51.51772703","-0.127854211","Great Russell Street, Bloomsbury",517
"3162",2020,5,16,326,301,"51.52635795","-0.125979294","Cartwright Gardens , Bloomsbury",627
"3163",2020,5,17,422,426,"51.5216612","-0.109006325","Hatton Wall, Holborn",848
"3164",2020,5,18,369,418,"51.51477076","-0.12221963","Drury Lane, Covent Garden",787
"3165",2020,5,19,296,288,"51.52505093","-0.131161087","Taviton Street, Bloomsbury",584
"3166",2020,5,20,200,125,"51.527326","-0.13605286","Drummond Street , Euston",325
"3167",2020,5,21,68,63,"51.53007835","-0.13884627","Hampstead Road (Cartmel), Euston",131
"3168",2020,5,22,308,316,"51.5222641","-0.114079481","Northington Street , Holborn",624
"3169",2020,5,23,180,188,"51.51943538","-0.119123345","Red Lion Square, Holborn",368
"3170",2020,5,24,316,349,"51.51908011","-0.124678402","British Museum, Bloomsbury",665
"3171",2020,5,25,407,369,"51.5288338","-0.132250369","Doric Way , Somers Town",776
"3172",2020,5,26,172,154,"51.52728093","-0.11829517","Ampton Street , Clerkenwell",326
"3173",2020,5,27,285,319,"51.51382102","-0.107927706","Bouverie Street, Temple",604
"3174",2020,5,28,254,232,"51.52351808","-0.143613641","Bolsover Street, Fitzrovia",486
"3175",2020,5,29,188,160,"51.513735","-0.193487","Hereford Road, Bayswater",348
"3176",2020,5,30,250,223,"51.52915444","-0.093421615","Windsor Terrace, Hoxton",473
"3177",2020,5,31,206,207,"51.52953709","-0.083353323","Fanshaw Street, Hoxton",413
"3178",2020,5,32,440,513,"51.52469624","-0.084439283","Leonard Circus , Shoreditch",953
"3179",2020,5,33,226,217,"51.5156","-0.070056","Central House, Aldgate",443
"3180",2020,5,34,144,139,"51.5341235","-0.129386874","Pancras Road, King's Cross",283
"3181",2020,5,36,193,189,"51.50173726","-0.184980612","De Vere Gardens, Kensington",382
"3182",2020,5,37,231,216,"51.49159394","-0.192369256","Penywern Road, Earl's Court",447
"3183",2020,5,38,112,106,"51.4973875","-0.197245586","Abingdon Villas, Kensington",218
"3184",2020,5,39,476,467,"51.5263778","-0.078130921","Shoreditch High Street, Shoreditch",943
"3185",2020,5,40,159,162,"51.52127071","-0.0755789","Commercial Street, Shoreditch",321
"3186",2020,5,41,386,412,"51.520955","-0.083493552","Pindar Street, Liverpool Street",798
"3187",2020,5,42,255,203,"51.53099181","-0.093903825","Wenlock Road , Hoxton",458
"3188",2020,5,43,258,280,"51.52026","-0.157183945","Crawford Street, Marylebone",538
"3189",2020,5,44,161,165,"51.51073687","-0.144165239","Bruton Street, Mayfair",326
"3190",2020,5,45,458,336,"51.522511","-0.162298","Boston Place, Marylebone",794
"3191",2020,5,46,484,442,"51.507131","-0.06691","Nesham Street, Wapping",926
"3192",2020,5,47,225,202,"51.52334476","-0.183846408","Warwick Avenue Station, Maida Vale",427
"3193",2020,5,48,331,387,"51.51248445","-0.099141408","Godliman Street, St. Paul's",718
"3194",2020,5,49,141,194,"51.50706909","-0.145904427","Curzon Street, Mayfair",335
"3195",2020,5,50,222,236,"51.52867339","-0.087459376","East Road, Hoxton",458
"3196",2020,5,51,213,201,"51.52671796","-0.104298194","Finsbury Library , Finsbury",414
"3197",2020,5,52,216,237,"51.52295439","-0.094934859","Roscoe Street, St. Luke's",453
"3198",2020,5,53,100,173,"51.5099923","-0.143495266","Grafton Street, Mayfair",273
"3199",2020,5,54,208,253,"51.52174785","-0.094475072","Golden Lane, Barbican",461
"3200",2020,5,55,602,722,"51.51707521","-0.086685542","Finsbury Circus, Liverpool Street",1324
"3201",2020,5,56,217,227,"51.52058381","-0.154701411","Paddington Street, Marylebone",444
"3202",2020,5,57,279,288,"51.52334672","-0.120202614","Guilford Street , Bloomsbury",567
"3203",2020,5,58,307,330,"51.52452699","-0.079248081","New Inn Yard, Shoreditch",637
"3204",2020,5,60,111,79,"51.52644828","-0.172190727","Lisson Grove, St. John's Wood",190
"3205",2020,5,61,236,217,"51.49738251","-0.089446947","Great Dover Street, The Borough",453
"3206",2020,5,62,110,83,"51.4907579","-0.106323685","Cotton Garden Estate, Kennington",193
"3207",2020,5,63,142,117,"51.53089041","-0.089782579","Murray Grove , Hoxton",259
"3208",2020,5,64,395,488,"51.50946212","-0.124749274","William IV Street, Strand",883
"3209",2020,5,65,210,202,NA,NA,NA,412
"3210",2020,5,66,656,1019,"51.51795029","-0.108657431","Holborn Circus, Holborn",1675
"3211",2020,5,67,351,313,"51.51882555","-0.108028472","Hatton Garden, Holborn",664
"3212",2020,5,68,333,335,"51.52059681","-0.116688468","Theobald's Road , Holborn",668
"3213",2020,5,69,191,195,"51.5262363","-0.134407652","Euston Road, Euston",386
"3214",2020,5,70,109,90,"51.53136059","-0.117069978","Calshot Street , King's Cross",199
"3215",2020,5,71,498,569,"51.5154186","-0.098850915","Newgate Street , St. Paul's",1067
"3216",2020,5,72,219,240,"51.52352001","-0.108340165","Farringdon Lane, Clerkenwell",459
"3217",2020,5,73,509,536,"51.52572618","-0.088486188","Old Street Station, St. Luke's",1045
"3218",2020,5,74,491,498,"51.48591714","-0.124469948","Vauxhall Cross, Vauxhall",989
"3219",2020,5,75,242,230,"51.53219984","-0.105480698","Torrens Street, Angel",472
"3220",2020,5,76,128,106,"51.52559505","-0.144083893","Longford Street, The Regent's Park",234
"3221",2020,5,77,251,247,"51.52341837","-0.124121774","Russell Square Station, Bloomsbury",498
"3222",2020,5,78,251,247,"51.52486887","-0.099489485","Sadlers Sports Centre, Finsbury",498
"3223",2020,5,79,128,198,"51.511726","-0.11385596","Arundel Street, Temple",326
"3224",2020,5,80,235,183,"51.50069361","-0.102091246","Webber Street , Southwark",418
"3225",2020,5,81,255,272,"51.52025302","-0.141327271","Great Titchfield Street, Fitzrovia",527
"3226",2020,5,82,139,151,"51.514274","-0.111257","Chancery Lane, Holborn",290
"3227",2020,5,83,257,264,"51.50963938","-0.131510949","Panton Street, West End",521
"3228",2020,5,84,194,193,"51.51593725","-0.111778348","Breams Buildings, Holborn",387
"3229",2020,5,85,324,319,"51.50064702","-0.078600401","Tanner Street, Bermondsey",643
"3230",2020,5,86,166,142,"51.48947903","-0.115156562","Sancroft Street, Vauxhall",308
"3231",2020,5,87,275,280,"51.51646835","-0.079684557","Devonshire Square, Liverpool Street",555
"3232",2020,5,88,338,363,"51.51858757","-0.132053392","Bayley Street , Bloomsbury",701
"3233",2020,5,89,200,197,"51.5262503","-0.123509611","Tavistock Place, Bloomsbury",397
"3234",2020,5,90,77,75,"51.53301907","-0.139174593","Harrington Square 1, Camden Town",152
"3235",2020,5,91,186,153,"51.49368637","-0.111014912","Walnut Tree Walk, Vauxhall",339
"3236",2020,5,92,168,195,"51.49889832","-0.100440521","Borough Road, Elephant & Castle",363
"3237",2020,5,93,211,91,"51.53440868","-0.109025404","Cloudesley Road, Angel",302
"3238",2020,5,94,258,234,"51.49506109","-0.085814489","Bricklayers Arms, Borough",492
"3239",2020,5,95,484,504,"51.5208417","-0.097340162","Aldersgate Street, Barbican",988
"3240",2020,5,96,211,181,"51.53095071","-0.078505384","Falkirk Street, Hoxton",392
"3241",2020,5,97,208,210,"51.49792478","-0.183834706","Gloucester Road (North), Kensington",418
"3242",2020,5,98,284,239,"51.52554222","-0.138231303","Hampstead Road, Euston",523
"3243",2020,5,99,347,349,"51.51457763","-0.158264483","Old Quebec Street, Marylebone",696
"3244",2020,5,100,170,160,"51.49043573","-0.122806861","Albert Embankment, Vauxhall",330
"3245",2020,5,101,647,672,"51.51155322","-0.0929401","Queen Street 1, Bank",1319
"3246",2020,5,102,284,314,"51.51340693","-0.076793375","Jewry Street, Aldgate",598
"3247",2020,5,103,101,89,"51.50472376","-0.192538767","Vicarage Gate, Kensington",190
"3248",2020,5,104,668,717,"51.51159481","-0.077121322","Crosswall, Tower",1385
"3249",2020,5,105,217,201,"51.51552971","-0.190240716","Westbourne Grove, Bayswater",418
"3250",2020,5,106,139,139,"51.51410514","-0.147301667","Woodstock Street, Mayfair",278
"3251",2020,5,107,499,513,"51.52600832","-0.096317627","Finsbury Leisure Centre, St. Luke's",1012
"3252",2020,5,108,112,139,"51.49812559","-0.132102166","Abbey Orchard Street, Westminster",251
"3253",2020,5,109,518,662,"51.51563144","-0.132328837","Soho Square , Soho",1180
"3254",2020,5,110,134,106,"51.53304322","-0.172528678","Wellington Road, St. John's Wood",240
"3255",2020,5,111,251,261,"51.5100172","-0.157275636","Park Lane , Hyde Park",512
"3256",2020,5,112,230,258,"51.51580998","-0.105270275","Stonecutter Street, Holborn",488
"3257",2020,5,113,164,168,"51.49646288","-0.183289032","Gloucester Road (Central), South Kensington",332
"3258",2020,5,114,230,226,"51.52451738","-0.158963647","Park Road (Baker Street), The Regent's Park",456
"3259",2020,5,115,370,414,"51.51423368","-0.073537654","Braham Street, Aldgate",784
"3260",2020,5,116,397,476,"51.51449962","-0.141423695","Little Argyll Street, West End",873
"3261",2020,5,117,248,252,"51.49288067","-0.114934001","Lollard Street, Vauxhall",500
"3262",2020,5,118,167,217,"51.49582705","-0.13547809","Rochester Row, Westminster",384
"3263",2020,5,119,396,406,"51.52589324","-0.090847761","Bath Street, St. Luke's",802
"3264",2020,5,120,187,195,"51.51573534","-0.093080779","The Guildhall, Guildhall",382
"3265",2020,5,121,281,284,"51.51891348","-0.156166631","Baker Street, Marylebone",565
"3266",2020,5,122,230,267,"51.52111369","-0.078869751","Norton Folgate, Liverpool Street",497
"3267",2020,5,123,156,138,"51.52836014","-0.104724625","St. John Street, Finsbury",294
"3268",2020,5,124,92,100,"51.49654462","-0.150905245","Eaton Square, Belgravia",192
"3269",2020,5,125,231,222,"51.50069491","-0.094524319","Borough High Street, The Borough",453
"3270",2020,5,126,368,373,"51.51782144","-0.096496865","Museum of London, Barbican",741
"3271",2020,5,127,205,259,"51.51700801","-0.09388536","Wood Street, Guildhall",464
"3272",2020,5,128,169,170,"51.49536226","-0.185296516","Emperor's Gate, South Kensington",339
"3273",2020,5,129,229,261,"51.5118973","-0.137043852","Golden Square, Soho",490
"3274",2020,5,130,382,446,"51.50950627","-0.075459482","Tower Gardens , Tower",828
"3275",2020,5,131,161,122,"51.53300545","-0.136792671","Eversholt Street , Camden Town",283
"3276",2020,5,132,697,697,"51.52364804","-0.074754872","Bethnal Green Road, Shoreditch",1394
"3277",2020,5,133,415,399,NA,NA,NA,814
"3278",2020,5,134,107,106,"51.504904","-0.06797","Wapping High Street, Wapping",213
"3279",2020,5,135,425,425,"51.52326004","-0.104708922","Clerkenwell Green, Clerkenwell",850
"3280",2020,5,136,321,358,"51.51196176","-0.097441687","Queen Victoria Street, St. Paul's",679
"3281",2020,5,138,225,240,"51.51227622","-0.157436972","Green Street, Mayfair",465
"3282",2020,5,139,158,146,"51.49488108","-0.117974901","Lambeth Road, Vauxhall",304
"3283",2020,5,140,362,406,"51.52096262","-0.085634242","Finsbury Square , Moorgate",768
"3284",2020,5,141,250,275,"51.51530805","-0.147203711","Chapel Place, Marylebone",525
"3285",2020,5,142,149,149,"51.49372451","-0.198286569","West Cromwell Road, Earl's Court",298
"3286",2020,5,143,184,219,"51.4968865","-0.161203828","Pont Street, Knightsbridge",403
"3287",2020,5,144,361,331,"51.48894022","-0.111435796","Kennington Cross, Kennington",692
"3288",2020,5,145,49,34,"51.50074359","-0.202759212","Ilchester Place, Kensington",83
"3289",2020,5,146,96,96,"51.48836528","-0.129361842","Vauxhall Bridge , Pimlico",192
"3290",2020,5,148,261,247,"51.49211134","-0.138364847","Tachbrook Street, Victoria",508
"3291",2020,5,149,166,170,"51.48478899","-0.110683213","Kennington Road Post Office, Oval",336
"3292",2020,5,150,153,211,"51.49705603","-0.168917077","Holy Trinity Brompton, Knightsbridge",364
"3293",2020,5,151,152,91,"51.51213691","-0.201554966","Chepstow Villas, Notting Hill",243
"3294",2020,5,152,207,195,"51.49217002","-0.101536865","Hampton Street, Walworth",402
"3295",2020,5,153,376,372,"51.511933","-0.174411","Bayswater Road, Hyde Park",748
"3296",2020,5,154,1575,1457,"51.50379168","-0.11282408","Waterloo Station 3, Waterloo",3032
"3297",2020,5,155,200,194,"51.49586666","-0.191933711","Lexham Gardens, Kensington",394
"3298",2020,5,156,174,161,"51.49443626","-0.092921165","New Kent Road, The Borough",335
"3299",2020,5,157,256,248,"51.50039792","-0.193068385","Wright's Lane, Kensington",504
"3300",2020,5,158,193,200,"51.49085368","-0.196170309","Trebovir Road, Earl's Court",393
"3301",2020,5,159,402,508,"51.51461995","-0.137841333","Great Marlborough Street, Soho",910
"3302",2020,5,160,223,227,"51.50663341","-0.131773845","Waterloo Place, St. James's",450
"3303",2020,5,162,256,252,"51.51760685","-0.121328408","Southampton Place, Holborn",508
"3304",2020,5,163,300,332,"51.4931848","-0.167894973","Sloane Avenue, Knightsbridge",632
"3305",2020,5,164,163,125,"51.515607","-0.183118788","Cleveland Gardens, Bayswater",288
"3306",2020,5,165,78,55,"51.517932","-0.183716959","Orsett Terrace, Bayswater",133
"3307",2020,5,166,144,174,"51.50185512","-0.159237081","Seville Street, Knightsbridge",318
"3308",2020,5,167,453,461,"51.49395092","-0.147624377","Eccleston Place, Victoria",914
"3309",2020,5,168,110,97,"51.50040123","-0.195455928","Argyll Road, Kensington",207
"3310",2020,5,169,266,250,"51.51474612","-0.165164288","Porchester Place, Paddington",516
"3311",2020,5,170,159,94,"51.52784273","-0.108068155","Hardwick Street, Clerkenwell",253
"3312",2020,5,171,144,147,"51.4916156","-0.186753859","Collingham Gardens, Earl's Court",291
"3313",2020,5,172,145,157,"51.49121192","-0.173715911","Sumner Place, South Kensington",302
"3314",2020,5,173,209,213,"51.50486","-0.113001","Waterloo Road, South Bank",422
"3315",2020,5,174,265,289,"51.512529","-0.115163","Strand, Strand",554
"3316",2020,5,175,334,344,"51.521668","-0.079608554","Worship Street, Shoreditch",678
"3317",2020,5,176,169,150,"51.51791921","-0.188098863","Gloucester Terrace, Bayswater",319
"3318",2020,5,177,371,419,"51.49616092","-0.140947636","Ashley Place, Victoria",790
"3319",2020,5,178,225,173,"51.48985626","-0.141923621","Warwick Square, Pimlico",398
"3320",2020,5,180,205,213,"51.5129118","-0.153645496","North Audley Street, Mayfair",418
"3321",2020,5,181,122,109,"51.49941247","-0.152317537","Belgrave Square, Belgravia",231
"3322",2020,5,182,183,191,"51.52202903","-0.165842551","Bell Street , Marylebone",374
"3323",2020,5,183,278,278,"51.482362","-0.13612398","Riverlight North, Nine Elms",556
"3324",2020,5,184,184,185,"51.52071513","-0.14521173","Portland Place, Marylebone",369
"3325",2020,5,185,249,227,"51.48805753","-0.140741432","Alderney Street, Pimlico",476
"3326",2020,5,186,620,533,"51.51733558","-0.175810943","South Wharf Road, Paddington",1153
"3327",2020,5,187,201,201,"51.49247977","-0.178433004","Queen's Gate (South), South Kensington",402
"3328",2020,5,188,107,81,"51.5165179","-0.164393768","Nutford Place, Marylebone",188
"3329",2020,5,189,183,103,"51.53166681","-0.109914711","Claremont Square, Angel",286
"3330",2020,5,190,285,266,"51.48997562","-0.132845681","Rampayne Street, Pimlico",551
"3331",2020,5,191,824,797,"51.50311799","-0.153520935","Hyde Park Corner, Hyde Park",1621
"3332",2020,5,192,365,372,"51.51251523","-0.133201961","Wardour Street, Soho",737
"3333",2020,5,193,380,472,"51.50581776","-0.100186337","Bankside Mix, Bankside",852
"3334",2020,5,194,730,1098,"51.50462759","-0.091773776","Hop Exchange, The Borough",1828
"3335",2020,5,195,307,309,"51.50724437","-0.106237501","Milroy Walk, South Bank",616
"3336",2020,5,196,255,252,"51.50368837","-0.098497684","Union Street, The Borough",507
"3337",2020,5,197,301,320,"51.50556905","-0.111606696","Stamford Street, South Bank",621
"3338",2020,5,199,558,653,"51.51048489","-0.082989638","Great Tower Street, Monument",1211
"3339",2020,5,200,278,256,"51.51492456","-0.066078037","LMU Commercial Road, Whitechapel",534
"3340",2020,5,201,277,299,"51.5225965","-0.161113413","Dorset Square, Marylebone",576
"3341",2020,5,202,470,465,"51.51236389","-0.06954201","Leman Street, Aldgate",935
"3342",2020,5,203,351,382,"51.51821864","-0.100791005","West Smithfield Rotunda, Farringdon",733
"3343",2020,5,204,223,198,"51.52659961","-0.112432615","Margery Street, Clerkenwell",421
"3344",2020,5,206,292,275,"51.518154","-0.062697","New Road 1 , Whitechapel",567
"3345",2020,5,207,76,78,"51.50135267","-0.153194766","Grosvenor Crescent, Belgravia",154
"3346",2020,5,208,73,56,"51.52505151","-0.166304359","Mallory Street, Marylebone",129
"3347",2020,5,209,98,89,"51.49358391","-0.165101392","Denyer Street, Knightsbridge",187
"3348",2020,5,210,337,375,"51.51681444","-0.151926305","Hinde Street, Marylebone",712
"3349",2020,5,211,120,160,"51.49464523","-0.158105512","Cadogan Place, Knightsbridge",280
"3350",2020,5,212,93,67,"51.50658458","-0.199004026","Campden Hill Road, Notting Hill",160
"3351",2020,5,213,648,673,"51.50274025","-0.149569201","Wellington Arch, Hyde Park",1321
"3352",2020,5,214,440,413,"51.52683806","-0.130504336","Endsleigh Gardens, Euston",853
"3353",2020,5,215,512,590,"51.51906932","-0.088285377","Moorfields, Moorgate",1102
"3354",2020,5,216,204,207,"51.49094565","-0.181190899","Old Brompton Road, South Kensington",411
"3355",2020,5,217,845,861,"51.51615461","-0.082422399","Wormwood Street, Liverpool Street",1706
"3356",2020,5,218,187,180,"51.48971651","-0.170194408","St. Luke's Church, Chelsea",367
"3357",2020,5,219,220,217,"51.49016361","-0.19039362","Bramham Gardens, Earl's Court",437
"3358",2020,5,220,114,107,"51.49066456","-0.166485083","Chelsea Green, Chelsea",221
"3359",2020,5,221,263,276,"51.49481649","-0.13045856","Horseferry Road, Westminster",539
"3360",2020,5,222,93,73,"51.50275704","-0.155349725","Knightsbridge, Hyde Park",166
"3361",2020,5,223,181,162,"51.49148474","-0.090220911","Rodney Road , Walworth",343
"3362",2020,5,224,183,177,"51.51031","-0.18740235","Queensway, Kensington Gardens",360
"3363",2020,5,225,412,286,"51.50935342","-0.196422","Notting Hill Gate Station, Notting Hill",698
"3364",2020,5,226,206,216,"51.50844614","-0.131961389","Charles II Street, West End",422
"3365",2020,5,227,223,215,"51.52891573","-0.115480888","Great Percy Street, Clerkenwell",438
"3366",2020,5,228,428,648,"51.50742485","-0.134621209","St. James's Square, St. James's",1076
"3367",2020,5,229,497,543,"51.50654321","-0.123179697","Whitehall Place, Strand",1040
"3368",2020,5,230,175,220,"51.50669284","-0.103137426","Poured Lines, Bankside",395
"3369",2020,5,231,261,279,"51.49396755","-0.17873226","Queen's Gate (Central), South Kensington",540
"3370",2020,5,232,102,113,"51.51501025","-0.112753217","Carey Street, Holborn",215
"3371",2020,5,233,309,354,"51.50777049","-0.130699733","Pall Mall East, West End",663
"3372",2020,5,234,263,261,"51.53450449","-0.106992706","Liverpool Road (N1 Centre), Angel",524
"3373",2020,5,235,177,137,"51.49571828","-0.110889274","Kennington Road  , Vauxhall",314
"3374",2020,5,236,162,173,"51.51838043","-0.073438925","Fashion Street, Whitechapel",335
"3375",2020,5,237,250,260,"51.5097860151","-0.0681619805156","Dock Street, Wapping",510
"3376",2020,5,238,89,72,"51.5233534","-0.175116099","Frampton Street, Paddington",161
"3377",2020,5,239,362,327,"51.52443845","-0.138019439","Warren Street Station, Euston",689
"3378",2020,5,240,98,101,"51.50545935","-0.10569204","Colombo Street, Southwark",199
"3379",2020,5,242,201,193,"51.52200801","-0.151359288","Beaumont Street, Marylebone",394
"3380",2020,5,243,281,244,"51.49096258","-0.139625122","Gloucester Street, Pimlico",525
"3381",2020,5,244,264,272,"51.51611887","-0.128585022","Earnshaw Street , Covent Garden",536
"3382",2020,5,245,113,94,"51.4853572","-0.142207481","Grosvenor Road, Pimlico",207
"3383",2020,5,246,408,431,"51.52285301","-0.099994052","Berry Street, Clerkenwell",839
"3384",2020,5,247,91,91,"51.530529","-0.167515","St. John's Wood Church, The Regent's Park",182
"3385",2020,5,248,369,361,"51.50645179","-0.170279555","Triangle Car Park, Hyde Park",730
"3386",2020,5,249,121,121,"51.49859784","-0.096191134","Harper Road, The Borough",242
"3387",2020,5,250,103,103,"51.489932","-0.162727","Royal Avenue 1, Chelsea",206
"3388",2020,5,251,628,791,"51.518908","-0.079249","Brushfield Street, Liverpool Street",1419
"3389",2020,5,252,375,421,"51.5046364","-0.116542278","Jubilee Gardens, South Bank",796
"3390",2020,5,253,306,247,"51.53404294","-0.086379717","Shoreditch Park, Hoxton",553
"3391",2020,5,254,267,230,"51.53051587","-0.106408455","Chadwell Street, Angel",497
"3392",2020,5,255,185,150,"51.52557531","-0.179592915","Clifton Road, Maida Vale",335
"3393",2020,5,256,151,158,"51.51362054","-0.116764211","Houghton Street, Strand",309
"3394",2020,5,257,131,135,"51.52248185","-0.154907218","Westminster University, Marylebone",266
"3395",2020,5,258,158,149,NA,NA,NA,307
"3396",2020,5,259,159,160,"51.490959","-0.1532331","Bourne Street, Belgravia",319
"3397",2020,5,260,230,235,"51.5136846","-0.135580879","Broadwick Street, Soho",465
"3398",2020,5,261,115,77,"51.5134891","-0.191351186","Princes Square, Bayswater",192
"3399",2020,5,262,214,178,"51.49874469","-0.103132904","LSBU (Borough Road), Elephant & Castle",392
"3400",2020,5,263,228,255,"51.51422502","-0.080660083","St. Mary Axe, Aldgate",483
"3401",2020,5,264,320,313,"51.52644342","-0.109256828","Tysoe Street, Clerkenwell",633
"3402",2020,5,265,214,186,"51.51595344","-0.169249375","Southwick Street, Paddington",400
"3403",2020,5,266,287,312,"51.50102668","-0.180246101","Queen's Gate (North), Kensington",599
"3404",2020,5,267,194,177,"51.49206037","-0.132224622","Regency Street, Westminster",371
"3405",2020,5,268,316,327,"51.49320445","-0.144132875","Belgrave Road, Victoria",643
"3406",2020,5,269,218,205,"51.50082346","-0.089740764","Empire Square, The Borough",423
"3407",2020,5,270,546,561,"51.4863434","-0.122492418","Kennington Lane Rail Bridge, Vauxhall",1107
"3408",2020,5,271,80,81,"51.53583617","-0.156285395","London Zoo,  The Regent's Park",161
"3409",2020,5,272,498,519,"51.50144456","-0.110699309","Baylis Road, Waterloo",1017
"3410",2020,5,273,239,318,"51.50613324","-0.114686385","Belvedere Road 1, South Bank",557
"3411",2020,5,274,147,158,"51.49671237","-0.20528437","Warwick Road, Olympia",305
"3412",2020,5,275,214,243,"51.52004497","-0.092176447","Barbican Centre, Barbican",457
"3413",2020,5,276,150,166,"51.50930161","-0.084985356","Lower Thames Street, Monument",316
"3414",2020,5,277,212,208,"51.50315739","-0.191496313","Kensington Church Street, Kensington",420
"3415",2020,5,278,637,645,"51.5034938","-0.07962099","Tooley Street, Bermondsey",1282
"3416",2020,5,279,283,249,"51.51862243","-0.176645823","North Wharf Road, Paddington",532
"3417",2020,5,280,208,203,"51.490083","-0.162418","Royal Avenue 2, Chelsea",411
"3418",2020,5,281,213,239,"51.49580589","-0.127575233","Smith Square, Westminster",452
"3419",2020,5,282,440,451,"51.51906446","-0.059642081","Royal London Hospital, Whitechapel",891
"3420",2020,5,283,68,76,"51.51440928","-0.118478757","Kingsway, Covent Garden",144
"3421",2020,5,284,171,152,"51.49914063","-0.112031483","Lambeth North Station, Waterloo",323
"3422",2020,5,286,114,83,"51.5272947","-0.174653609","St. John's Wood Road, St. John's Wood",197
"3423",2020,5,287,181,179,"51.52367314","-0.128377673","Bedford Way, Bloomsbury",360
"3424",2020,5,288,309,342,"51.49236962","-0.147478734","Elizabeth Bridge, Victoria",651
"3425",2020,5,289,59,59,"51.50923022","-0.151296092","South Audley Street, Mayfair",118
"3426",2020,5,290,211,171,"51.518268","-0.17110323","St Mary's Hospital, Paddington",382
"3427",2020,5,291,185,154,"51.48483991","-0.138089062","Claverton Street, Pimlico",339
"3428",2020,5,292,201,226,"51.49888404","-0.165471605","Montpelier Street, Knightsbridge",427
"3429",2020,5,293,145,119,"51.49815779","-0.209494128","Kensington Olympia Station, Olympia",264
"3430",2020,5,294,271,234,"51.488226","-0.135635511","St. George's Square, Pimlico",505
"3431",2020,5,295,224,204,"51.50029631","-0.092762704","Swan Street, The Borough",428
"3432",2020,5,296,147,136,"51.49363156","-0.190603326","Knaresborough Place, Earl's Court",283
"3433",2020,5,297,40,34,"51.49612799","-0.106000855","Geraldine Street, Elephant & Castle",74
"3434",2020,5,298,388,390,"51.50227992","-0.074189225","Curlew Street, Shad Thames",778
"3435",2020,5,299,111,122,"51.49398524","-0.136928582","Vincent Square, Westminster",233
"3436",2020,5,300,361,342,"51.505014","-0.17306032","Serpentine Car Park, Hyde Park",703
"3437",2020,5,301,259,270,"51.51475963","-0.148105415","Marylebone Lane, Marylebone",529
"3438",2020,5,302,143,143,"51.466907","-0.216573","Putney Pier, Wandsworth",286
"3439",2020,5,303,549,551,"51.50295379","-0.158456089","Albert Gate, Hyde Park",1100
"3440",2020,5,306,199,196,"51.51816295","-0.135025698","Rathbone Street, Fitzrovia",395
"3441",2020,5,307,445,444,"51.50990837","-0.187842717","Black Lion Gate, Kensington Gardens",889
"3442",2020,5,308,185,191,"51.49907558","-0.085666316","Long Lane , Bermondsey",376
"3443",2020,5,309,179,168,"51.50963123","-0.119047563","Embankment (Savoy), Strand",347
"3444",2020,5,310,223,214,"51.4908679","-0.116911864","Black Prince Road, Vauxhall",437
"3445",2020,5,311,230,229,"51.51918144","-0.140485596","Foley Street, Fitzrovia",459
"3446",2020,5,312,167,154,"51.53088935","-0.176770502","Grove End Road, St. John's Wood",321
"3447",2020,5,313,280,339,"51.51734403","-0.138072691","Wells Street, Fitzrovia",619
"3448",2020,5,314,203,215,"51.50088934","-0.083159352","Tyers Gate, Bermondsey",418
"3449",2020,5,315,133,144,"51.52536703","-0.153463612","The Tennis Courts, The Regent's Park",277
"3450",2020,5,316,160,186,NA,NA,NA,346
"3451",2020,5,317,90,74,"51.49679128","-0.093913472","Dickens Square, Borough",164
"3452",2020,5,318,189,283,"51.51004801","-0.138846453","Sackville Street, Mayfair",472
"3453",2020,5,319,253,271,"51.52702563","-0.088542771","Baldwin Street, St. Luke's",524
"3454",2020,5,320,361,354,"51.49357351","-0.139956043","Queen Mother Sports Centre, Victoria",715
"3455",2020,5,321,369,360,"51.49785559","-0.081608045","Bermondsey Street, Bermondsey",729
"3456",2020,5,322,116,114,"51.526293","-0.073955","Palissy Street, Shoreditch",230
"3457",2020,5,323,166,200,"51.523196","-0.083067","Clifton Street, Shoreditch",366
"3458",2020,5,324,271,267,"51.49652013","-0.101384068","Ontario Street, Elephant & Castle",538
"3459",2020,5,325,159,195,"51.50908747","-0.129697889","St. Martin's Street, West End",354
"3460",2020,5,326,390,308,"51.53266186","-0.099981142","Graham Street, Angel",698
"3461",2020,5,327,71,56,"51.53095","-0.085603","New North Road 1, Hoxton",127
"3462",2020,5,328,88,77,"51.53114","-0.086016","New North Road 2, Hoxton",165
"3463",2020,5,329,161,128,"51.53589283","-0.160854428","Prince Albert Road, The Regent's Park",289
"3464",2020,5,330,333,277,"51.51641749","-0.179135079","Eastbourne Mews, Paddington",610
"3465",2020,5,331,379,419,"51.52085887","-0.089887855","Bunhill Row, Moorgate",798
"3466",2020,5,332,107,77,"51.49334336","-0.194757949","Nevern Place, Earl's Court",184
"3467",2020,5,333,222,131,"51.50860544","-0.193764092","Palace Gardens Terrace, Notting Hill",353
"3468",2020,5,334,200,179,"51.505044","-0.115851","Concert Hall Approach 1, South Bank",379
"3469",2020,5,335,258,370,"51.51196803","-0.120718759","Tavistock Street, Covent Garden",628
"3470",2020,5,336,101,202,"51.504942","-0.115533","Concert Hall Approach 2, South Bank",303
"3471",2020,5,337,127,92,"51.51108452","-0.197524944","Pembridge Villas, Notting Hill",219
"3472",2020,5,338,430,486,"51.51175646","-0.119643424","Wellington Street , Strand",916
"3473",2020,5,339,117,67,"51.5333196","-0.1117812","Risinghill Street, Angel",184
"3474",2020,5,340,488,557,"51.51444134","-0.087587447","Bank of England Museum, Bank",1045
"3475",2020,5,341,648,618,"51.50810309","-0.12602103","Craven Street, Strand",1266
"3476",2020,5,343,118,115,"51.53692216","-0.150181444","London Zoo Car Park, The Regent's Park",233
"3477",2020,5,344,163,145,"51.528246","-0.10102611","Goswell Road (City Uni), Finsbury",308
"3478",2020,5,345,344,360,"51.48802358","-0.166878535","Flood Street, Chelsea",704
"3479",2020,5,347,206,212,"51.50013942","-0.113936001","Lower Marsh, Waterloo",418
"3480",2020,5,348,188,243,"51.51217033","-0.150481272","Grosvenor Square, Mayfair",431
"3481",2020,5,349,177,230,"51.51196","-0.142783033","St. George Street, Mayfair",407
"3482",2020,5,350,339,309,"51.5017154373867","-0.1798541843891","Queen's Gate, Kensington Gardens",648
"3483",2020,5,351,247,183,"51.529423","-0.097122","Macclesfield Rd, St Lukes",430
"3484",2020,5,352,144,137,"51.486965","-0.116625","Vauxhall Street, Vauxhall",281
"3485",2020,5,353,101,110,"51.49459148","-0.134234258","Greycoat Street , Westminster",211
"3486",2020,5,354,256,365,"51.506767","-0.123702","Northumberland Avenue, Strand",621
"3487",2020,5,355,70,71,NA,NA,NA,141
"3488",2020,5,356,440,436,"51.494412","-0.173881","South Kensington Station, South Kensington",876
"3489",2020,5,357,332,380,"51.520994","-0.139016","Howland Street, Fitzrovia",712
"3490",2020,5,358,253,264,"51.516226","-0.124826","High Holborn , Covent Garden",517
"3491",2020,5,359,133,191,"51.49782999","-0.135440826","Butler Place, Westminster",324
"3492",2020,5,360,344,446,"51.49675303","-0.138733562","Howick Place, Westminster",790
"3493",2020,5,361,751,431,"51.50391973","-0.11342629","Waterloo Station 2, Waterloo",1182
"3494",2020,5,362,231,176,"51.536264","-0.133952","Royal College Street, Camden Town",407
"3495",2020,5,363,38,32,"51.5291212008901","-0.171185284853","Lord's, St. John's Wood",70
"3496",2020,5,364,277,298,"51.519656","-0.132339","Alfred Place, Bloomsbury",575
"3497",2020,5,365,235,188,"51.530344","-0.100168","City Road, Angel",423
"3498",2020,5,366,112,133,"51.5109192966489","-0.1511263847351","Millennium Hotel, Mayfair",245
"3499",2020,5,367,130,113,"51.5173721","-0.1642075","Harrowby Street, Marylebone",243
"3500",2020,5,368,205,218,"51.50024195","-0.15934065","Harriet Street, Knightsbridge",423
"3501",2020,5,370,57,60,"51.520205","-0.174593","Paddington Green, Paddington",117
"3502",2020,5,371,113,112,"51.49775","-0.10988","King Edward Walk, Waterloo",225
"3503",2020,5,372,214,226,"51.515208","-0.117863","Sardinia Street, Holborn",440
"3504",2020,5,373,141,158,"51.49980661","-0.176415994","Prince Consort Road, Knightsbridge",299
"3505",2020,5,374,1351,1250,"51.50402794","-0.11386436","Waterloo Station 1, Waterloo",2601
"3506",2020,5,375,130,119,"51.50194596","-0.194392952","Kensington Town Hall, Kensington",249
"3507",2020,5,376,264,327,"51.49188409","-0.125674815","Millbank Tower, Pimlico",591
"3508",2020,5,377,147,165,"51.50535447","-0.113656543","Waterloo Bridge, South Bank",312
"3509",2020,5,378,136,169,"51.49559291","-0.179077626","Natural History Museum, South Kensington",305
"3510",2020,5,379,186,179,"51.51431171","-0.200838199","Turquoise Island, Notting Hill",365
"3511",2020,5,380,103,117,"51.50686435","-0.150666888","Stanhope Gate, Mayfair",220
"3512",2020,5,381,217,229,"51.51953043","-0.13577731","Charlotte Street, Fitzrovia",446
"3513",2020,5,382,102,115,"51.50935171","-0.14744969","Farm Street, Mayfair",217
"3514",2020,5,383,187,223,"51.51310333","-0.13121385","Frith Street, Soho",410
"3515",2020,5,384,113,108,"51.496481","-0.192404","Marloes Road, Kensington",221
"3516",2020,5,386,396,437,"51.51352755","-0.130110822","Moor Street, Soho",833
"3517",2020,5,387,236,222,"51.49369988","-0.121394101","Fire Brigade Pier, Vauxhall",458
"3518",2020,5,388,227,287,"51.51070161","-0.121723604","Southampton Street, Strand",514
"3519",2020,5,389,42,34,"51.51013066","-0.155757901","Upper Grosvenor Street, Mayfair",76
"3520",2020,5,390,83,84,"51.521776","-0.068856","Buxton Street 1, Shoreditch",167
"3521",2020,5,392,351,437,"51.49942855","-0.179702476","Imperial College, Knightsbridge",788
"3522",2020,5,393,363,375,"51.51733427","-0.103604248","Snow Hill, Farringdon",738
"3523",2020,5,394,131,76,"51.524826","-0.176268","Aberdeen Place, St. John's Wood",207
"3524",2020,5,395,250,265,"51.492462","-0.159919","Cadogan Gardens, Chelsea",515
"3525",2020,5,396,146,143,"51.51809","-0.163609","Shouldham Street, Marylebone",289
"3526",2020,5,397,271,225,"51.51348","-0.17977","Devonshire Terrace, Bayswater",496
"3527",2020,5,398,79,49,"51.502319","-0.200742","Holland Park, Kensington",128
"3528",2020,5,399,246,253,"51.52261762","-0.071653961","Brick Lane Market, Shoreditch",499
"3529",2020,5,401,273,246,"51.528187","-0.075375","Columbia Road, Shoreditch",519
"3530",2020,5,402,122,114,"51.52289229","-0.171681991","Penfold Street, Marylebone",236
"3531",2020,5,403,205,206,"51.51689296","-0.158249929","George Place Mews, Marylebone",411
"3532",2020,5,404,255,258,"51.50204238","-0.184400221","Palace Gate, Kensington Gardens",513
"3533",2020,5,405,385,382,"51.49418566","-0.18267094","Gloucester Road Station, South Kensington",767
"3534",2020,5,408,73,54,NA,NA,NA,127
"3535",2020,5,409,229,211,"51.493146","-0.099828","Strata, Elephant & Castle",440
"3536",2020,5,410,118,97,"51.519968","-0.169774","Edgware Road Station, Marylebone",215
"3537",2020,5,411,291,291,"51.49337264","-0.09968067","Walworth Road, Elephant & Castle",582
"3538",2020,5,412,119,102,"51.488105","-0.110121","Cleaver Street, Kennington",221
"3539",2020,5,419,157,153,"51.485821","-0.149004","Chelsea Bridge, Pimlico",310
"3540",2020,5,420,153,114,"51.504043","-0.105312","Southwark Station 1, Southwark",267
"3541",2020,5,421,319,316,"51.504044","-0.104778","Southwark Station 2, Southwark",635
"3542",2020,5,423,104,143,"51.49456127","-0.15393398","Eaton Square (South), Belgravia",247
"3543",2020,5,424,174,149,"51.490491","-0.149186","Ebury Bridge, Pimlico",323
"3544",2020,5,425,180,171,"51.533379","-0.139159","Harrington Square 2, Camden Town",351
"3545",2020,5,426,149,158,"51.493072","-0.129925","Vincent Street, Pimlico",307
"3546",2020,5,427,655,690,"51.51397065","-0.09294031","Cheapside, Bank",1345
"3547",2020,5,428,434,592,"51.499917","-0.174554","Exhibition Road, Knightsbridge",1026
"3548",2020,5,430,100,100,"51.48902","-0.17524","South Parade, Chelsea",200
"3549",2020,5,431,84,96,"51.534474","-0.122203","Crinan Street, King's Cross",180
"3550",2020,5,432,289,338,"51.496957","-0.173894","Exhibition Road Museums, South Kensington",627
"3551",2020,5,433,375,363,"51.524564","-0.116279","Wren Street, Holborn",738
"3552",2020,5,435,175,192,"51.488852","-0.105593","Kennington Station, Kennington",367
"3553",2020,5,436,445,413,"51.51824","-0.11655","Red Lion Street, Holborn",858
"3554",2020,5,437,172,158,"51.488124","-0.120903","Vauxhall Walk, Vauxhall",330
"3555",2020,5,439,104,77,"51.5338","-0.118677","Killick Street, King's Cross",181
"3556",2020,5,440,142,117,"51.483145","-0.113134","Kennington Oval, Oval",259
"3557",2020,5,441,189,176,"51.495656","-0.114605","Sail Street, Vauxhall",365
"3558",2020,5,442,73,79,"51.510101","-0.211358","Walmer Road, Avondale",152
"3559",2020,5,443,217,184,"51.515256","-0.058641","Philpot Street, Whitechapel",401
"3560",2020,5,444,193,191,"51.52568","-0.055312","Bethnal Green Garden, Bethnal Green",384
"3561",2020,5,445,127,129,"51.52388","-0.065076","Cheshire Street, Bethnal Green",256
"3562",2020,5,446,264,229,"51.528936","-0.055894","York Hall, Bethnal Green",493
"3563",2020,5,447,31,22,"51.493381","-0.007542","Jubilee Crescent, Cubitt Town",53
"3564",2020,5,448,111,116,"51.50623","-0.02296","Fisherman's Walk West, Canary Wharf",227
"3565",2020,5,449,261,252,"51.511088","-0.057159","Shadwell Station, Shadwell",513
"3566",2020,5,450,170,120,"51.515975","-0.053177","Jubilee Street, Stepney",290
"3567",2020,5,451,195,164,"51.504719","-0.063531","Hermitage Court, Wapping",359
"3568",2020,5,452,155,153,"51.505697","-0.070542","St. Katharine's Way, Tower",308
"3569",2020,5,453,181,157,"51.508447","-0.055167","Garnet Street, Shadwell",338
"3570",2020,5,454,55,48,"51.487679","-0.021582","Napier Avenue, Millwall",103
"3571",2020,5,455,60,63,"51.49447","-0.014409","East Ferry Road, Cubitt Town",123
"3572",2020,5,456,132,143,"51.538071","-0.144664","Parkway, Camden Town",275
"3573",2020,5,457,243,191,"51.542138","-0.145393","Castlehaven Road, Camden Town",434
"3574",2020,5,458,182,179,"51.504749","-0.057544","Wapping Lane, Wapping",361
"3575",2020,5,459,199,185,"51.535179","-0.03338","Gunmakers Lane, Old Ford",384
"3576",2020,5,460,162,160,"51.516196","-0.029138","Burdett Road, Mile End",322
"3577",2020,5,461,101,83,"51.516","-0.038775","Aston Street, Stepney",184
"3578",2020,5,462,280,257,"51.541603","-0.138853","Bonny Street, Camden Town",537
"3579",2020,5,463,123,86,"51.534776","-0.071881","Thurtle Road, Haggerston",209
"3580",2020,5,464,53,41,"51.51417","-0.052099","St. Mary & St. Michael Church, Stepney",94
"3581",2020,5,465,293,268,"51.53558","-0.08249","Pitfield Street North,Hoxton",561
"3582",2020,5,466,185,137,"51.534464","-0.076341","Whiston Road, Haggerston",322
"3583",2020,5,467,81,65,"51.523538","-0.030556","Southern Grove, Bow",146
"3584",2020,5,468,43,52,"51.521564","-0.022694","Cantrell Road, Bow",95
"3585",2020,5,469,138,132,"51.513757","-0.020467","Lindfield Street, Poplar",270
"3586",2020,5,470,152,125,"51.530535","-0.025492","Mostyn Grove, Bow",277
"3587",2020,5,471,160,166,"51.533283","-0.028155","Hewison Street, Old Ford",326
"3588",2020,5,472,23,24,"51.529452","-0.027616","Malmesbury Road, Bow",47
"3589",2020,5,473,49,54,"51.496137","-0.019355","Millharbour, Millwall",103
"3590",2020,5,475,1,2,"51.499041","-0.020157","Lightermans Road, Millwall",3
"3591",2020,5,476,15,27,"51.489096","-0.009205","Stebondale Street, Cubitt Town",42
"3592",2020,5,477,53,54,"51.49109","-0.018716","Spindrift Avenue, Millwall",107
"3593",2020,5,478,300,300,"51.521889","-0.04667","Stepney Green Station, Stepney",600
"3594",2020,5,479,239,242,"51.527152","-0.058005","Pott Street, Bethnal Green",481
"3595",2020,5,480,358,322,"51.5128711","-0.0389866","Flamborough Street, Limehouse",680
"3596",2020,5,481,106,132,"51.487129","-0.009001","Saunders Ness Road, Cubitt Town",238
"3597",2020,5,483,162,142,"51.51328","-0.047784","Albert Gardens, Stepney",304
"3598",2020,5,484,96,85,"51.528828","-0.013258","Bromley High Street, Bow",181
"3599",2020,5,485,198,164,"51.531127","-0.048017","Old Ford Road, Bethnal Green",362
"3600",2020,5,486,298,268,"51.525645","-0.069543","Granby Street, Shoreditch",566
"3601",2020,5,488,205,187,"51.506946","-0.058681","Reardon Street, Wapping",392
"3602",2020,5,489,273,229,"51.513074","-0.064094","Christian Street, Whitechapel",502
"3603",2020,5,490,82,92,"51.508622","-0.065006","Pennington Street, Wapping",174
"3604",2020,5,491,285,267,"51.522507","-0.041378","Queen Mary's, Mile End",552
"3605",2020,5,492,254,258,"51.525501","-0.032267204","Maplin Street, Mile End",512
"3606",2020,5,494,6,26,"51.50196","-0.016251","South Quay East, Canary Wharf",32
"3607",2020,5,495,169,157,"51.528169","-0.018703","Bow Church Station, Bow",326
"3608",2020,5,496,72,73,"51.52512","-0.015578","Devons Road, Bow",145
"3609",2020,5,497,81,81,"51.526149","-0.027396845","Merchant Street, Bow",162
"3610",2020,5,498,156,146,"51.527058","-0.025296","Bow Road Station, Bow",302
"3611",2020,5,499,212,201,"51.519265","-0.021345","Furze Green, Bow",413
"3612",2020,5,500,293,258,"51.519806","-0.055731","Ansell House, Stepney",551
"3613",2020,5,501,133,130,"51.522561","-0.054883","Cephas Street, Bethnal Green",263
"3614",2020,5,502,151,134,"51.53341","-0.049591815","Bonner Gate, Victoria Park",285
"3615",2020,5,503,372,358,"51.520893","-0.051394","Cleveland Way, Stepney",730
"3616",2020,5,504,21,16,"51.496454","-0.009506","St. John's Park, Cubitt Town",37
"3617",2020,5,505,139,126,"51.520398","-0.026768","Ackroyd Drive, Bow",265
"3618",2020,5,506,200,219,"51.517475","-0.075855","Bell Lane, Liverpool Street",419
"3619",2020,5,507,110,97,"51.528692","-0.059091","Clarkson Street, Bethnal Green",207
"3620",2020,5,508,335,337,"51.519362","-0.074431","Fournier Street, Whitechapel",672
"3621",2020,5,509,189,195,"51.517842","-0.090075","Fore Street, Guildhall",384
"3622",2020,5,510,219,260,"51.509303","-0.025996","Westferry DLR, Limehouse",479
"3623",2020,5,511,229,212,"51.511066","-0.053558","Sutton Street, Shadwell",441
"3624",2020,5,512,389,342,"51.532091","-0.06142","Pritchard's Road, Bethnal Green",731
"3625",2020,5,513,132,134,"51.5142228","-0.055656","Watney Market, Stepney",266
"3626",2020,5,514,175,182,"51.516204","-0.155525","Portman Square, Marylebone",357
"3627",2020,5,515,86,85,"51.500088","-0.211316","Russell Gardens, Olympia",171
"3628",2020,5,516,101,101,"51.5112","-0.014438","Chrisp Street Market, Poplar",202
"3629",2020,5,517,161,133,"51.532513","-0.033085","Ford Road, Old Ford",294
"3630",2020,5,518,176,175,"51.528224","-0.037471","Antill Road, Mile End",351
"3631",2020,5,519,17,15,"51.518811","-0.011662","Teviot Street, Poplar",32
"3632",2020,5,520,196,156,"51.526041","-0.047218","Bancroft Road, Bethnal Green",352
"3633",2020,5,521,184,161,"51.534137","-0.037366","Driffield Road, Old Ford",345
"3634",2020,5,522,270,277,"51.525941","-0.036017","Clinton Road, Mile End",547
"3635",2020,5,523,31,31,"51.51549","-0.013475","Langdon Park, Poplar",62
"3636",2020,5,524,226,150,"51.511654","-0.179668","Lancaster Gate , Bayswater",376
"3637",2020,5,526,69,75,"51.503143","-0.008428","Lancaster Drive, Blackwall",144
"3638",2020,5,527,115,124,"51.503802","-0.215808","Hansard Mews, Holland Park",239
"3639",2020,5,528,67,100,"51.507326","-0.145827","Clarges Street, Mayfair",167
"3640",2020,5,529,157,158,"51.486892","-0.170983","Manresa Road, Chelsea",315
"3641",2020,5,530,63,54,"51.508896","-0.012413","Newby Place, Poplar",117
"3642",2020,5,531,241,203,"51.530326","-0.042744","Twig Folly Bridge, Mile End",444
"3643",2020,5,532,120,143,"51.50357","-0.020068","Jubilee Plaza, Canary Wharf",263
"3644",2020,5,533,197,185,"51.528222","-0.069743","Wellington Row, Bethnal Green",382
"3645",2020,5,534,273,220,"51.531864","-0.066035","Goldsmith's Row, Haggerston",493
"3646",2020,5,535,192,163,"51.537349","-0.147154","Gloucester Avenue, Camden Town",355
"3647",2020,5,536,91,72,"51.53385","-0.06992","Queensbridge Road, Haggerston",163
"3648",2020,5,537,239,213,"51.51793","-0.067937","Old Montague Street, Whitechapel",452
"3649",2020,5,538,75,82,"51.508981","-0.00699","Naval Row, Blackwall",157
"3650",2020,5,540,198,141,"51.528302","-0.144466","Albany Street, The Regent's Park",339
"3651",2020,5,541,422,422,"51.506613","-0.142844","Green Park Station, Mayfair",844
"3652",2020,5,542,155,156,"51.514115","-0.033828","Salmon Lane, Limehouse",311
"3653",2020,5,543,39,24,"51.509591","-0.204666","Lansdowne Walk, Ladbroke Grove",63
"3654",2020,5,544,166,157,"51.526153","-0.102208","Percival Street, Finsbury",323
"3655",2020,5,545,145,124,"51.539957","-0.145246","Arlington Road, Camden Town",269
"3656",2020,5,546,321,330,"51.517428","-0.107987","New Fetter Lane, Holborn",651
"3657",2020,5,547,54,56,"51.509474","-0.002275","East India DLR, Blackwall",110
"3658",2020,5,548,92,80,"51.498386","-0.107913","Westminster Bridge Road, Elephant & Castle",172
"3659",2020,5,549,164,143,"51.49605","-0.104193","Gaywood  Street, Elephant & Castle",307
"3660",2020,5,550,160,149,"51.521564","-0.039264","Harford Street, Mile End",309
"3661",2020,5,551,115,101,"51.505772","-0.016460175","Import Dock, Canary Wharf",216
"3662",2020,5,552,252,244,"51.511542","-0.056667","Watney Street, Shadwell",496
"3663",2020,5,553,493,463,"51.535678","-0.062546","Regent's Row , Haggerston",956
"3664",2020,5,554,37,24,"51.513548","-0.005659","Aberfeldy Street, Poplar",61
"3665",2020,5,556,94,94,"51.502661","-0.021596","Heron Quays DLR, Canary Wharf",188
"3666",2020,5,557,148,176,"51.51601","-0.0985","King Edward Street, St Pauls",324
"3667",2020,5,558,334,399,"51.493978","-0.127554","Page Street, Westminster",733
"3668",2020,5,559,59,48,"51.501391","-0.205991","Abbotsbury Road, Holland Park",107
"3669",2020,5,560,85,48,"51.511624","-0.205921","Ladbroke Grove Central, Ladbroke Grove",133
"3670",2020,5,561,97,91,"51.518369","-0.043371","Rectory Square, Stepney",188
"3671",2020,5,562,213,204,"51.51746","-0.12335","Bury Place, Holborn",417
"3672",2020,5,563,32,39,"51.499286","-0.009152","Preston's Road, Cubitt Town",71
"3673",2020,5,564,379,528,"51.509943","-0.117619","Somerset House, Strand",907
"3674",2020,5,565,88,90,"51.521905","-0.063386","Selby Street, Whitechapel",178
"3675",2020,5,566,151,175,"51.509158","-0.224103","Westfield Ariel Way, White City",326
"3676",2020,5,568,285,254,"51.51616","-0.18697","Bishop's Bridge Road West, Bayswater",539
"3677",2020,5,569,208,168,"51.53213","-0.08299","Pitfield Street Central, Hoxton",376
"3678",2020,5,570,205,199,"51.503083","-0.017676","Upper Bank Street, Canary Wharf",404
"3679",2020,5,571,99,116,"51.506256","-0.218337","Westfield Southern Terrace ,Shepherd's Bush",215
"3680",2020,5,572,241,241,"51.539099","-0.141728","Greenland Road, Camden Town",482
"3681",2020,5,573,431,431,"51.485587","-0.18119","Limerston Street, West Chelsea",862
"3682",2020,5,574,546,456,"51.53356","-0.09315","Eagle Wharf Road, Hoxton",1002
"3683",2020,5,576,59,67,"51.497304","-0.022793","Alpha Grove, Millwall",126
"3684",2020,5,577,187,194,"51.528869","-0.047548","Globe Town Market, Bethnal Green",381
"3685",2020,5,578,112,118,"51.527607","-0.057133","Hollybush Gardens, Bethnal Green",230
"3686",2020,5,579,435,607,"51.511246","-0.093051","Queen Street 2, Bank",1042
"3687",2020,5,580,175,161,"51.48692917","-0.102996299","Doddington Grove, Kennington",336
"3688",2020,5,581,254,278,"51.519167","-0.147983","New Cavendish Street, Marylebone",532
"3689",2020,5,583,294,398,"51.497622","-0.125978","Abingdon Green, Westminster",692
"3690",2020,5,584,181,169,"51.51244","-0.19096","Ilchester Gardens, Bayswater",350
"3691",2020,5,586,30,29,"51.490645","-0.014582","Mudchute DLR, Cubitt Town",59
"3692",2020,5,587,366,406,"51.50964","-0.08497","Monument Street, Monument",772
"3693",2020,5,588,157,134,"51.52959","-0.0801","Hoxton Street, Hoxton",291
"3694",2020,5,589,260,259,"51.487196","-0.179369","Drayton Gardens, West Chelsea",519
"3695",2020,5,590,65,55,"51.53256","-0.16862","Greenberry Street, St.John's Wood",120
"3696",2020,5,592,129,97,"51.5171","-0.18377","Bishop's Bridge Road East, Bayswater",226
"3697",2020,5,593,164,135,"51.531066","-0.11934","Northdown Street, King's Cross",299
"3698",2020,5,594,249,262,"51.513875","-0.117774","Kingsway Southbound, Strand",511
"3699",2020,5,595,228,237,"51.493267","-0.21985","Hammersmith Road, Hammersmith",465
"3700",2020,5,596,255,240,"51.472817","-0.199783","Parson's Green , Parson's Green",495
"3701",2020,5,597,144,143,"51.473471","-0.20782","Fulham Park Road, Fulham",287
"3702",2020,5,598,187,161,"51.494499","-0.228188","Southerton Road, Hammersmith",348
"3703",2020,5,599,103,90,"51.485743","-0.223616","Manbre Road, Hammersmith",193
"3704",2020,5,600,250,261,"51.481747","-0.124642","South Lambeth Road, Vauxhall",511
"3705",2020,5,601,121,134,"51.514767","-0.225787","BBC White City, White City",255
"3706",2020,5,602,191,183,"51.472993","-0.133972","Union Grove, Wandsworth Road",374
"3707",2020,5,603,119,150,"51.477839","-0.116493","Caldwell Street, Stockwell",269
"3708",2020,5,604,89,77,"51.538792","-0.138535","St Martins Close, Camden Town",166
"3709",2020,5,605,170,175,"51.520331","-0.163667","Seymour Place, Marylebone",345
"3710",2020,5,606,68,59,"51.504199","-0.210941","Addison Road, Holland Park",127
"3711",2020,5,607,165,164,"51.468814","-0.210279","Putney Bridge Station, Fulham",329
"3712",2020,5,608,25,30,"51.491093","-0.216493","Colet Gardens, Hammersmith",55
"3713",2020,5,609,81,48,"51.46512358","-0.157788279","Sugden Road, Clapham",129
"3714",2020,5,610,149,149,"51.48256792","-0.172078187","Danvers Street, West Chelsea",298
"3715",2020,5,611,107,92,"51.50646524","-0.208486599","Princedale Road , Holland Park",199
"3716",2020,5,612,184,159,"51.46925984","-0.141812513","Wandsworth Rd, Isley Court, Wandsworth Road",343
"3717",2020,5,613,332,319,"51.50403821","-0.217400093","Woodstock Grove, Shepherd's Bush",651
"3718",2020,5,614,83,74,"51.47817208","-0.144690541","Bradmead, Battersea Park",157
"3719",2020,5,615,188,178,"51.4768851","-0.215895601","Finlay Street, Fulham",366
"3720",2020,5,616,188,157,"51.48102131","-0.209973497","Aintree Street, Fulham",345
"3721",2020,5,617,88,76,"51.47107905","-0.207842908","Elysium Place, Fulham",164
"3722",2020,5,618,133,105,"51.47625965","-0.193254007","Eel Brook Common, Walham Green",238
"3723",2020,5,619,134,100,"51.4737636","-0.197010096","Irene Road, Parsons Green",234
"3724",2020,5,620,164,140,"51.47518024","-0.167160736","Surrey Lane, Battersea",304
"3725",2020,5,621,214,227,"51.46086446","-0.187427294","Wandsworth Town Station, Wandsworth",441
"3726",2020,5,622,221,223,"51.50748124","-0.205535908","Lansdowne Road, Ladbroke Grove",444
"3727",2020,5,623,76,68,"51.46193072","-0.180791784","Nantes Close, Wandsworth",144
"3728",2020,5,624,140,126,"51.4729184","-0.132102704","Courland Grove, Wandsworth Road",266
"3729",2020,5,625,254,208,"51.47761941","-0.149551631","Queen's Circus, Battersea Park",462
"3730",2020,5,626,256,247,"51.48438657","-0.20481514","Normand Park, West Kensington",503
"3731",2020,5,627,74,81,"51.4687905","-0.158230901","Holden Street, Battersea",155
"3732",2020,5,628,174,161,"51.46881971","-0.184318843","William Morris Way, Sands End",335
"3733",2020,5,629,48,43,"51.45995384","-0.190184054","Morie Street, Wandsworth",91
"3734",2020,5,630,93,85,"51.47073264","-0.126994068","Clarence Walk, Stockwell",178
"3735",2020,5,631,215,200,"51.4795017","-0.141770709","Battersea Park Road, Nine Elms",415
"3736",2020,5,632,93,88,"51.47053858","-0.163041605","Sheepcote Lane, Battersea",181
"3737",2020,5,633,169,163,"51.48959104","-0.209378594","Vereker Road, West Kensington",332
"3738",2020,5,634,115,121,"51.49434708","-0.215804559","Brook Green South, Brook Green",236
"3739",2020,5,635,191,179,"51.48606206","-0.214428378","Greyhound Road, Hammersmith",370
"3740",2020,5,636,193,182,"51.46706414","-0.193502076","South Park, Sands End",375
"3741",2020,5,637,51,52,"51.45787019","-0.174691623","Spencer Park, Wandsworth Common",103
"3742",2020,5,638,437,418,"51.46663393","-0.169821175","Falcon Road, Clapham Junction",855
"3743",2020,5,639,192,191,"51.48357068","-0.202038682","Coomer Place, West Kensington",383
"3744",2020,5,640,133,118,"51.47286577","-0.148059277","Silverthorne Road, Battersea",251
"3745",2020,5,641,100,118,"51.49824168","-0.117495865","Archbishop's Park, Waterloo",218
"3746",2020,5,642,76,76,"51.46916161","-0.174485792","Fawcett Close, Battersea",152
"3747",2020,5,643,92,77,"51.5190427","-0.204764421","All Saints' Road, Portobello",169
"3748",2020,5,644,196,188,"51.48373225","-0.223852256","Rainville Road, Hammersmith",384
"3749",2020,5,645,203,209,"51.50173215","-0.100292412","Great Suffolk Street, The Borough",412
"3750",2020,5,646,244,262,"51.49886563","-0.137424571","Buckingham Gate, Westminster",506
"3751",2020,5,647,147,159,"51.50035306","-0.217515071","Richmond Way, Shepherd's Bush",306
"3752",2020,5,648,87,70,"51.46904022","-0.19627483","Peterborough Road, Sands End",157
"3753",2020,5,649,140,139,"51.48180515","-0.18027465","World's End Place, West Chelsea",279
"3754",2020,5,650,138,135,"51.51687069","-0.213872396","St. Mark's Road, North Kensington",273
"3755",2020,5,651,81,82,"51.48089844","-0.183853573","Thorndike Close, West Chelsea",163
"3756",2020,5,652,57,77,"51.51148696","-0.218190203","Evesham Street, Avondale",134
"3757",2020,5,653,186,176,"51.47084722","-0.17070367","Simpson Street, Clapham Junction",362
"3758",2020,5,654,146,131,"51.48267821","-0.117661574","Ashmole Estate, Oval",277
"3759",2020,5,655,134,116,"51.48294452","-0.219346128","Crabtree Lane, Fulham",250
"3760",2020,5,656,84,70,"51.46841875","-0.199135704","Broomhouse Lane, Parsons Green",154
"3761",2020,5,657,85,69,"51.4996806","-0.221791552","Blythe Road West, Shepherd's Bush",154
"3762",2020,5,658,349,334,"51.47729232","-0.16478637","Ethelburga Estate, Battersea Park",683
"3763",2020,5,659,283,321,"51.511934","-0.10307894","Blackfriars Station, St. Paul's",604
"3764",2020,5,660,115,111,"51.49087074","-0.206029743","West Kensington Station, West Kensington",226
"3765",2020,5,661,272,256,"51.51632095","-0.202608612","All Saints Church, Portobello",528
"3766",2020,5,662,175,172,"51.48498496","-0.167919869","Phene Street, Chelsea",347
"3767",2020,5,663,106,99,"51.51323001","-0.211593602","Clarendon Road, Avondale",205
"3768",2020,5,664,202,175,"51.474376","-0.155442787","Austin Road, Battersea Park",377
"3769",2020,5,665,109,95,"51.46108367","-0.191722864","Smugglers Way, Wandsworth",204
"3770",2020,5,666,185,169,"51.49610093","-0.208158259","Olympia Way, Olympia",354
"3771",2020,5,667,133,130,"51.5015946","-0.222293381","Shepherd's Bush Road North, Shepherd's Bush",263
"3772",2020,5,668,207,208,"51.49422354","-0.236769936","Ravenscourt Park Station, Hammersmith",415
"3773",2020,5,669,83,53,"51.47614939","-0.1232585","Teversham Lane, Stockwell",136
"3774",2020,5,670,146,131,"51.46718562","-0.152248582","Ashley Crescent, Battersea",277
"3775",2020,5,671,343,342,"51.475089","-0.201968","Parsons Green Station, Parsons Green",685
"3776",2020,5,673,160,144,"51.46517078","-0.18038939","Hibbert Street, Battersea",304
"3777",2020,5,674,163,109,"51.53546778","-0.11619105","Carnegie Street, King's Cross",272
"3778",2020,5,675,101,101,"51.46348914","-0.182126248","Usk Road, Clapham Junction",202
"3779",2020,5,676,210,186,"51.47787084","-0.126874471","Hartington Road, Stockwell",396
"3780",2020,5,677,79,55,"51.46866929","-0.146544642","Heath Road, Battersea",134
"3781",2020,5,678,47,51,"51.46231278","-0.211468596","Esmond Street, Putney",98
"3782",2020,5,679,160,136,"51.47453545","-0.170210533","Orbel Street, Battersea",296
"3783",2020,5,680,359,329,"51.47768469","-0.170329317","Westbridge Road, Battersea",688
"3784",2020,5,681,149,171,"51.47303687","-0.214749808","Bishop's Avenue, Fulham",320
"3785",2020,5,682,244,246,"51.48810829","-0.22660621","Crisp Road, Hammersmith",490
"3786",2020,5,683,96,88,"51.46506424","-0.163750945","Dorothy Road, Clapham Junction",184
"3787",2020,5,684,89,97,"51.45475251","-0.195197203","Neville Gill Close, Wandsworth",186
"3788",2020,5,685,170,160,"51.46067005","-0.198735357","Osiers Road, Wandsworth",330
"3789",2020,5,686,153,153,"51.48814438","-0.222456468","Beryl Road, Hammersmith",306
"3790",2020,5,687,181,182,"51.49760804","-0.21145598","Maclise Road, Olympia",363
"3791",2020,5,688,66,60,"51.46095151","-0.20066766","Northfields, Wandsworth",126
"3792",2020,5,689,48,33,"51.45922541","-0.180884959","Spanish Road, Clapham Junction",81
"3793",2020,5,690,100,74,"51.47047503","-0.152130083","Stanley Grove, Battersea",174
"3794",2020,5,691,229,235,"51.47946386","-0.195777222","Erin Close, Walham Green",464
"3795",2020,5,692,199,204,"51.54211855","-0.028941601","Cadogan Close, Victoria Park",403
"3796",2020,5,693,64,70,"51.464786","-0.215618902","Felsham Road, Putney",134
"3797",2020,5,694,56,52,"51.46071722","-0.216526155","Putney Rail Station, Putney",108
"3798",2020,5,695,465,440,"51.53638435","-0.102757578","Islington Green, Angel",905
"3799",2020,5,696,212,211,"51.48728535","-0.217995921","Charing Cross Hospital, Hammersmith",423
"3800",2020,5,697,133,99,"51.53639219","-0.112721065","Charlotte Terrace, Angel",232
"3801",2020,5,698,166,126,"51.53908372","-0.070329419","Shoreditch Court, Haggerston",292
"3802",2020,5,699,124,83,"51.5366541","-0.07023031","Belford House, Haggerston",207
"3803",2020,5,700,174,131,"51.47696496","-0.174347066","Battersea Church Road, Battersea",305
"3804",2020,5,701,267,247,"51.47287627","-0.176267008","Vicarage Crescent, Battersea",514
"3805",2020,5,702,227,170,"51.52868155","-0.065550321","Durant Street, Bethnal Green",397
"3806",2020,5,703,326,451,"51.51505991","-0.10534448","St. Bride Street, Holborn",777
"3807",2020,5,704,43,29,"51.45682071","-0.202802098","Mexfield Road, East Putney",72
"3808",2020,5,705,62,66,NA,NA,NA,128
"3809",2020,5,706,285,301,"51.50215353","-0.083632928","Snowsfields, London Bridge",586
"3810",2020,5,707,329,327,"51.49021762","-0.215087092","Barons Court Station, West Kensington",656
"3811",2020,5,708,97,95,"51.46161068","-0.21614583","Disraeli Road, Putney",192
"3812",2020,5,709,70,70,"51.46321128","-0.215550761","Montserrat Road , Putney",140
"3813",2020,5,710,174,174,"51.47439218","-0.163347594","Albert Bridge Road, Battersea Park",348
"3814",2020,5,711,120,117,"51.48335692","-0.216305546","Everington Street, Fulham",237
"3815",2020,5,712,195,191,"51.51854104","-0.034903714","Mile End Stadium, Mile End",386
"3816",2020,5,713,78,87,"51.54100708","-0.14326094","Hawley Crescent, Camden Town",165
"3817",2020,5,714,85,78,"51.47311696","-0.137235175","Stewart's Road, Wandsworth Road",163
"3818",2020,5,715,101,77,"51.51563007","-0.049067243","Aylward Street, Stepney",178
"3819",2020,5,716,112,96,"51.51542791","-0.02356501","Stainsby Road , Poplar",208
"3820",2020,5,717,413,350,"51.53658514","-0.075885686","Dunston Road , Haggerston",763
"3821",2020,5,718,271,256,"51.53571683","-0.060291813","Ada Street, Hackney Central",527
"3822",2020,5,719,270,265,"51.53642464","-0.054162264","Victoria Park Road, Hackney Central",535
"3823",2020,5,720,166,147,"51.48724429","-0.205279052","Star Road, West Kensington",313
"3824",2020,5,721,97,94,"51.53603947","-0.026262677","Wendon Street, Old Ford",191
"3825",2020,5,722,152,136,"51.52458353","-0.058631453","Finnis Street, Bethnal Green",288
"3826",2020,5,723,301,277,"51.46822047","-0.190346493","Stephendale Road, Sands End",578
"3827",2020,5,724,82,44,"51.45799126","-0.184806157","Alma Road, Wandsworth",126
"3828",2020,5,725,215,205,"51.491327","-0.096518684","Walworth Square, Walworth",420
"3829",2020,5,726,174,168,"51.47505096","-0.150908371","Alfreda Street, Battersea Park",342
"3830",2020,5,727,178,160,"51.47569809","-0.20587627","Chesilton Road, Fulham",338
"3831",2020,5,728,52,47,"51.46199911","-0.206240805","Putney Bridge Road, East Putney",99
"3832",2020,5,729,258,229,"51.47893931","-0.208485293","St. Peter's Terrace, Fulham",487
"3833",2020,5,730,203,216,"51.49208492","-0.229116862","Bridge Avenue, Hammersmith",419
"3834",2020,5,731,120,128,"51.47727637","-0.189210466","Michael Road, Walham Green",248
"3835",2020,5,732,704,715,"51.50630441","-0.087262995","Duke Street Hill, London Bridge",1419
"3836",2020,5,733,122,126,"51.50542628","-0.150817316","Park Lane, Mayfair",248
"3837",2020,5,734,90,70,"51.46230566","-0.175407201","Plough Terrace, Clapham Junction",160
"3838",2020,5,735,236,231,"51.46489445","-0.17302926","Grant Road East, Clapham Junction",467
"3839",2020,5,736,41,50,"51.50659035","-0.216104479","Queensdale Road, Shepherd's Bush",91
"3840",2020,5,737,454,457,"51.47993289","-0.19411695","Fulham Broadway, Walham Green",911
"3841",2020,5,738,152,153,"51.47514228","-0.187278987","Imperial Road, Sands End",305
"3842",2020,5,739,144,145,"51.48176572","-0.185273723","Hortensia Road, West Brompton",289
"3843",2020,5,740,46,40,"51.51092871","-0.214594781","Sirdar Road, Avondale",86
"3844",2020,5,741,62,59,"51.5129814","-0.219486603","Freston Road, Avondale",121
"3845",2020,5,742,149,160,"51.51510818","-0.208565479","Blenheim Crescent, Ladbroke Grove",309
"3846",2020,5,743,43,43,"51.46079243","-0.212607684","Oxford Road, Putney",86
"3847",2020,5,744,40,37,"51.46745485","-0.172293499","Ingrave Street, Clapham Junction",77
"3848",2020,5,745,113,108,"51.47816972","-0.18243547","Upcerne Road, West Chelsea",221
"3849",2020,5,746,142,138,"51.4795738","-0.17903854","Lots Road, West Chelsea",280
"3850",2020,5,747,150,146,"51.48796408","-0.161765173","Ormonde Gate, Chelsea",296
"3851",2020,5,748,284,228,"51.53727795","-0.079201849","Hertford Road, De Beauvoir Town",512
"3852",2020,5,749,255,203,"51.53932857","-0.074284675","Haggerston Road, Haggerston",458
"3853",2020,5,750,49,45,"51.4710956","-0.157850096","Culvert Road, Battersea",94
"3854",2020,5,751,160,196,"51.51612862","-0.120909408","Newton Street, Covent Garden",356
"3855",2020,5,754,74,72,"51.5129006","-0.214762686","Grenfell Road, Avondale",146
"3856",2020,5,755,189,200,"51.48512191","-0.174971902","The Vale, Chelsea",389
"3857",2020,5,756,166,161,"51.47515398","-0.159169801","Prince of Wales Drive, Battersea Park",327
"3858",2020,5,757,147,148,"51.48795853","-0.187404506","Harcourt Terrace, West Brompton",295
"3859",2020,5,758,166,146,"51.51787005","-0.201005397","Westbourne Park Road, Portobello",312
"3860",2020,5,759,94,66,"51.52456169","-0.165668686","Broadley Terrace, Marylebone",160
"3861",2020,5,760,71,65,"51.52526975","-0.163795009","Rossmore Road, Marylebone",136
"3862",2020,5,761,166,153,"51.48321729","-0.211860644","Humbolt Road, Fulham",319
"3863",2020,5,762,443,538,"51.50070305","-0.129698963","Storey's Gate, Westminster",981
"3864",2020,5,763,170,149,"51.52059714","-0.032566533","Mile End Park Leisure Centre, Mile End",319
"3865",2020,5,764,141,170,"51.46239255","-0.16829214","St. John's Road, Clapham Junction",311
"3866",2020,5,765,57,62,"51.46760141","-0.20682737","Ranelagh Gardens, Fulham",119
"3867",2020,5,766,191,184,"51.45752945","-0.192165613","Ram Street, Wandsworth",375
"3868",2020,5,767,18,13,"51.45705988","-0.200806304","Santos Road, Wandsworth",31
"3869",2020,5,768,136,145,"51.46134382","-0.159322467","Clapham Common North Side, Clapham Common",281
"3870",2020,5,769,187,187,"51.473611","-0.191803","Sandilands Road, Walham Green",374
"3871",2020,5,770,120,102,"51.491026","-0.209121","Gwendwr Road, West Kensington",222
"3872",2020,5,771,62,60,"51.509224","-0.216016","Rifle Place, Avondale",122
"3873",2020,5,772,347,312,"51.47250956","-0.122831913","Binfield Road, Stockwell",659
"3874",2020,5,773,354,365,"51.511891","-0.107349","Tallis Street, Temple",719
"3875",2020,5,774,62,50,"51.470131","-0.20464","Hurlingham Park, Parsons Green",112
"3876",2020,5,775,98,122,"51.496664","-0.223868","Little Brook Green, Brook Green",220
"3877",2020,5,776,98,103,"51.460333","-0.167029","Abyssinia Close, Clapham Junction",201
"3878",2020,5,777,39,34,"51.4619230679","-0.165297856693","Limburg Road, Clapham Junction",73
"3879",2020,5,778,1,1,NA,NA,NA,2
"3880",2020,5,779,279,290,"51.514449","-0.077178979","Houndsditch, Aldgate",569
"3881",2020,5,780,271,280,"51.474665","-0.18316517","Imperial Wharf Station, Sands End",551
"3882",2020,5,781,198,271,"51.495898","-0.173009","Victoria & Albert Museum, South Kensington",469
"3883",2020,5,782,193,174,"51.483911","-0.19760944","Halford Road, West Kensington",367
"3884",2020,5,783,282,293,"51.5403115","-0.021630359","Monier Road, Hackney Wick",575
"3885",2020,5,784,155,155,"51.546326","-0.00993526","East Village, Queen Elizabeth Olympic Park",310
"3886",2020,5,785,433,420,"51.54094","-0.010510565","Aquatic Centre, Queen Elizabeth Olympic Park",853
"3887",2020,5,786,121,129,"51.549369","-0.015717614","Lee Valley VeloPark, Queen Elizabeth Olympic Park",250
"3888",2020,5,787,127,103,"51.546805","-0.01469126","Timber Lodge, Queen Elizabeth Olympic Park",230
"3889",2020,5,789,92,91,"51.538718","-0.011889482","Podium, Queen Elizabeth Olympic Park",183
"3890",2020,5,790,195,194,"51.541793","-0.00481","Stratford Station, Stratford",389
"3891",2020,5,792,219,237,"51.505461","-0.10454093","Blackfriars Road, Southwark",456
"3892",2020,5,793,139,122,"51.528279","-0.11955857","Cromer Street, Bloomsbury",261
"3893",2020,5,794,54,46,NA,NA,NA,100
"3894",2020,5,795,170,176,"51.527068","-0.13186102","Euston Square Gardens, Euston",346
"3895",2020,5,796,174,170,"51.524","-0.12640984","Coram Street, Bloomsbury",344
"3896",2020,5,797,247,248,"51.5293","-0.12827903","Ossulston Street, Somers Town",495
"3897",2020,5,798,304,328,"51.5301998755","-0.122299440803","Birkenhead Street, King's Cross",632
"3898",2020,5,799,174,206,"51.4976984561","-0.137598896295","Kings Gate House, Westminster",380
"3899",2020,5,800,224,218,"51.4811219398","-0.149035374873","Sopwith Way, Battersea Park",442
"3900",2020,5,801,234,273,"51.5052241745","-0.0980318118664","Lavington Street, Bankside",507
"3901",2020,5,802,158,130,"51.4765900593","-0.118256789081","Albert Square, Stockwell",288
"3902",2020,5,803,171,186,"51.5054099403","-0.0983410884509","Southwark Street, Bankside",357
"3903",2020,5,804,350,353,"51.5346677396","-0.125078652873","Good's Way, King's Cross",703
"3904",2020,5,806,212,198,"51.5372405623","-0.124807385707","Handyside Street, King's Cross",410
"3905",2020,5,807,206,222,"51.5212","-0.20888818","Bevington Road West, North Kensington",428
"3906",2020,5,808,67,62,NA,NA,NA,129
"3907",2020,5,809,162,220,"51.5162778834","-0.118272991635","Lincoln's Inn Fields, Holborn",382
"3908",2020,5,810,331,385,"51.5067252868","-0.0988072461627","Tate Modern, Bankside",716
"3909",2020,5,811,232,264,"51.5057030357","-0.0277727426235","Westferry Circus, Canary Wharf",496
"3910",2020,5,812,72,82,"51.5487311915","-0.0226065549321","Here East North, Queen Elizabeth Olympic Park",154
"3911",2020,5,813,171,197,"51.4878074485","-0.122759625866","New Spring Gardens Walk, Vauxhall",368
"3912",2020,5,814,70,55,"51.4714330677","-0.123670735702","Clapham Road, Lingham Street, Stockwell",125
"3913",2020,5,815,364,366,"51.5000891978","-0.116628700672","Lambeth Palace Road, Waterloo",730
"3914",2020,5,816,66,72,"51.5465327935","-0.0205975904647","Here East South, Queen Elizabeth Olympic Park",138
"3915",2020,5,817,243,217,"51.4813354746","-0.138212295869","Riverlight South, Nine Elms",460
"3916",2020,5,818,514,495,"51.501513","-0.12382322","Westminster Pier, Westminster",1009
"3917",2020,5,819,176,213,"51.50621","-0.114842","Belvedere Road 2, South Bank",389
"3918",2020,5,820,137,108,"51.492807","-0.091938","Victory Place, Walworth",245
"3919",2020,5,821,361,356,"51.4835074867","-0.147714557371","Battersea Power Station, Battersea Park",717
"3920",2020,5,826,501,528,"51.496863","-0.1429434","Allington Street, Victoria",1029
"3921",2020,5,827,185,197,"51.479601","-0.11147178","Cranmer Road, Stockwell",382
"3922",2020,5,828,170,150,"51.473874","-0.11258096","Normandy Road, Stockwell",320
"3923",2020,5,829,74,68,"51.469217","-0.11268674","Wynne Road, Stockwell",142
"3924",2020,5,830,114,101,"51.469202","-0.11902256","Sidney Road, Stockwell",215
"3925",2020,5,831,98,80,"51.466232","-0.11317995","St John's Crescent, Brixton",178
"3926",2020,5,832,166,162,"51.464019","-0.11578197","Ferndale Road, Brixton",328
"3927",2020,5,833,129,134,"51.460232","-0.11537509","Saltoun Road, Brixton",263
"3928",2020,5,834,144,143,"51.477966","-0.14785703","Gas Holders, Battersea Park",287
"3929",2020,5,835,162,163,"51.516785","-0.10494775","Farringdon Street, Holborn",325
"3930",2020,5,836,158,123,"51.541596","-0.12544145","York Way, Kings Cross",281
"3931",2020,5,838,213,224,"51.518093","-0.0914017","Fore Street Avenue, Guildhall",437
"3932",2020,5,839,385,394,"51.508033","-0.10682363","Sea Containers, South Bank",779
"3933",2020,6,1,154,128,"51.52916347","-0.109970527","River Street , Clerkenwell",282
"3934",2020,6,2,215,208,"51.49960695","-0.197574246","Phillimore Gardens, Kensington",423
"3935",2020,6,3,242,278,"51.52128377","-0.084605692","Christopher Street, Liverpool Street",520
"3936",2020,6,4,135,154,"51.53005939","-0.120973687","St. Chad's Street, King's Cross",289
"3937",2020,6,5,328,343,"51.49313","-0.156876","Sedding Street, Sloane Square",671
"3938",2020,6,6,264,277,"51.51811784","-0.144228881","Broadcasting House, Marylebone",541
"3939",2020,6,7,114,104,"51.53430039","-0.1680743","Charlbert Street, St. John's Wood",218
"3940",2020,6,8,147,144,"51.529857","-0.18348604","Maida Vale, Maida Vale",291
"3941",2020,6,9,218,225,"51.5073853","-0.096440751","New Globe Walk, Bankside",443
"3942",2020,6,10,109,121,"51.50597426","-0.092754157","Park Street, Bankside",230
"3943",2020,6,11,230,235,"51.52395143","-0.122502346","Brunswick Square, Bloomsbury",465
"3944",2020,6,12,510,560,"51.52168078","-0.130431727","Malet Street, Bloomsbury",1070
"3945",2020,6,13,165,179,"51.51991453","-0.136039674","Scala Street, Fitzrovia",344
"3946",2020,6,14,1653,1690,"51.52994371","-0.123616824","Belgrove Street , King's Cross",3343
"3947",2020,6,15,245,251,"51.51772703","-0.127854211","Great Russell Street, Bloomsbury",496
"3948",2020,6,16,308,300,"51.52635795","-0.125979294","Cartwright Gardens , Bloomsbury",608
"3949",2020,6,17,419,465,"51.5216612","-0.109006325","Hatton Wall, Holborn",884
"3950",2020,6,18,335,352,"51.51477076","-0.12221963","Drury Lane, Covent Garden",687
"3951",2020,6,19,330,323,"51.52505093","-0.131161087","Taviton Street, Bloomsbury",653
"3952",2020,6,20,201,160,"51.527326","-0.13605286","Drummond Street , Euston",361
"3953",2020,6,21,79,63,"51.53007835","-0.13884627","Hampstead Road (Cartmel), Euston",142
"3954",2020,6,22,330,333,"51.5222641","-0.114079481","Northington Street , Holborn",663
"3955",2020,6,23,172,163,"51.51943538","-0.119123345","Red Lion Square, Holborn",335
"3956",2020,6,24,379,365,"51.51908011","-0.124678402","British Museum, Bloomsbury",744
"3957",2020,6,25,432,363,"51.5288338","-0.132250369","Doric Way , Somers Town",795
"3958",2020,6,26,187,154,"51.52728093","-0.11829517","Ampton Street , Clerkenwell",341
"3959",2020,6,27,310,293,"51.51382102","-0.107927706","Bouverie Street, Temple",603
"3960",2020,6,28,254,234,"51.52351808","-0.143613641","Bolsover Street, Fitzrovia",488
"3961",2020,6,29,192,137,"51.513735","-0.193487","Hereford Road, Bayswater",329
"3962",2020,6,30,268,245,"51.52915444","-0.093421615","Windsor Terrace, Hoxton",513
"3963",2020,6,31,274,255,"51.52953709","-0.083353323","Fanshaw Street, Hoxton",529
"3964",2020,6,32,417,486,"51.52469624","-0.084439283","Leonard Circus , Shoreditch",903
"3965",2020,6,33,234,234,"51.5156","-0.070056","Central House, Aldgate",468
"3966",2020,6,34,132,125,"51.5341235","-0.129386874","Pancras Road, King's Cross",257
"3967",2020,6,36,212,223,"51.50173726","-0.184980612","De Vere Gardens, Kensington",435
"3968",2020,6,37,176,166,"51.49159394","-0.192369256","Penywern Road, Earl's Court",342
"3969",2020,6,38,126,127,"51.4973875","-0.197245586","Abingdon Villas, Kensington",253
"3970",2020,6,39,500,484,"51.5263778","-0.078130921","Shoreditch High Street, Shoreditch",984
"3971",2020,6,40,155,153,"51.52127071","-0.0755789","Commercial Street, Shoreditch",308
"3972",2020,6,41,391,438,"51.520955","-0.083493552","Pindar Street, Liverpool Street",829
"3973",2020,6,42,296,236,"51.53099181","-0.093903825","Wenlock Road , Hoxton",532
"3974",2020,6,43,259,273,"51.52026","-0.157183945","Crawford Street, Marylebone",532
"3975",2020,6,44,138,140,"51.51073687","-0.144165239","Bruton Street, Mayfair",278
"3976",2020,6,45,395,346,"51.522511","-0.162298","Boston Place, Marylebone",741
"3977",2020,6,46,435,434,"51.507131","-0.06691","Nesham Street, Wapping",869
"3978",2020,6,47,240,224,"51.52334476","-0.183846408","Warwick Avenue Station, Maida Vale",464
"3979",2020,6,48,338,368,"51.51248445","-0.099141408","Godliman Street, St. Paul's",706
"3980",2020,6,49,131,178,"51.50706909","-0.145904427","Curzon Street, Mayfair",309
"3981",2020,6,50,220,207,"51.52867339","-0.087459376","East Road, Hoxton",427
"3982",2020,6,51,206,198,"51.52671796","-0.104298194","Finsbury Library , Finsbury",404
"3983",2020,6,52,201,227,"51.52295439","-0.094934859","Roscoe Street, St. Luke's",428
"3984",2020,6,53,141,153,"51.5099923","-0.143495266","Grafton Street, Mayfair",294
"3985",2020,6,54,203,237,"51.52174785","-0.094475072","Golden Lane, Barbican",440
"3986",2020,6,55,654,793,"51.51707521","-0.086685542","Finsbury Circus, Liverpool Street",1447
"3987",2020,6,56,206,218,"51.52058381","-0.154701411","Paddington Street, Marylebone",424
"3988",2020,6,57,324,318,"51.52334672","-0.120202614","Guilford Street , Bloomsbury",642
"3989",2020,6,58,359,347,"51.52452699","-0.079248081","New Inn Yard, Shoreditch",706
"3990",2020,6,60,102,71,"51.52644828","-0.172190727","Lisson Grove, St. John's Wood",173
"3991",2020,6,61,241,232,"51.49738251","-0.089446947","Great Dover Street, The Borough",473
"3992",2020,6,62,108,103,"51.4907579","-0.106323685","Cotton Garden Estate, Kennington",211
"3993",2020,6,63,140,124,"51.53089041","-0.089782579","Murray Grove , Hoxton",264
"3994",2020,6,64,413,532,"51.50946212","-0.124749274","William IV Street, Strand",945
"3995",2020,6,65,220,216,NA,NA,NA,436
"3996",2020,6,66,642,1076,"51.51795029","-0.108657431","Holborn Circus, Holborn",1718
"3997",2020,6,67,370,308,"51.51882555","-0.108028472","Hatton Garden, Holborn",678
"3998",2020,6,68,345,333,"51.52059681","-0.116688468","Theobald's Road , Holborn",678
"3999",2020,6,69,206,229,"51.5262363","-0.134407652","Euston Road, Euston",435
"4000",2020,6,70,111,102,"51.53136059","-0.117069978","Calshot Street , King's Cross",213
"4001",2020,6,71,554,629,"51.5154186","-0.098850915","Newgate Street , St. Paul's",1183
"4002",2020,6,72,211,196,"51.52352001","-0.108340165","Farringdon Lane, Clerkenwell",407
"4003",2020,6,73,538,538,"51.52572618","-0.088486188","Old Street Station, St. Luke's",1076
"4004",2020,6,74,551,549,"51.48591714","-0.124469948","Vauxhall Cross, Vauxhall",1100
"4005",2020,6,75,218,226,"51.53219984","-0.105480698","Torrens Street, Angel",444
"4006",2020,6,76,132,89,"51.52559505","-0.144083893","Longford Street, The Regent's Park",221
"4007",2020,6,77,270,272,"51.52341837","-0.124121774","Russell Square Station, Bloomsbury",542
"4008",2020,6,78,253,244,"51.52486887","-0.099489485","Sadlers Sports Centre, Finsbury",497
"4009",2020,6,79,172,194,"51.511726","-0.11385596","Arundel Street, Temple",366
"4010",2020,6,80,203,175,"51.50069361","-0.102091246","Webber Street , Southwark",378
"4011",2020,6,81,254,269,"51.52025302","-0.141327271","Great Titchfield Street, Fitzrovia",523
"4012",2020,6,82,138,127,"51.514274","-0.111257","Chancery Lane, Holborn",265
"4013",2020,6,83,224,244,"51.50963938","-0.131510949","Panton Street, West End",468
"4014",2020,6,84,240,202,"51.51593725","-0.111778348","Breams Buildings, Holborn",442
"4015",2020,6,85,321,310,"51.50064702","-0.078600401","Tanner Street, Bermondsey",631
"4016",2020,6,86,138,133,"51.48947903","-0.115156562","Sancroft Street, Vauxhall",271
"4017",2020,6,87,306,315,"51.51646835","-0.079684557","Devonshire Square, Liverpool Street",621
"4018",2020,6,88,378,399,"51.51858757","-0.132053392","Bayley Street , Bloomsbury",777
"4019",2020,6,89,231,200,"51.5262503","-0.123509611","Tavistock Place, Bloomsbury",431
"4020",2020,6,90,79,76,"51.53301907","-0.139174593","Harrington Square 1, Camden Town",155
"4021",2020,6,91,177,159,"51.49368637","-0.111014912","Walnut Tree Walk, Vauxhall",336
"4022",2020,6,92,189,208,"51.49889832","-0.100440521","Borough Road, Elephant & Castle",397
"4023",2020,6,93,235,115,"51.53440868","-0.109025404","Cloudesley Road, Angel",350
"4024",2020,6,94,258,236,"51.49506109","-0.085814489","Bricklayers Arms, Borough",494
"4025",2020,6,95,511,533,"51.5208417","-0.097340162","Aldersgate Street, Barbican",1044
"4026",2020,6,96,191,184,"51.53095071","-0.078505384","Falkirk Street, Hoxton",375
"4027",2020,6,97,234,240,"51.49792478","-0.183834706","Gloucester Road (North), Kensington",474
"4028",2020,6,98,309,272,"51.52554222","-0.138231303","Hampstead Road, Euston",581
"4029",2020,6,99,304,330,"51.51457763","-0.158264483","Old Quebec Street, Marylebone",634
"4030",2020,6,100,149,151,"51.49043573","-0.122806861","Albert Embankment, Vauxhall",300
"4031",2020,6,101,745,788,"51.51155322","-0.0929401","Queen Street 1, Bank",1533
"4032",2020,6,102,332,328,"51.51340693","-0.076793375","Jewry Street, Aldgate",660
"4033",2020,6,103,109,93,"51.50472376","-0.192538767","Vicarage Gate, Kensington",202
"4034",2020,6,104,645,753,"51.51159481","-0.077121322","Crosswall, Tower",1398
"4035",2020,6,105,208,185,"51.51552971","-0.190240716","Westbourne Grove, Bayswater",393
"4036",2020,6,106,129,133,"51.51410514","-0.147301667","Woodstock Street, Mayfair",262
"4037",2020,6,107,552,529,"51.52600832","-0.096317627","Finsbury Leisure Centre, St. Luke's",1081
"4038",2020,6,108,267,266,"51.49812559","-0.132102166","Abbey Orchard Street, Westminster",533
"4039",2020,6,109,516,639,"51.51563144","-0.132328837","Soho Square , Soho",1155
"4040",2020,6,110,137,109,"51.53304322","-0.172528678","Wellington Road, St. John's Wood",246
"4041",2020,6,111,383,374,"51.5100172","-0.157275636","Park Lane , Hyde Park",757
"4042",2020,6,112,223,233,"51.51580998","-0.105270275","Stonecutter Street, Holborn",456
"4043",2020,6,113,158,159,"51.49646288","-0.183289032","Gloucester Road (Central), South Kensington",317
"4044",2020,6,114,237,238,"51.52451738","-0.158963647","Park Road (Baker Street), The Regent's Park",475
"4045",2020,6,115,405,401,"51.51423368","-0.073537654","Braham Street, Aldgate",806
"4046",2020,6,116,389,426,"51.51449962","-0.141423695","Little Argyll Street, West End",815
"4047",2020,6,117,246,250,"51.49288067","-0.114934001","Lollard Street, Vauxhall",496
"4048",2020,6,118,159,196,"51.49582705","-0.13547809","Rochester Row, Westminster",355
"4049",2020,6,119,381,390,"51.52589324","-0.090847761","Bath Street, St. Luke's",771
"4050",2020,6,120,209,234,"51.51573534","-0.093080779","The Guildhall, Guildhall",443
"4051",2020,6,121,287,298,"51.51891348","-0.156166631","Baker Street, Marylebone",585
"4052",2020,6,122,267,283,"51.52111369","-0.078869751","Norton Folgate, Liverpool Street",550
"4053",2020,6,123,133,119,"51.52836014","-0.104724625","St. John Street, Finsbury",252
"4054",2020,6,124,106,100,"51.49654462","-0.150905245","Eaton Square, Belgravia",206
"4055",2020,6,125,224,230,"51.50069491","-0.094524319","Borough High Street, The Borough",454
"4056",2020,6,126,373,381,"51.51782144","-0.096496865","Museum of London, Barbican",754
"4057",2020,6,127,169,167,"51.51700801","-0.09388536","Wood Street, Guildhall",336
"4058",2020,6,128,138,136,"51.49536226","-0.185296516","Emperor's Gate, South Kensington",274
"4059",2020,6,129,256,295,"51.5118973","-0.137043852","Golden Square, Soho",551
"4060",2020,6,130,358,402,"51.50950627","-0.075459482","Tower Gardens , Tower",760
"4061",2020,6,131,150,114,"51.53300545","-0.136792671","Eversholt Street , Camden Town",264
"4062",2020,6,132,742,765,"51.52364804","-0.074754872","Bethnal Green Road, Shoreditch",1507
"4063",2020,6,133,421,412,NA,NA,NA,833
"4064",2020,6,134,125,135,"51.504904","-0.06797","Wapping High Street, Wapping",260
"4065",2020,6,135,369,377,"51.52326004","-0.104708922","Clerkenwell Green, Clerkenwell",746
"4066",2020,6,136,325,363,"51.51196176","-0.097441687","Queen Victoria Street, St. Paul's",688
"4067",2020,6,138,205,212,"51.51227622","-0.157436972","Green Street, Mayfair",417
"4068",2020,6,139,196,188,"51.49488108","-0.117974901","Lambeth Road, Vauxhall",384
"4069",2020,6,140,369,417,"51.52096262","-0.085634242","Finsbury Square , Moorgate",786
"4070",2020,6,141,264,254,"51.51530805","-0.147203711","Chapel Place, Marylebone",518
"4071",2020,6,142,124,137,"51.49372451","-0.198286569","West Cromwell Road, Earl's Court",261
"4072",2020,6,143,137,182,"51.4968865","-0.161203828","Pont Street, Knightsbridge",319
"4073",2020,6,144,387,360,"51.48894022","-0.111435796","Kennington Cross, Kennington",747
"4074",2020,6,145,46,35,"51.50074359","-0.202759212","Ilchester Place, Kensington",81
"4075",2020,6,146,103,116,"51.48836528","-0.129361842","Vauxhall Bridge , Pimlico",219
"4076",2020,6,148,254,265,"51.49211134","-0.138364847","Tachbrook Street, Victoria",519
"4077",2020,6,149,154,148,"51.48478899","-0.110683213","Kennington Road Post Office, Oval",302
"4078",2020,6,150,173,211,"51.49705603","-0.168917077","Holy Trinity Brompton, Knightsbridge",384
"4079",2020,6,151,148,99,"51.51213691","-0.201554966","Chepstow Villas, Notting Hill",247
"4080",2020,6,152,195,191,"51.49217002","-0.101536865","Hampton Street, Walworth",386
"4081",2020,6,153,405,419,"51.511933","-0.174411","Bayswater Road, Hyde Park",824
"4082",2020,6,154,1498,1533,"51.50379168","-0.11282408","Waterloo Station 3, Waterloo",3031
"4083",2020,6,155,189,197,"51.49586666","-0.191933711","Lexham Gardens, Kensington",386
"4084",2020,6,156,161,144,"51.49443626","-0.092921165","New Kent Road, The Borough",305
"4085",2020,6,157,180,204,"51.50039792","-0.193068385","Wright's Lane, Kensington",384
"4086",2020,6,158,161,157,"51.49085368","-0.196170309","Trebovir Road, Earl's Court",318
"4087",2020,6,159,438,501,"51.51461995","-0.137841333","Great Marlborough Street, Soho",939
"4088",2020,6,160,243,272,"51.50663341","-0.131773845","Waterloo Place, St. James's",515
"4089",2020,6,162,221,222,"51.51760685","-0.121328408","Southampton Place, Holborn",443
"4090",2020,6,163,321,331,"51.4931848","-0.167894973","Sloane Avenue, Knightsbridge",652
"4091",2020,6,164,123,99,"51.515607","-0.183118788","Cleveland Gardens, Bayswater",222
"4092",2020,6,165,76,52,"51.517932","-0.183716959","Orsett Terrace, Bayswater",128
"4093",2020,6,166,203,203,"51.50185512","-0.159237081","Seville Street, Knightsbridge",406
"4094",2020,6,167,447,455,"51.49395092","-0.147624377","Eccleston Place, Victoria",902
"4095",2020,6,168,129,144,"51.50040123","-0.195455928","Argyll Road, Kensington",273
"4096",2020,6,169,263,261,"51.51474612","-0.165164288","Porchester Place, Paddington",524
"4097",2020,6,170,162,114,"51.52784273","-0.108068155","Hardwick Street, Clerkenwell",276
"4098",2020,6,171,128,125,"51.4916156","-0.186753859","Collingham Gardens, Earl's Court",253
"4099",2020,6,172,108,109,"51.49121192","-0.173715911","Sumner Place, South Kensington",217
"4100",2020,6,173,234,254,"51.50486","-0.113001","Waterloo Road, South Bank",488
"4101",2020,6,174,284,300,"51.512529","-0.115163","Strand, Strand",584
"4102",2020,6,175,337,369,"51.521668","-0.079608554","Worship Street, Shoreditch",706
"4103",2020,6,176,173,149,"51.51791921","-0.188098863","Gloucester Terrace, Bayswater",322
"4104",2020,6,177,429,444,"51.49616092","-0.140947636","Ashley Place, Victoria",873
"4105",2020,6,178,185,168,"51.48985626","-0.141923621","Warwick Square, Pimlico",353
"4106",2020,6,180,183,183,"51.5129118","-0.153645496","North Audley Street, Mayfair",366
"4107",2020,6,181,116,126,"51.49941247","-0.152317537","Belgrave Square, Belgravia",242
"4108",2020,6,182,246,227,"51.52202903","-0.165842551","Bell Street , Marylebone",473
"4109",2020,6,183,261,260,"51.482362","-0.13612398","Riverlight North, Nine Elms",521
"4110",2020,6,184,217,221,"51.52071513","-0.14521173","Portland Place, Marylebone",438
"4111",2020,6,185,228,224,"51.48805753","-0.140741432","Alderney Street, Pimlico",452
"4112",2020,6,186,641,598,"51.51733558","-0.175810943","South Wharf Road, Paddington",1239
"4113",2020,6,187,287,303,"51.49247977","-0.178433004","Queen's Gate (South), South Kensington",590
"4114",2020,6,188,121,102,"51.5165179","-0.164393768","Nutford Place, Marylebone",223
"4115",2020,6,189,143,84,"51.53166681","-0.109914711","Claremont Square, Angel",227
"4116",2020,6,190,243,241,"51.48997562","-0.132845681","Rampayne Street, Pimlico",484
"4117",2020,6,191,812,815,"51.50311799","-0.153520935","Hyde Park Corner, Hyde Park",1627
"4118",2020,6,192,328,361,"51.51251523","-0.133201961","Wardour Street, Soho",689
"4119",2020,6,193,438,543,"51.50581776","-0.100186337","Bankside Mix, Bankside",981
"4120",2020,6,194,781,1066,"51.50462759","-0.091773776","Hop Exchange, The Borough",1847
"4121",2020,6,195,282,302,"51.50724437","-0.106237501","Milroy Walk, South Bank",584
"4122",2020,6,196,256,275,"51.50368837","-0.098497684","Union Street, The Borough",531
"4123",2020,6,197,321,400,"51.50556905","-0.111606696","Stamford Street, South Bank",721
"4124",2020,6,199,600,620,"51.51048489","-0.082989638","Great Tower Street, Monument",1220
"4125",2020,6,200,276,254,"51.51492456","-0.066078037","LMU Commercial Road, Whitechapel",530
"4126",2020,6,201,326,309,"51.5225965","-0.161113413","Dorset Square, Marylebone",635
"4127",2020,6,202,432,453,"51.51236389","-0.06954201","Leman Street, Aldgate",885
"4128",2020,6,203,370,382,"51.51821864","-0.100791005","West Smithfield Rotunda, Farringdon",752
"4129",2020,6,204,176,181,"51.52659961","-0.112432615","Margery Street, Clerkenwell",357
"4130",2020,6,206,296,296,"51.518154","-0.062697","New Road 1 , Whitechapel",592
"4131",2020,6,207,73,71,"51.50135267","-0.153194766","Grosvenor Crescent, Belgravia",144
"4132",2020,6,208,70,60,"51.52505151","-0.166304359","Mallory Street, Marylebone",130
"4133",2020,6,209,122,130,"51.49358391","-0.165101392","Denyer Street, Knightsbridge",252
"4134",2020,6,210,397,414,"51.51681444","-0.151926305","Hinde Street, Marylebone",811
"4135",2020,6,211,128,180,"51.49464523","-0.158105512","Cadogan Place, Knightsbridge",308
"4136",2020,6,212,88,56,"51.50658458","-0.199004026","Campden Hill Road, Notting Hill",144
"4137",2020,6,213,702,705,"51.50274025","-0.149569201","Wellington Arch, Hyde Park",1407
"4138",2020,6,214,431,492,"51.52683806","-0.130504336","Endsleigh Gardens, Euston",923
"4139",2020,6,215,472,548,"51.51906932","-0.088285377","Moorfields, Moorgate",1020
"4140",2020,6,216,55,100,"51.49094565","-0.181190899","Old Brompton Road, South Kensington",155
"4141",2020,6,217,905,948,"51.51615461","-0.082422399","Wormwood Street, Liverpool Street",1853
"4142",2020,6,218,182,184,"51.48971651","-0.170194408","St. Luke's Church, Chelsea",366
"4143",2020,6,219,260,240,"51.49016361","-0.19039362","Bramham Gardens, Earl's Court",500
"4144",2020,6,220,123,134,"51.49066456","-0.166485083","Chelsea Green, Chelsea",257
"4145",2020,6,221,257,262,"51.49481649","-0.13045856","Horseferry Road, Westminster",519
"4146",2020,6,222,118,84,"51.50275704","-0.155349725","Knightsbridge, Hyde Park",202
"4147",2020,6,223,177,165,"51.49148474","-0.090220911","Rodney Road , Walworth",342
"4148",2020,6,224,197,199,"51.51031","-0.18740235","Queensway, Kensington Gardens",396
"4149",2020,6,225,382,292,"51.50935342","-0.196422","Notting Hill Gate Station, Notting Hill",674
"4150",2020,6,226,270,317,"51.50844614","-0.131961389","Charles II Street, West End",587
"4151",2020,6,227,230,206,"51.52891573","-0.115480888","Great Percy Street, Clerkenwell",436
"4152",2020,6,228,460,654,"51.50742485","-0.134621209","St. James's Square, St. James's",1114
"4153",2020,6,229,474,517,"51.50654321","-0.123179697","Whitehall Place, Strand",991
"4154",2020,6,230,162,190,"51.50669284","-0.103137426","Poured Lines, Bankside",352
"4155",2020,6,231,151,160,"51.49396755","-0.17873226","Queen's Gate (Central), South Kensington",311
"4156",2020,6,232,110,128,"51.51501025","-0.112753217","Carey Street, Holborn",238
"4157",2020,6,233,203,259,"51.50777049","-0.130699733","Pall Mall East, West End",462
"4158",2020,6,234,270,283,"51.53450449","-0.106992706","Liverpool Road (N1 Centre), Angel",553
"4159",2020,6,235,174,143,"51.49571828","-0.110889274","Kennington Road  , Vauxhall",317
"4160",2020,6,236,126,145,"51.51838043","-0.073438925","Fashion Street, Whitechapel",271
"4161",2020,6,237,275,277,"51.5097860151","-0.0681619805156","Dock Street, Wapping",552
"4162",2020,6,238,126,73,"51.5233534","-0.175116099","Frampton Street, Paddington",199
"4163",2020,6,239,376,359,"51.52443845","-0.138019439","Warren Street Station, Euston",735
"4164",2020,6,240,120,130,"51.50545935","-0.10569204","Colombo Street, Southwark",250
"4165",2020,6,242,212,202,"51.52200801","-0.151359288","Beaumont Street, Marylebone",414
"4166",2020,6,243,299,271,"51.49096258","-0.139625122","Gloucester Street, Pimlico",570
"4167",2020,6,244,277,307,"51.51611887","-0.128585022","Earnshaw Street , Covent Garden",584
"4168",2020,6,245,103,94,"51.4853572","-0.142207481","Grosvenor Road, Pimlico",197
"4169",2020,6,246,372,393,"51.52285301","-0.099994052","Berry Street, Clerkenwell",765
"4170",2020,6,247,108,78,"51.530529","-0.167515","St. John's Wood Church, The Regent's Park",186
"4171",2020,6,248,366,367,"51.50645179","-0.170279555","Triangle Car Park, Hyde Park",733
"4172",2020,6,249,163,138,"51.49859784","-0.096191134","Harper Road, The Borough",301
"4173",2020,6,250,98,104,"51.489932","-0.162727","Royal Avenue 1, Chelsea",202
"4174",2020,6,251,643,778,"51.518908","-0.079249","Brushfield Street, Liverpool Street",1421
"4175",2020,6,252,419,485,"51.5046364","-0.116542278","Jubilee Gardens, South Bank",904
"4176",2020,6,253,316,240,"51.53404294","-0.086379717","Shoreditch Park, Hoxton",556
"4177",2020,6,254,241,232,"51.53051587","-0.106408455","Chadwell Street, Angel",473
"4178",2020,6,255,175,172,"51.52557531","-0.179592915","Clifton Road, Maida Vale",347
"4179",2020,6,256,153,156,"51.51362054","-0.116764211","Houghton Street, Strand",309
"4180",2020,6,257,164,153,"51.52248185","-0.154907218","Westminster University, Marylebone",317
"4181",2020,6,258,155,156,NA,NA,NA,311
"4182",2020,6,259,174,169,"51.490959","-0.1532331","Bourne Street, Belgravia",343
"4183",2020,6,260,230,242,"51.5136846","-0.135580879","Broadwick Street, Soho",472
"4184",2020,6,261,102,65,"51.5134891","-0.191351186","Princes Square, Bayswater",167
"4185",2020,6,262,199,169,"51.49874469","-0.103132904","LSBU (Borough Road), Elephant & Castle",368
"4186",2020,6,263,256,250,"51.51422502","-0.080660083","St. Mary Axe, Aldgate",506
"4187",2020,6,264,316,310,"51.52644342","-0.109256828","Tysoe Street, Clerkenwell",626
"4188",2020,6,265,189,180,"51.51595344","-0.169249375","Southwick Street, Paddington",369
"4189",2020,6,266,268,294,"51.50102668","-0.180246101","Queen's Gate (North), Kensington",562
"4190",2020,6,267,194,172,"51.49206037","-0.132224622","Regency Street, Westminster",366
"4191",2020,6,268,305,320,"51.49320445","-0.144132875","Belgrave Road, Victoria",625
"4192",2020,6,269,235,218,"51.50082346","-0.089740764","Empire Square, The Borough",453
"4193",2020,6,270,577,583,"51.4863434","-0.122492418","Kennington Lane Rail Bridge, Vauxhall",1160
"4194",2020,6,271,126,104,"51.53583617","-0.156285395","London Zoo,  The Regent's Park",230
"4195",2020,6,272,475,519,"51.50144456","-0.110699309","Baylis Road, Waterloo",994
"4196",2020,6,273,310,345,"51.50613324","-0.114686385","Belvedere Road 1, South Bank",655
"4197",2020,6,274,159,145,"51.49671237","-0.20528437","Warwick Road, Olympia",304
"4198",2020,6,275,254,258,"51.52004497","-0.092176447","Barbican Centre, Barbican",512
"4199",2020,6,276,156,178,"51.50930161","-0.084985356","Lower Thames Street, Monument",334
"4200",2020,6,277,267,253,"51.50315739","-0.191496313","Kensington Church Street, Kensington",520
"4201",2020,6,278,635,646,"51.5034938","-0.07962099","Tooley Street, Bermondsey",1281
"4202",2020,6,279,303,290,"51.51862243","-0.176645823","North Wharf Road, Paddington",593
"4203",2020,6,280,187,203,"51.490083","-0.162418","Royal Avenue 2, Chelsea",390
"4204",2020,6,281,228,259,"51.49580589","-0.127575233","Smith Square, Westminster",487
"4205",2020,6,282,457,458,"51.51906446","-0.059642081","Royal London Hospital, Whitechapel",915
"4206",2020,6,283,75,86,"51.51440928","-0.118478757","Kingsway, Covent Garden",161
"4207",2020,6,284,188,181,"51.49914063","-0.112031483","Lambeth North Station, Waterloo",369
"4208",2020,6,286,157,97,"51.5272947","-0.174653609","St. John's Wood Road, St. John's Wood",254
"4209",2020,6,287,190,196,"51.52367314","-0.128377673","Bedford Way, Bloomsbury",386
"4210",2020,6,288,345,346,"51.49236962","-0.147478734","Elizabeth Bridge, Victoria",691
"4211",2020,6,289,73,84,"51.50923022","-0.151296092","South Audley Street, Mayfair",157
"4212",2020,6,290,202,174,"51.518268","-0.17110323","St Mary's Hospital, Paddington",376
"4213",2020,6,291,200,168,"51.48483991","-0.138089062","Claverton Street, Pimlico",368
"4214",2020,6,292,234,233,"51.49888404","-0.165471605","Montpelier Street, Knightsbridge",467
"4215",2020,6,293,116,107,"51.49815779","-0.209494128","Kensington Olympia Station, Olympia",223
"4216",2020,6,294,278,256,"51.488226","-0.135635511","St. George's Square, Pimlico",534
"4217",2020,6,295,228,228,"51.50029631","-0.092762704","Swan Street, The Borough",456
"4218",2020,6,296,95,102,"51.49363156","-0.190603326","Knaresborough Place, Earl's Court",197
"4219",2020,6,297,50,39,"51.49612799","-0.106000855","Geraldine Street, Elephant & Castle",89
"4220",2020,6,298,403,408,"51.50227992","-0.074189225","Curlew Street, Shad Thames",811
"4221",2020,6,299,95,106,"51.49398524","-0.136928582","Vincent Square, Westminster",201
"4222",2020,6,300,402,389,"51.505014","-0.17306032","Serpentine Car Park, Hyde Park",791
"4223",2020,6,301,274,297,"51.51475963","-0.148105415","Marylebone Lane, Marylebone",571
"4224",2020,6,302,60,61,"51.466907","-0.216573","Putney Pier, Wandsworth",121
"4225",2020,6,303,462,484,"51.50295379","-0.158456089","Albert Gate, Hyde Park",946
"4226",2020,6,306,206,205,"51.51816295","-0.135025698","Rathbone Street, Fitzrovia",411
"4227",2020,6,307,456,441,"51.50990837","-0.187842717","Black Lion Gate, Kensington Gardens",897
"4228",2020,6,308,207,198,"51.49907558","-0.085666316","Long Lane , Bermondsey",405
"4229",2020,6,309,176,205,"51.50963123","-0.119047563","Embankment (Savoy), Strand",381
"4230",2020,6,310,240,227,"51.4908679","-0.116911864","Black Prince Road, Vauxhall",467
"4231",2020,6,311,232,237,"51.51918144","-0.140485596","Foley Street, Fitzrovia",469
"4232",2020,6,312,181,148,"51.53088935","-0.176770502","Grove End Road, St. John's Wood",329
"4233",2020,6,313,310,342,"51.51734403","-0.138072691","Wells Street, Fitzrovia",652
"4234",2020,6,314,229,215,"51.50088934","-0.083159352","Tyers Gate, Bermondsey",444
"4235",2020,6,315,129,128,"51.52536703","-0.153463612","The Tennis Courts, The Regent's Park",257
"4236",2020,6,316,234,297,NA,NA,NA,531
"4237",2020,6,317,88,59,"51.49679128","-0.093913472","Dickens Square, Borough",147
"4238",2020,6,318,269,303,"51.51004801","-0.138846453","Sackville Street, Mayfair",572
"4239",2020,6,319,253,262,"51.52702563","-0.088542771","Baldwin Street, St. Luke's",515
"4240",2020,6,320,306,320,"51.49357351","-0.139956043","Queen Mother Sports Centre, Victoria",626
"4241",2020,6,321,332,325,"51.49785559","-0.081608045","Bermondsey Street, Bermondsey",657
"4242",2020,6,322,101,80,"51.526293","-0.073955","Palissy Street, Shoreditch",181
"4243",2020,6,323,155,163,"51.523196","-0.083067","Clifton Street, Shoreditch",318
"4244",2020,6,324,297,296,"51.49652013","-0.101384068","Ontario Street, Elephant & Castle",593
"4245",2020,6,325,183,250,"51.50908747","-0.129697889","St. Martin's Street, West End",433
"4246",2020,6,326,321,292,"51.53266186","-0.099981142","Graham Street, Angel",613
"4247",2020,6,327,76,58,"51.53095","-0.085603","New North Road 1, Hoxton",134
"4248",2020,6,328,99,92,"51.53114","-0.086016","New North Road 2, Hoxton",191
"4249",2020,6,329,152,136,"51.53589283","-0.160854428","Prince Albert Road, The Regent's Park",288
"4250",2020,6,330,330,296,"51.51641749","-0.179135079","Eastbourne Mews, Paddington",626
"4251",2020,6,331,423,431,"51.52085887","-0.089887855","Bunhill Row, Moorgate",854
"4252",2020,6,332,115,102,"51.49334336","-0.194757949","Nevern Place, Earl's Court",217
"4253",2020,6,333,228,159,"51.50860544","-0.193764092","Palace Gardens Terrace, Notting Hill",387
"4254",2020,6,334,232,225,"51.505044","-0.115851","Concert Hall Approach 1, South Bank",457
"4255",2020,6,335,247,338,"51.51196803","-0.120718759","Tavistock Street, Covent Garden",585
"4256",2020,6,336,134,204,"51.504942","-0.115533","Concert Hall Approach 2, South Bank",338
"4257",2020,6,337,155,104,"51.51108452","-0.197524944","Pembridge Villas, Notting Hill",259
"4258",2020,6,338,411,447,"51.51175646","-0.119643424","Wellington Street , Strand",858
"4259",2020,6,339,116,63,"51.5333196","-0.1117812","Risinghill Street, Angel",179
"4260",2020,6,340,473,489,"51.51444134","-0.087587447","Bank of England Museum, Bank",962
"4261",2020,6,341,603,589,"51.50810309","-0.12602103","Craven Street, Strand",1192
"4262",2020,6,343,140,111,"51.53692216","-0.150181444","London Zoo Car Park, The Regent's Park",251
"4263",2020,6,344,176,154,"51.528246","-0.10102611","Goswell Road (City Uni), Finsbury",330
"4264",2020,6,345,338,340,"51.48802358","-0.166878535","Flood Street, Chelsea",678
"4265",2020,6,347,230,251,"51.50013942","-0.113936001","Lower Marsh, Waterloo",481
"4266",2020,6,348,191,235,"51.51217033","-0.150481272","Grosvenor Square, Mayfair",426
"4267",2020,6,349,207,249,"51.51196","-0.142783033","St. George Street, Mayfair",456
"4268",2020,6,350,271,263,"51.5017154373867","-0.1798541843891","Queen's Gate, Kensington Gardens",534
"4269",2020,6,351,245,174,"51.529423","-0.097122","Macclesfield Rd, St Lukes",419
"4270",2020,6,352,165,172,"51.486965","-0.116625","Vauxhall Street, Vauxhall",337
"4271",2020,6,353,96,93,"51.49459148","-0.134234258","Greycoat Street , Westminster",189
"4272",2020,6,354,271,409,"51.506767","-0.123702","Northumberland Avenue, Strand",680
"4273",2020,6,355,20,11,NA,NA,NA,31
"4274",2020,6,356,329,319,"51.494412","-0.173881","South Kensington Station, South Kensington",648
"4275",2020,6,357,334,371,"51.520994","-0.139016","Howland Street, Fitzrovia",705
"4276",2020,6,358,278,266,"51.516226","-0.124826","High Holborn , Covent Garden",544
"4277",2020,6,359,146,162,"51.49782999","-0.135440826","Butler Place, Westminster",308
"4278",2020,6,360,376,408,"51.49675303","-0.138733562","Howick Place, Westminster",784
"4279",2020,6,361,620,393,"51.50391973","-0.11342629","Waterloo Station 2, Waterloo",1013
"4280",2020,6,362,230,172,"51.536264","-0.133952","Royal College Street, Camden Town",402
"4281",2020,6,363,45,35,"51.5291212008901","-0.171185284853","Lord's, St. John's Wood",80
"4282",2020,6,364,320,322,"51.519656","-0.132339","Alfred Place, Bloomsbury",642
"4283",2020,6,365,250,205,"51.530344","-0.100168","City Road, Angel",455
"4284",2020,6,366,110,150,"51.5109192966489","-0.1511263847351","Millennium Hotel, Mayfair",260
"4285",2020,6,367,135,122,"51.5173721","-0.1642075","Harrowby Street, Marylebone",257
"4286",2020,6,368,250,267,"51.50024195","-0.15934065","Harriet Street, Knightsbridge",517
"4287",2020,6,370,75,55,"51.520205","-0.174593","Paddington Green, Paddington",130
"4288",2020,6,371,117,102,"51.49775","-0.10988","King Edward Walk, Waterloo",219
"4289",2020,6,372,234,231,"51.515208","-0.117863","Sardinia Street, Holborn",465
"4290",2020,6,373,164,199,"51.49980661","-0.176415994","Prince Consort Road, Knightsbridge",363
"4291",2020,6,374,1321,1387,"51.50402794","-0.11386436","Waterloo Station 1, Waterloo",2708
"4292",2020,6,375,116,122,"51.50194596","-0.194392952","Kensington Town Hall, Kensington",238
"4293",2020,6,376,235,265,"51.49188409","-0.125674815","Millbank Tower, Pimlico",500
"4294",2020,6,377,146,153,"51.50535447","-0.113656543","Waterloo Bridge, South Bank",299
"4295",2020,6,378,91,141,"51.49559291","-0.179077626","Natural History Museum, South Kensington",232
"4296",2020,6,379,210,191,"51.51431171","-0.200838199","Turquoise Island, Notting Hill",401
"4297",2020,6,380,124,127,"51.50686435","-0.150666888","Stanhope Gate, Mayfair",251
"4298",2020,6,381,212,212,"51.51953043","-0.13577731","Charlotte Street, Fitzrovia",424
"4299",2020,6,382,93,117,"51.50935171","-0.14744969","Farm Street, Mayfair",210
"4300",2020,6,383,238,268,"51.51310333","-0.13121385","Frith Street, Soho",506
"4301",2020,6,384,107,108,"51.496481","-0.192404","Marloes Road, Kensington",215
"4302",2020,6,386,396,426,"51.51352755","-0.130110822","Moor Street, Soho",822
"4303",2020,6,387,223,212,"51.49369988","-0.121394101","Fire Brigade Pier, Vauxhall",435
"4304",2020,6,388,264,280,"51.51070161","-0.121723604","Southampton Street, Strand",544
"4305",2020,6,389,52,34,"51.51013066","-0.155757901","Upper Grosvenor Street, Mayfair",86
"4306",2020,6,390,90,107,"51.521776","-0.068856","Buxton Street 1, Shoreditch",197
"4307",2020,6,392,354,392,"51.49942855","-0.179702476","Imperial College, Knightsbridge",746
"4308",2020,6,393,372,347,"51.51733427","-0.103604248","Snow Hill, Farringdon",719
"4309",2020,6,394,113,88,"51.524826","-0.176268","Aberdeen Place, St. John's Wood",201
"4310",2020,6,395,262,288,"51.492462","-0.159919","Cadogan Gardens, Chelsea",550
"4311",2020,6,396,187,167,"51.51809","-0.163609","Shouldham Street, Marylebone",354
"4312",2020,6,397,241,214,"51.51348","-0.17977","Devonshire Terrace, Bayswater",455
"4313",2020,6,398,100,77,"51.502319","-0.200742","Holland Park, Kensington",177
"4314",2020,6,399,216,224,"51.52261762","-0.071653961","Brick Lane Market, Shoreditch",440
"4315",2020,6,401,239,210,"51.528187","-0.075375","Columbia Road, Shoreditch",449
"4316",2020,6,402,104,90,"51.52289229","-0.171681991","Penfold Street, Marylebone",194
"4317",2020,6,403,184,199,"51.51689296","-0.158249929","George Place Mews, Marylebone",383
"4318",2020,6,404,281,280,"51.50204238","-0.184400221","Palace Gate, Kensington Gardens",561
"4319",2020,6,405,396,382,"51.49418566","-0.18267094","Gloucester Road Station, South Kensington",778
"4320",2020,6,408,73,53,NA,NA,NA,126
"4321",2020,6,409,219,207,"51.493146","-0.099828","Strata, Elephant & Castle",426
"4322",2020,6,410,155,125,"51.519968","-0.169774","Edgware Road Station, Marylebone",280
"4323",2020,6,411,271,301,"51.49337264","-0.09968067","Walworth Road, Elephant & Castle",572
"4324",2020,6,412,123,104,"51.488105","-0.110121","Cleaver Street, Kennington",227
"4325",2020,6,419,160,133,"51.485821","-0.149004","Chelsea Bridge, Pimlico",293
"4326",2020,6,420,148,145,"51.504043","-0.105312","Southwark Station 1, Southwark",293
"4327",2020,6,421,319,322,"51.504044","-0.104778","Southwark Station 2, Southwark",641
"4328",2020,6,423,106,120,"51.49456127","-0.15393398","Eaton Square (South), Belgravia",226
"4329",2020,6,424,181,166,"51.490491","-0.149186","Ebury Bridge, Pimlico",347
"4330",2020,6,425,206,195,"51.533379","-0.139159","Harrington Square 2, Camden Town",401
"4331",2020,6,426,154,147,"51.493072","-0.129925","Vincent Street, Pimlico",301
"4332",2020,6,427,649,722,"51.51397065","-0.09294031","Cheapside, Bank",1371
"4333",2020,6,428,426,530,"51.499917","-0.174554","Exhibition Road, Knightsbridge",956
"4334",2020,6,430,124,131,"51.48902","-0.17524","South Parade, Chelsea",255
"4335",2020,6,431,122,109,"51.534474","-0.122203","Crinan Street, King's Cross",231
"4336",2020,6,432,409,420,"51.496957","-0.173894","Exhibition Road Museums, South Kensington",829
"4337",2020,6,433,362,318,"51.524564","-0.116279","Wren Street, Holborn",680
"4338",2020,6,435,188,166,"51.488852","-0.105593","Kennington Station, Kennington",354
"4339",2020,6,436,481,440,"51.51824","-0.11655","Red Lion Street, Holborn",921
"4340",2020,6,437,162,166,"51.488124","-0.120903","Vauxhall Walk, Vauxhall",328
"4341",2020,6,439,93,79,"51.5338","-0.118677","Killick Street, King's Cross",172
"4342",2020,6,440,132,123,"51.483145","-0.113134","Kennington Oval, Oval",255
"4343",2020,6,441,165,146,"51.495656","-0.114605","Sail Street, Vauxhall",311
"4344",2020,6,442,67,52,"51.510101","-0.211358","Walmer Road, Avondale",119
"4345",2020,6,443,215,189,"51.515256","-0.058641","Philpot Street, Whitechapel",404
"4346",2020,6,444,190,178,"51.52568","-0.055312","Bethnal Green Garden, Bethnal Green",368
"4347",2020,6,445,138,139,"51.52388","-0.065076","Cheshire Street, Bethnal Green",277
"4348",2020,6,446,257,273,"51.528936","-0.055894","York Hall, Bethnal Green",530
"4349",2020,6,447,32,47,"51.493381","-0.007542","Jubilee Crescent, Cubitt Town",79
"4350",2020,6,448,125,110,"51.50623","-0.02296","Fisherman's Walk West, Canary Wharf",235
"4351",2020,6,449,313,291,"51.511088","-0.057159","Shadwell Station, Shadwell",604
"4352",2020,6,450,171,139,"51.515975","-0.053177","Jubilee Street, Stepney",310
"4353",2020,6,451,193,170,"51.504719","-0.063531","Hermitage Court, Wapping",363
"4354",2020,6,452,161,167,"51.505697","-0.070542","St. Katharine's Way, Tower",328
"4355",2020,6,453,162,160,"51.508447","-0.055167","Garnet Street, Shadwell",322
"4356",2020,6,454,62,71,"51.487679","-0.021582","Napier Avenue, Millwall",133
"4357",2020,6,455,43,48,"51.49447","-0.014409","East Ferry Road, Cubitt Town",91
"4358",2020,6,456,102,128,"51.538071","-0.144664","Parkway, Camden Town",230
"4359",2020,6,457,234,208,"51.542138","-0.145393","Castlehaven Road, Camden Town",442
"4360",2020,6,458,225,216,"51.504749","-0.057544","Wapping Lane, Wapping",441
"4361",2020,6,459,171,163,"51.535179","-0.03338","Gunmakers Lane, Old Ford",334
"4362",2020,6,460,169,157,"51.516196","-0.029138","Burdett Road, Mile End",326
"4363",2020,6,461,123,101,"51.516","-0.038775","Aston Street, Stepney",224
"4364",2020,6,462,300,257,"51.541603","-0.138853","Bonny Street, Camden Town",557
"4365",2020,6,463,140,118,"51.534776","-0.071881","Thurtle Road, Haggerston",258
"4366",2020,6,464,64,44,"51.51417","-0.052099","St. Mary & St. Michael Church, Stepney",108
"4367",2020,6,465,258,247,"51.53558","-0.08249","Pitfield Street North,Hoxton",505
"4368",2020,6,466,206,146,"51.534464","-0.076341","Whiston Road, Haggerston",352
"4369",2020,6,467,100,84,"51.523538","-0.030556","Southern Grove, Bow",184
"4370",2020,6,468,42,45,"51.521564","-0.022694","Cantrell Road, Bow",87
"4371",2020,6,469,140,131,"51.513757","-0.020467","Lindfield Street, Poplar",271
"4372",2020,6,470,157,146,"51.530535","-0.025492","Mostyn Grove, Bow",303
"4373",2020,6,471,143,147,"51.533283","-0.028155","Hewison Street, Old Ford",290
"4374",2020,6,472,36,27,"51.529452","-0.027616","Malmesbury Road, Bow",63
"4375",2020,6,473,53,40,"51.496137","-0.019355","Millharbour, Millwall",93
"4376",2020,6,475,47,51,"51.499041","-0.020157","Lightermans Road, Millwall",98
"4377",2020,6,476,27,23,"51.489096","-0.009205","Stebondale Street, Cubitt Town",50
"4378",2020,6,477,67,81,"51.49109","-0.018716","Spindrift Avenue, Millwall",148
"4379",2020,6,478,297,288,"51.521889","-0.04667","Stepney Green Station, Stepney",585
"4380",2020,6,479,250,245,"51.527152","-0.058005","Pott Street, Bethnal Green",495
"4381",2020,6,480,337,328,"51.5128711","-0.0389866","Flamborough Street, Limehouse",665
"4382",2020,6,481,100,111,"51.487129","-0.009001","Saunders Ness Road, Cubitt Town",211
"4383",2020,6,483,188,179,"51.51328","-0.047784","Albert Gardens, Stepney",367
"4384",2020,6,484,73,64,"51.528828","-0.013258","Bromley High Street, Bow",137
"4385",2020,6,485,186,176,"51.531127","-0.048017","Old Ford Road, Bethnal Green",362
"4386",2020,6,486,303,267,"51.525645","-0.069543","Granby Street, Shoreditch",570
"4387",2020,6,488,211,196,"51.506946","-0.058681","Reardon Street, Wapping",407
"4388",2020,6,489,253,216,"51.513074","-0.064094","Christian Street, Whitechapel",469
"4389",2020,6,490,85,89,"51.508622","-0.065006","Pennington Street, Wapping",174
"4390",2020,6,491,318,295,"51.522507","-0.041378","Queen Mary's, Mile End",613
"4391",2020,6,492,298,277,"51.525501","-0.032267204","Maplin Street, Mile End",575
"4392",2020,6,494,3,5,"51.50196","-0.016251","South Quay East, Canary Wharf",8
"4393",2020,6,495,193,165,"51.528169","-0.018703","Bow Church Station, Bow",358
"4394",2020,6,496,117,99,"51.52512","-0.015578","Devons Road, Bow",216
"4395",2020,6,497,101,94,"51.526149","-0.027396845","Merchant Street, Bow",195
"4396",2020,6,498,151,141,"51.527058","-0.025296","Bow Road Station, Bow",292
"4397",2020,6,499,235,239,"51.519265","-0.021345","Furze Green, Bow",474
"4398",2020,6,500,259,262,"51.519806","-0.055731","Ansell House, Stepney",521
"4399",2020,6,501,125,125,"51.522561","-0.054883","Cephas Street, Bethnal Green",250
"4400",2020,6,502,103,101,"51.53341","-0.049591815","Bonner Gate, Victoria Park",204
"4401",2020,6,503,369,359,"51.520893","-0.051394","Cleveland Way, Stepney",728
"4402",2020,6,504,29,20,"51.496454","-0.009506","St. John's Park, Cubitt Town",49
"4403",2020,6,505,172,155,"51.520398","-0.026768","Ackroyd Drive, Bow",327
"4404",2020,6,506,207,242,"51.517475","-0.075855","Bell Lane, Liverpool Street",449
"4405",2020,6,507,120,99,"51.528692","-0.059091","Clarkson Street, Bethnal Green",219
"4406",2020,6,508,314,334,"51.519362","-0.074431","Fournier Street, Whitechapel",648
"4407",2020,6,509,222,240,"51.517842","-0.090075","Fore Street, Guildhall",462
"4408",2020,6,510,228,293,"51.509303","-0.025996","Westferry DLR, Limehouse",521
"4409",2020,6,511,250,216,"51.511066","-0.053558","Sutton Street, Shadwell",466
"4410",2020,6,512,392,326,"51.532091","-0.06142","Pritchard's Road, Bethnal Green",718
"4411",2020,6,513,154,146,"51.5142228","-0.055656","Watney Market, Stepney",300
"4412",2020,6,514,214,228,"51.516204","-0.155525","Portman Square, Marylebone",442
"4413",2020,6,515,76,69,"51.500088","-0.211316","Russell Gardens, Olympia",145
"4414",2020,6,516,98,95,"51.5112","-0.014438","Chrisp Street Market, Poplar",193
"4415",2020,6,517,158,142,"51.532513","-0.033085","Ford Road, Old Ford",300
"4416",2020,6,518,146,135,"51.528224","-0.037471","Antill Road, Mile End",281
"4417",2020,6,519,14,10,"51.518811","-0.011662","Teviot Street, Poplar",24
"4418",2020,6,520,203,172,"51.526041","-0.047218","Bancroft Road, Bethnal Green",375
"4419",2020,6,521,174,164,"51.534137","-0.037366","Driffield Road, Old Ford",338
"4420",2020,6,522,229,223,"51.525941","-0.036017","Clinton Road, Mile End",452
"4421",2020,6,523,25,27,"51.51549","-0.013475","Langdon Park, Poplar",52
"4422",2020,6,524,188,139,"51.511654","-0.179668","Lancaster Gate , Bayswater",327
"4423",2020,6,526,42,47,"51.503143","-0.008428","Lancaster Drive, Blackwall",89
"4424",2020,6,527,101,125,"51.503802","-0.215808","Hansard Mews, Holland Park",226
"4425",2020,6,528,93,108,"51.507326","-0.145827","Clarges Street, Mayfair",201
"4426",2020,6,529,148,154,"51.486892","-0.170983","Manresa Road, Chelsea",302
"4427",2020,6,530,53,57,"51.508896","-0.012413","Newby Place, Poplar",110
"4428",2020,6,531,224,189,"51.530326","-0.042744","Twig Folly Bridge, Mile End",413
"4429",2020,6,532,102,129,"51.50357","-0.020068","Jubilee Plaza, Canary Wharf",231
"4430",2020,6,533,212,195,"51.528222","-0.069743","Wellington Row, Bethnal Green",407
"4431",2020,6,534,276,211,"51.531864","-0.066035","Goldsmith's Row, Haggerston",487
"4432",2020,6,535,174,146,"51.537349","-0.147154","Gloucester Avenue, Camden Town",320
"4433",2020,6,536,96,82,"51.53385","-0.06992","Queensbridge Road, Haggerston",178
"4434",2020,6,537,244,244,"51.51793","-0.067937","Old Montague Street, Whitechapel",488
"4435",2020,6,538,61,65,"51.508981","-0.00699","Naval Row, Blackwall",126
"4436",2020,6,540,200,144,"51.528302","-0.144466","Albany Street, The Regent's Park",344
"4437",2020,6,541,482,504,"51.506613","-0.142844","Green Park Station, Mayfair",986
"4438",2020,6,542,165,141,"51.514115","-0.033828","Salmon Lane, Limehouse",306
"4439",2020,6,543,51,19,"51.509591","-0.204666","Lansdowne Walk, Ladbroke Grove",70
"4440",2020,6,544,175,174,"51.526153","-0.102208","Percival Street, Finsbury",349
"4441",2020,6,545,155,144,"51.539957","-0.145246","Arlington Road, Camden Town",299
"4442",2020,6,546,358,317,"51.517428","-0.107987","New Fetter Lane, Holborn",675
"4443",2020,6,547,50,51,"51.509474","-0.002275","East India DLR, Blackwall",101
"4444",2020,6,548,91,85,"51.498386","-0.107913","Westminster Bridge Road, Elephant & Castle",176
"4445",2020,6,549,158,127,"51.49605","-0.104193","Gaywood  Street, Elephant & Castle",285
"4446",2020,6,550,163,145,"51.521564","-0.039264","Harford Street, Mile End",308
"4447",2020,6,551,126,132,"51.505772","-0.016460175","Import Dock, Canary Wharf",258
"4448",2020,6,552,304,286,"51.511542","-0.056667","Watney Street, Shadwell",590
"4449",2020,6,553,576,520,"51.535678","-0.062546","Regent's Row , Haggerston",1096
"4450",2020,6,554,33,29,"51.513548","-0.005659","Aberfeldy Street, Poplar",62
"4451",2020,6,556,90,88,"51.502661","-0.021596","Heron Quays DLR, Canary Wharf",178
"4452",2020,6,557,157,158,"51.51601","-0.0985","King Edward Street, St Pauls",315
"4453",2020,6,558,383,376,"51.493978","-0.127554","Page Street, Westminster",759
"4454",2020,6,559,47,49,"51.501391","-0.205991","Abbotsbury Road, Holland Park",96
"4455",2020,6,560,68,27,"51.511624","-0.205921","Ladbroke Grove Central, Ladbroke Grove",95
"4456",2020,6,561,118,98,"51.518369","-0.043371","Rectory Square, Stepney",216
"4457",2020,6,562,212,212,"51.51746","-0.12335","Bury Place, Holborn",424
"4458",2020,6,563,55,47,"51.499286","-0.009152","Preston's Road, Cubitt Town",102
"4459",2020,6,564,389,487,"51.509943","-0.117619","Somerset House, Strand",876
"4460",2020,6,565,99,95,"51.521905","-0.063386","Selby Street, Whitechapel",194
"4461",2020,6,566,119,128,"51.509158","-0.224103","Westfield Ariel Way, White City",247
"4462",2020,6,568,258,257,"51.51616","-0.18697","Bishop's Bridge Road West, Bayswater",515
"4463",2020,6,569,205,159,"51.53213","-0.08299","Pitfield Street Central, Hoxton",364
"4464",2020,6,570,238,236,"51.503083","-0.017676","Upper Bank Street, Canary Wharf",474
"4465",2020,6,571,95,110,"51.506256","-0.218337","Westfield Southern Terrace ,Shepherd's Bush",205
"4466",2020,6,572,226,244,"51.539099","-0.141728","Greenland Road, Camden Town",470
"4467",2020,6,573,411,405,"51.485587","-0.18119","Limerston Street, West Chelsea",816
"4468",2020,6,574,524,426,"51.53356","-0.09315","Eagle Wharf Road, Hoxton",950
"4469",2020,6,576,63,53,"51.497304","-0.022793","Alpha Grove, Millwall",116
"4470",2020,6,577,209,201,"51.528869","-0.047548","Globe Town Market, Bethnal Green",410
"4471",2020,6,578,108,113,"51.527607","-0.057133","Hollybush Gardens, Bethnal Green",221
"4472",2020,6,579,438,583,"51.511246","-0.093051","Queen Street 2, Bank",1021
"4473",2020,6,580,173,178,"51.48692917","-0.102996299","Doddington Grove, Kennington",351
"4474",2020,6,581,283,295,"51.519167","-0.147983","New Cavendish Street, Marylebone",578
"4475",2020,6,583,280,347,"51.497622","-0.125978","Abingdon Green, Westminster",627
"4476",2020,6,584,179,159,"51.51244","-0.19096","Ilchester Gardens, Bayswater",338
"4477",2020,6,586,48,42,"51.490645","-0.014582","Mudchute DLR, Cubitt Town",90
"4478",2020,6,587,357,437,"51.50964","-0.08497","Monument Street, Monument",794
"4479",2020,6,588,124,117,"51.52959","-0.0801","Hoxton Street, Hoxton",241
"4480",2020,6,589,319,327,"51.487196","-0.179369","Drayton Gardens, West Chelsea",646
"4481",2020,6,590,64,33,"51.53256","-0.16862","Greenberry Street, St.John's Wood",97
"4482",2020,6,592,116,113,"51.5171","-0.18377","Bishop's Bridge Road East, Bayswater",229
"4483",2020,6,593,152,127,"51.531066","-0.11934","Northdown Street, King's Cross",279
"4484",2020,6,594,233,275,"51.513875","-0.117774","Kingsway Southbound, Strand",508
"4485",2020,6,595,256,256,"51.493267","-0.21985","Hammersmith Road, Hammersmith",512
"4486",2020,6,596,272,250,"51.472817","-0.199783","Parson's Green , Parson's Green",522
"4487",2020,6,597,133,133,"51.473471","-0.20782","Fulham Park Road, Fulham",266
"4488",2020,6,598,156,146,"51.494499","-0.228188","Southerton Road, Hammersmith",302
"4489",2020,6,599,87,81,"51.485743","-0.223616","Manbre Road, Hammersmith",168
"4490",2020,6,600,237,235,"51.481747","-0.124642","South Lambeth Road, Vauxhall",472
"4491",2020,6,601,121,156,"51.514767","-0.225787","BBC White City, White City",277
"4492",2020,6,602,204,177,"51.472993","-0.133972","Union Grove, Wandsworth Road",381
"4493",2020,6,603,123,163,"51.477839","-0.116493","Caldwell Street, Stockwell",286
"4494",2020,6,604,76,79,"51.538792","-0.138535","St Martins Close, Camden Town",155
"4495",2020,6,605,169,202,"51.520331","-0.163667","Seymour Place, Marylebone",371
"4496",2020,6,606,79,78,"51.504199","-0.210941","Addison Road, Holland Park",157
"4497",2020,6,607,66,84,"51.468814","-0.210279","Putney Bridge Station, Fulham",150
"4498",2020,6,608,20,24,"51.491093","-0.216493","Colet Gardens, Hammersmith",44
"4499",2020,6,609,66,48,"51.46512358","-0.157788279","Sugden Road, Clapham",114
"4500",2020,6,610,146,144,"51.48256792","-0.172078187","Danvers Street, West Chelsea",290
"4501",2020,6,611,93,74,"51.50646524","-0.208486599","Princedale Road , Holland Park",167
"4502",2020,6,612,158,147,"51.46925984","-0.141812513","Wandsworth Rd, Isley Court, Wandsworth Road",305
"4503",2020,6,613,335,329,"51.50403821","-0.217400093","Woodstock Grove, Shepherd's Bush",664
"4504",2020,6,614,84,75,"51.47817208","-0.144690541","Bradmead, Battersea Park",159
"4505",2020,6,615,161,159,"51.4768851","-0.215895601","Finlay Street, Fulham",320
"4506",2020,6,616,193,169,"51.48102131","-0.209973497","Aintree Street, Fulham",362
"4507",2020,6,617,100,101,"51.47107905","-0.207842908","Elysium Place, Fulham",201
"4508",2020,6,618,115,131,"51.47625965","-0.193254007","Eel Brook Common, Walham Green",246
"4509",2020,6,619,138,112,"51.4737636","-0.197010096","Irene Road, Parsons Green",250
"4510",2020,6,620,157,137,"51.47518024","-0.167160736","Surrey Lane, Battersea",294
"4511",2020,6,621,229,209,"51.46086446","-0.187427294","Wandsworth Town Station, Wandsworth",438
"4512",2020,6,622,194,189,"51.50748124","-0.205535908","Lansdowne Road, Ladbroke Grove",383
"4513",2020,6,623,62,70,"51.46193072","-0.180791784","Nantes Close, Wandsworth",132
"4514",2020,6,624,111,99,"51.4729184","-0.132102704","Courland Grove, Wandsworth Road",210
"4515",2020,6,625,256,215,"51.47761941","-0.149551631","Queen's Circus, Battersea Park",471
"4516",2020,6,626,197,195,"51.48438657","-0.20481514","Normand Park, West Kensington",392
"4517",2020,6,627,77,75,"51.4687905","-0.158230901","Holden Street, Battersea",152
"4518",2020,6,628,178,188,"51.46881971","-0.184318843","William Morris Way, Sands End",366
"4519",2020,6,629,41,43,"51.45995384","-0.190184054","Morie Street, Wandsworth",84
"4520",2020,6,630,89,71,"51.47073264","-0.126994068","Clarence Walk, Stockwell",160
"4521",2020,6,631,184,163,"51.4795017","-0.141770709","Battersea Park Road, Nine Elms",347
"4522",2020,6,632,118,109,"51.47053858","-0.163041605","Sheepcote Lane, Battersea",227
"4523",2020,6,633,174,172,"51.48959104","-0.209378594","Vereker Road, West Kensington",346
"4524",2020,6,634,106,109,"51.49434708","-0.215804559","Brook Green South, Brook Green",215
"4525",2020,6,635,188,177,"51.48606206","-0.214428378","Greyhound Road, Hammersmith",365
"4526",2020,6,636,189,169,"51.46706414","-0.193502076","South Park, Sands End",358
"4527",2020,6,637,56,37,"51.45787019","-0.174691623","Spencer Park, Wandsworth Common",93
"4528",2020,6,638,374,372,"51.46663393","-0.169821175","Falcon Road, Clapham Junction",746
"4529",2020,6,639,214,210,"51.48357068","-0.202038682","Coomer Place, West Kensington",424
"4530",2020,6,640,128,117,"51.47286577","-0.148059277","Silverthorne Road, Battersea",245
"4531",2020,6,641,104,106,"51.49824168","-0.117495865","Archbishop's Park, Waterloo",210
"4532",2020,6,642,71,60,"51.46916161","-0.174485792","Fawcett Close, Battersea",131
"4533",2020,6,643,119,106,"51.5190427","-0.204764421","All Saints' Road, Portobello",225
"4534",2020,6,644,184,175,"51.48373225","-0.223852256","Rainville Road, Hammersmith",359
"4535",2020,6,645,212,202,"51.50173215","-0.100292412","Great Suffolk Street, The Borough",414
"4536",2020,6,646,259,322,"51.49886563","-0.137424571","Buckingham Gate, Westminster",581
"4537",2020,6,647,134,121,"51.50035306","-0.217515071","Richmond Way, Shepherd's Bush",255
"4538",2020,6,648,91,73,"51.46904022","-0.19627483","Peterborough Road, Sands End",164
"4539",2020,6,649,164,167,"51.48180515","-0.18027465","World's End Place, West Chelsea",331
"4540",2020,6,650,127,123,"51.51687069","-0.213872396","St. Mark's Road, North Kensington",250
"4541",2020,6,651,136,103,"51.48089844","-0.183853573","Thorndike Close, West Chelsea",239
"4542",2020,6,652,53,52,"51.51148696","-0.218190203","Evesham Street, Avondale",105
"4543",2020,6,653,196,183,"51.47084722","-0.17070367","Simpson Street, Clapham Junction",379
"4544",2020,6,654,165,175,"51.48267821","-0.117661574","Ashmole Estate, Oval",340
"4545",2020,6,655,92,84,"51.48294452","-0.219346128","Crabtree Lane, Fulham",176
"4546",2020,6,656,88,69,"51.46841875","-0.199135704","Broomhouse Lane, Parsons Green",157
"4547",2020,6,657,93,90,"51.4996806","-0.221791552","Blythe Road West, Shepherd's Bush",183
"4548",2020,6,658,326,306,"51.47729232","-0.16478637","Ethelburga Estate, Battersea Park",632
"4549",2020,6,659,280,318,"51.511934","-0.10307894","Blackfriars Station, St. Paul's",598
"4550",2020,6,660,108,114,"51.49087074","-0.206029743","West Kensington Station, West Kensington",222
"4551",2020,6,661,282,274,"51.51632095","-0.202608612","All Saints Church, Portobello",556
"4552",2020,6,662,200,181,"51.48498496","-0.167919869","Phene Street, Chelsea",381
"4553",2020,6,663,110,105,"51.51323001","-0.211593602","Clarendon Road, Avondale",215
"4554",2020,6,664,172,170,"51.474376","-0.155442787","Austin Road, Battersea Park",342
"4555",2020,6,665,105,87,"51.46108367","-0.191722864","Smugglers Way, Wandsworth",192
"4556",2020,6,666,148,107,"51.49610093","-0.208158259","Olympia Way, Olympia",255
"4557",2020,6,667,140,137,"51.5015946","-0.222293381","Shepherd's Bush Road North, Shepherd's Bush",277
"4558",2020,6,668,193,203,"51.49422354","-0.236769936","Ravenscourt Park Station, Hammersmith",396
"4559",2020,6,669,82,66,"51.47614939","-0.1232585","Teversham Lane, Stockwell",148
"4560",2020,6,670,132,133,"51.46718562","-0.152248582","Ashley Crescent, Battersea",265
"4561",2020,6,671,388,352,"51.475089","-0.201968","Parsons Green Station, Parsons Green",740
"4562",2020,6,673,139,143,"51.46517078","-0.18038939","Hibbert Street, Battersea",282
"4563",2020,6,674,154,111,"51.53546778","-0.11619105","Carnegie Street, King's Cross",265
"4564",2020,6,675,107,91,"51.46348914","-0.182126248","Usk Road, Clapham Junction",198
"4565",2020,6,676,194,197,"51.47787084","-0.126874471","Hartington Road, Stockwell",391
"4566",2020,6,677,73,68,"51.46866929","-0.146544642","Heath Road, Battersea",141
"4567",2020,6,678,57,56,"51.46231278","-0.211468596","Esmond Street, Putney",113
"4568",2020,6,679,150,134,"51.47453545","-0.170210533","Orbel Street, Battersea",284
"4569",2020,6,680,315,275,"51.47768469","-0.170329317","Westbridge Road, Battersea",590
"4570",2020,6,681,133,139,"51.47303687","-0.214749808","Bishop's Avenue, Fulham",272
"4571",2020,6,682,233,233,"51.48810829","-0.22660621","Crisp Road, Hammersmith",466
"4572",2020,6,683,104,102,"51.46506424","-0.163750945","Dorothy Road, Clapham Junction",206
"4573",2020,6,684,105,109,"51.45475251","-0.195197203","Neville Gill Close, Wandsworth",214
"4574",2020,6,685,161,159,"51.46067005","-0.198735357","Osiers Road, Wandsworth",320
"4575",2020,6,686,172,153,"51.48814438","-0.222456468","Beryl Road, Hammersmith",325
"4576",2020,6,687,193,167,"51.49760804","-0.21145598","Maclise Road, Olympia",360
"4577",2020,6,688,66,52,"51.46095151","-0.20066766","Northfields, Wandsworth",118
"4578",2020,6,689,51,31,"51.45922541","-0.180884959","Spanish Road, Clapham Junction",82
"4579",2020,6,690,94,84,"51.47047503","-0.152130083","Stanley Grove, Battersea",178
"4580",2020,6,691,214,208,"51.47946386","-0.195777222","Erin Close, Walham Green",422
"4581",2020,6,692,219,203,"51.54211855","-0.028941601","Cadogan Close, Victoria Park",422
"4582",2020,6,693,102,103,"51.464786","-0.215618902","Felsham Road, Putney",205
"4583",2020,6,694,60,61,"51.46071722","-0.216526155","Putney Rail Station, Putney",121
"4584",2020,6,695,478,452,"51.53638435","-0.102757578","Islington Green, Angel",930
"4585",2020,6,696,182,178,"51.48728535","-0.217995921","Charing Cross Hospital, Hammersmith",360
"4586",2020,6,697,157,82,"51.53639219","-0.112721065","Charlotte Terrace, Angel",239
"4587",2020,6,698,169,134,"51.53908372","-0.070329419","Shoreditch Court, Haggerston",303
"4588",2020,6,699,133,93,"51.5366541","-0.07023031","Belford House, Haggerston",226
"4589",2020,6,700,146,106,"51.47696496","-0.174347066","Battersea Church Road, Battersea",252
"4590",2020,6,701,207,223,"51.47287627","-0.176267008","Vicarage Crescent, Battersea",430
"4591",2020,6,702,182,147,"51.52868155","-0.065550321","Durant Street, Bethnal Green",329
"4592",2020,6,703,333,422,"51.51505991","-0.10534448","St. Bride Street, Holborn",755
"4593",2020,6,704,51,46,"51.45682071","-0.202802098","Mexfield Road, East Putney",97
"4594",2020,6,705,52,65,NA,NA,NA,117
"4595",2020,6,706,287,291,"51.50215353","-0.083632928","Snowsfields, London Bridge",578
"4596",2020,6,707,321,306,"51.49021762","-0.215087092","Barons Court Station, West Kensington",627
"4597",2020,6,708,104,111,"51.46161068","-0.21614583","Disraeli Road, Putney",215
"4598",2020,6,709,73,75,"51.46321128","-0.215550761","Montserrat Road , Putney",148
"4599",2020,6,710,203,184,"51.47439218","-0.163347594","Albert Bridge Road, Battersea Park",387
"4600",2020,6,711,150,130,"51.48335692","-0.216305546","Everington Street, Fulham",280
"4601",2020,6,712,174,163,"51.51854104","-0.034903714","Mile End Stadium, Mile End",337
"4602",2020,6,713,82,68,"51.54100708","-0.14326094","Hawley Crescent, Camden Town",150
"4603",2020,6,714,83,78,"51.47311696","-0.137235175","Stewart's Road, Wandsworth Road",161
"4604",2020,6,715,118,112,"51.51563007","-0.049067243","Aylward Street, Stepney",230
"4605",2020,6,716,110,78,"51.51542791","-0.02356501","Stainsby Road , Poplar",188
"4606",2020,6,717,430,398,"51.53658514","-0.075885686","Dunston Road , Haggerston",828
"4607",2020,6,718,244,268,"51.53571683","-0.060291813","Ada Street, Hackney Central",512
"4608",2020,6,719,303,286,"51.53642464","-0.054162264","Victoria Park Road, Hackney Central",589
"4609",2020,6,720,129,131,"51.48724429","-0.205279052","Star Road, West Kensington",260
"4610",2020,6,721,120,116,"51.53603947","-0.026262677","Wendon Street, Old Ford",236
"4611",2020,6,722,167,160,"51.52458353","-0.058631453","Finnis Street, Bethnal Green",327
"4612",2020,6,723,227,217,"51.46822047","-0.190346493","Stephendale Road, Sands End",444
"4613",2020,6,724,57,49,"51.45799126","-0.184806157","Alma Road, Wandsworth",106
"4614",2020,6,725,203,202,"51.491327","-0.096518684","Walworth Square, Walworth",405
"4615",2020,6,726,149,133,"51.47505096","-0.150908371","Alfreda Street, Battersea Park",282
"4616",2020,6,727,182,163,"51.47569809","-0.20587627","Chesilton Road, Fulham",345
"4617",2020,6,728,66,65,"51.46199911","-0.206240805","Putney Bridge Road, East Putney",131
"4618",2020,6,729,259,253,"51.47893931","-0.208485293","St. Peter's Terrace, Fulham",512
"4619",2020,6,730,169,172,"51.49208492","-0.229116862","Bridge Avenue, Hammersmith",341
"4620",2020,6,731,139,135,"51.47727637","-0.189210466","Michael Road, Walham Green",274
"4621",2020,6,732,744,793,"51.50630441","-0.087262995","Duke Street Hill, London Bridge",1537
"4622",2020,6,733,133,146,"51.50542628","-0.150817316","Park Lane, Mayfair",279
"4623",2020,6,734,97,66,"51.46230566","-0.175407201","Plough Terrace, Clapham Junction",163
"4624",2020,6,735,229,222,"51.46489445","-0.17302926","Grant Road East, Clapham Junction",451
"4625",2020,6,736,39,40,"51.50659035","-0.216104479","Queensdale Road, Shepherd's Bush",79
"4626",2020,6,737,454,455,"51.47993289","-0.19411695","Fulham Broadway, Walham Green",909
"4627",2020,6,738,155,156,"51.47514228","-0.187278987","Imperial Road, Sands End",311
"4628",2020,6,739,146,129,"51.48176572","-0.185273723","Hortensia Road, West Brompton",275
"4629",2020,6,740,33,35,"51.51092871","-0.214594781","Sirdar Road, Avondale",68
"4630",2020,6,741,43,54,"51.5129814","-0.219486603","Freston Road, Avondale",97
"4631",2020,6,742,160,158,"51.51510818","-0.208565479","Blenheim Crescent, Ladbroke Grove",318
"4632",2020,6,743,20,34,"51.46079243","-0.212607684","Oxford Road, Putney",54
"4633",2020,6,744,46,38,"51.46745485","-0.172293499","Ingrave Street, Clapham Junction",84
"4634",2020,6,745,99,86,"51.47816972","-0.18243547","Upcerne Road, West Chelsea",185
"4635",2020,6,746,151,148,"51.4795738","-0.17903854","Lots Road, West Chelsea",299
"4636",2020,6,747,136,143,"51.48796408","-0.161765173","Ormonde Gate, Chelsea",279
"4637",2020,6,748,282,229,"51.53727795","-0.079201849","Hertford Road, De Beauvoir Town",511
"4638",2020,6,749,256,217,"51.53932857","-0.074284675","Haggerston Road, Haggerston",473
"4639",2020,6,750,50,53,"51.4710956","-0.157850096","Culvert Road, Battersea",103
"4640",2020,6,751,176,184,"51.51612862","-0.120909408","Newton Street, Covent Garden",360
"4641",2020,6,754,80,81,"51.5129006","-0.214762686","Grenfell Road, Avondale",161
"4642",2020,6,755,206,197,"51.48512191","-0.174971902","The Vale, Chelsea",403
"4643",2020,6,756,177,164,"51.47515398","-0.159169801","Prince of Wales Drive, Battersea Park",341
"4644",2020,6,757,179,168,"51.48795853","-0.187404506","Harcourt Terrace, West Brompton",347
"4645",2020,6,758,168,156,"51.51787005","-0.201005397","Westbourne Park Road, Portobello",324
"4646",2020,6,759,81,82,"51.52456169","-0.165668686","Broadley Terrace, Marylebone",163
"4647",2020,6,760,56,52,"51.52526975","-0.163795009","Rossmore Road, Marylebone",108
"4648",2020,6,761,176,143,"51.48321729","-0.211860644","Humbolt Road, Fulham",319
"4649",2020,6,762,534,620,"51.50070305","-0.129698963","Storey's Gate, Westminster",1154
"4650",2020,6,763,151,157,"51.52059714","-0.032566533","Mile End Park Leisure Centre, Mile End",308
"4651",2020,6,764,129,148,"51.46239255","-0.16829214","St. John's Road, Clapham Junction",277
"4652",2020,6,765,30,44,"51.46760141","-0.20682737","Ranelagh Gardens, Fulham",74
"4653",2020,6,766,196,205,"51.45752945","-0.192165613","Ram Street, Wandsworth",401
"4654",2020,6,767,27,19,"51.45705988","-0.200806304","Santos Road, Wandsworth",46
"4655",2020,6,768,134,114,"51.46134382","-0.159322467","Clapham Common North Side, Clapham Common",248
"4656",2020,6,769,182,173,"51.473611","-0.191803","Sandilands Road, Walham Green",355
"4657",2020,6,770,87,73,"51.491026","-0.209121","Gwendwr Road, West Kensington",160
"4658",2020,6,771,71,60,"51.509224","-0.216016","Rifle Place, Avondale",131
"4659",2020,6,772,326,344,"51.47250956","-0.122831913","Binfield Road, Stockwell",670
"4660",2020,6,773,373,389,"51.511891","-0.107349","Tallis Street, Temple",762
"4661",2020,6,774,87,74,"51.470131","-0.20464","Hurlingham Park, Parsons Green",161
"4662",2020,6,775,109,118,"51.496664","-0.223868","Little Brook Green, Brook Green",227
"4663",2020,6,776,94,101,"51.460333","-0.167029","Abyssinia Close, Clapham Junction",195
"4664",2020,6,777,45,27,"51.4619230679","-0.165297856693","Limburg Road, Clapham Junction",72
"4665",2020,6,779,260,279,"51.514449","-0.077178979","Houndsditch, Aldgate",539
"4666",2020,6,780,313,316,"51.474665","-0.18316517","Imperial Wharf Station, Sands End",629
"4667",2020,6,781,116,136,"51.495898","-0.173009","Victoria & Albert Museum, South Kensington",252
"4668",2020,6,782,187,185,"51.483911","-0.19760944","Halford Road, West Kensington",372
"4669",2020,6,783,252,231,"51.5403115","-0.021630359","Monier Road, Hackney Wick",483
"4670",2020,6,784,135,124,"51.546326","-0.00993526","East Village, Queen Elizabeth Olympic Park",259
"4671",2020,6,785,432,419,"51.54094","-0.010510565","Aquatic Centre, Queen Elizabeth Olympic Park",851
"4672",2020,6,786,90,90,"51.549369","-0.015717614","Lee Valley VeloPark, Queen Elizabeth Olympic Park",180
"4673",2020,6,787,84,84,"51.546805","-0.01469126","Timber Lodge, Queen Elizabeth Olympic Park",168
"4674",2020,6,789,100,118,"51.538718","-0.011889482","Podium, Queen Elizabeth Olympic Park",218
"4675",2020,6,790,194,190,"51.541793","-0.00481","Stratford Station, Stratford",384
"4676",2020,6,792,288,307,"51.505461","-0.10454093","Blackfriars Road, Southwark",595
"4677",2020,6,793,122,114,"51.528279","-0.11955857","Cromer Street, Bloomsbury",236
"4678",2020,6,794,11,4,NA,NA,NA,15
"4679",2020,6,795,165,143,"51.527068","-0.13186102","Euston Square Gardens, Euston",308
"4680",2020,6,796,187,188,"51.524","-0.12640984","Coram Street, Bloomsbury",375
"4681",2020,6,797,246,251,"51.5293","-0.12827903","Ossulston Street, Somers Town",497
"4682",2020,6,798,323,313,"51.5301998755","-0.122299440803","Birkenhead Street, King's Cross",636
"4683",2020,6,799,154,192,"51.4976984561","-0.137598896295","Kings Gate House, Westminster",346
"4684",2020,6,800,208,202,"51.4811219398","-0.149035374873","Sopwith Way, Battersea Park",410
"4685",2020,6,801,263,263,"51.5052241745","-0.0980318118664","Lavington Street, Bankside",526
"4686",2020,6,802,203,162,"51.4765900593","-0.118256789081","Albert Square, Stockwell",365
"4687",2020,6,803,205,202,"51.5054099403","-0.0983410884509","Southwark Street, Bankside",407
"4688",2020,6,804,349,366,"51.5346677396","-0.125078652873","Good's Way, King's Cross",715
"4689",2020,6,806,218,178,"51.5372405623","-0.124807385707","Handyside Street, King's Cross",396
"4690",2020,6,807,188,178,"51.5212","-0.20888818","Bevington Road West, North Kensington",366
"4691",2020,6,808,11,9,NA,NA,NA,20
"4692",2020,6,809,207,241,"51.5162778834","-0.118272991635","Lincoln's Inn Fields, Holborn",448
"4693",2020,6,810,323,330,"51.5067252868","-0.0988072461627","Tate Modern, Bankside",653
"4694",2020,6,811,238,281,"51.5057030357","-0.0277727426235","Westferry Circus, Canary Wharf",519
"4695",2020,6,812,54,65,"51.5487311915","-0.0226065549321","Here East North, Queen Elizabeth Olympic Park",119
"4696",2020,6,813,177,174,"51.4878074485","-0.122759625866","New Spring Gardens Walk, Vauxhall",351
"4697",2020,6,814,116,96,"51.4714330677","-0.123670735702","Clapham Road, Lingham Street, Stockwell",212
"4698",2020,6,815,425,405,"51.5000891978","-0.116628700672","Lambeth Palace Road, Waterloo",830
"4699",2020,6,816,66,75,"51.5465327935","-0.0205975904647","Here East South, Queen Elizabeth Olympic Park",141
"4700",2020,6,817,270,248,"51.4813354746","-0.138212295869","Riverlight South, Nine Elms",518
"4701",2020,6,818,432,454,"51.501513","-0.12382322","Westminster Pier, Westminster",886
"4702",2020,6,819,199,214,"51.50621","-0.114842","Belvedere Road 2, South Bank",413
"4703",2020,6,820,146,130,"51.492807","-0.091938","Victory Place, Walworth",276
"4704",2020,6,821,364,345,"51.4835074867","-0.147714557371","Battersea Power Station, Battersea Park",709
"4705",2020,6,826,484,523,"51.496863","-0.1429434","Allington Street, Victoria",1007
"4706",2020,6,827,227,218,"51.479601","-0.11147178","Cranmer Road, Stockwell",445
"4707",2020,6,828,151,131,"51.473874","-0.11258096","Normandy Road, Stockwell",282
"4708",2020,6,829,68,57,"51.469217","-0.11268674","Wynne Road, Stockwell",125
"4709",2020,6,830,100,106,"51.469202","-0.11902256","Sidney Road, Stockwell",206
"4710",2020,6,831,101,119,"51.466232","-0.11317995","St John's Crescent, Brixton",220
"4711",2020,6,832,155,164,"51.464019","-0.11578197","Ferndale Road, Brixton",319
"4712",2020,6,833,138,125,"51.460232","-0.11537509","Saltoun Road, Brixton",263
"4713",2020,6,834,169,171,"51.477966","-0.14785703","Gas Holders, Battersea Park",340
"4714",2020,6,835,179,175,"51.516785","-0.10494775","Farringdon Street, Holborn",354
"4715",2020,6,836,135,119,"51.541596","-0.12544145","York Way, Kings Cross",254
"4716",2020,6,838,186,207,"51.518093","-0.0914017","Fore Street Avenue, Guildhall",393
"4717",2020,6,839,367,408,"51.508033","-0.10682363","Sea Containers, South Bank",775
"4718",2020,7,1,134,102,"51.52916347","-0.109970527","River Street , Clerkenwell",236
"4719",2020,7,2,185,207,"51.49960695","-0.197574246","Phillimore Gardens, Kensington",392
"4720",2020,7,3,230,272,"51.52128377","-0.084605692","Christopher Street, Liverpool Street",502
"4721",2020,7,4,104,151,"51.53005939","-0.120973687","St. Chad's Street, King's Cross",255
"4722",2020,7,5,297,324,"51.49313","-0.156876","Sedding Street, Sloane Square",621
"4723",2020,7,6,210,227,"51.51811784","-0.144228881","Broadcasting House, Marylebone",437
"4724",2020,7,7,103,82,"51.53430039","-0.1680743","Charlbert Street, St. John's Wood",185
"4725",2020,7,8,136,122,"51.529857","-0.18348604","Maida Vale, Maida Vale",258
"4726",2020,7,9,221,220,"51.5073853","-0.096440751","New Globe Walk, Bankside",441
"4727",2020,7,10,84,92,"51.50597426","-0.092754157","Park Street, Bankside",176
"4728",2020,7,11,237,216,"51.52395143","-0.122502346","Brunswick Square, Bloomsbury",453
"4729",2020,7,12,441,472,"51.52168078","-0.130431727","Malet Street, Bloomsbury",913
"4730",2020,7,13,148,176,"51.51991453","-0.136039674","Scala Street, Fitzrovia",324
"4731",2020,7,14,1511,1448,"51.52994371","-0.123616824","Belgrove Street , King's Cross",2959
"4732",2020,7,15,235,230,"51.51772703","-0.127854211","Great Russell Street, Bloomsbury",465
"4733",2020,7,16,259,223,"51.52635795","-0.125979294","Cartwright Gardens , Bloomsbury",482
"4734",2020,7,17,387,380,"51.5216612","-0.109006325","Hatton Wall, Holborn",767
"4735",2020,7,18,357,372,"51.51477076","-0.12221963","Drury Lane, Covent Garden",729
"4736",2020,7,19,340,321,"51.52505093","-0.131161087","Taviton Street, Bloomsbury",661
"4737",2020,7,20,189,138,"51.527326","-0.13605286","Drummond Street , Euston",327
"4738",2020,7,21,69,52,"51.53007835","-0.13884627","Hampstead Road (Cartmel), Euston",121
"4739",2020,7,22,281,292,"51.5222641","-0.114079481","Northington Street , Holborn",573
"4740",2020,7,23,163,169,"51.51943538","-0.119123345","Red Lion Square, Holborn",332
"4741",2020,7,24,254,291,"51.51908011","-0.124678402","British Museum, Bloomsbury",545
"4742",2020,7,25,417,336,"51.5288338","-0.132250369","Doric Way , Somers Town",753
"4743",2020,7,26,177,151,"51.52728093","-0.11829517","Ampton Street , Clerkenwell",328
"4744",2020,7,27,293,313,"51.51382102","-0.107927706","Bouverie Street, Temple",606
"4745",2020,7,28,281,263,"51.52351808","-0.143613641","Bolsover Street, Fitzrovia",544
"4746",2020,7,29,151,138,"51.513735","-0.193487","Hereford Road, Bayswater",289
"4747",2020,7,30,207,185,"51.52915444","-0.093421615","Windsor Terrace, Hoxton",392
"4748",2020,7,31,227,208,"51.52953709","-0.083353323","Fanshaw Street, Hoxton",435
"4749",2020,7,32,367,412,"51.52469624","-0.084439283","Leonard Circus , Shoreditch",779
"4750",2020,7,33,192,203,"51.5156","-0.070056","Central House, Aldgate",395
"4751",2020,7,34,135,125,"51.5341235","-0.129386874","Pancras Road, King's Cross",260
"4752",2020,7,36,105,104,"51.50173726","-0.184980612","De Vere Gardens, Kensington",209
"4753",2020,7,37,189,168,"51.49159394","-0.192369256","Penywern Road, Earl's Court",357
"4754",2020,7,38,100,78,"51.4973875","-0.197245586","Abingdon Villas, Kensington",178
"4755",2020,7,39,398,419,"51.5263778","-0.078130921","Shoreditch High Street, Shoreditch",817
"4756",2020,7,40,147,151,"51.52127071","-0.0755789","Commercial Street, Shoreditch",298
"4757",2020,7,41,349,385,"51.520955","-0.083493552","Pindar Street, Liverpool Street",734
"4758",2020,7,42,222,156,"51.53099181","-0.093903825","Wenlock Road , Hoxton",378
"4759",2020,7,43,238,234,"51.52026","-0.157183945","Crawford Street, Marylebone",472
"4760",2020,7,44,144,149,"51.51073687","-0.144165239","Bruton Street, Mayfair",293
"4761",2020,7,45,391,327,"51.522511","-0.162298","Boston Place, Marylebone",718
"4762",2020,7,46,375,365,"51.507131","-0.06691","Nesham Street, Wapping",740
"4763",2020,7,47,170,163,"51.52334476","-0.183846408","Warwick Avenue Station, Maida Vale",333
"4764",2020,7,48,247,300,"51.51248445","-0.099141408","Godliman Street, St. Paul's",547
"4765",2020,7,49,114,160,"51.50706909","-0.145904427","Curzon Street, Mayfair",274
"4766",2020,7,50,182,174,"51.52867339","-0.087459376","East Road, Hoxton",356
"4767",2020,7,51,204,194,"51.52671796","-0.104298194","Finsbury Library , Finsbury",398
"4768",2020,7,52,184,202,"51.52295439","-0.094934859","Roscoe Street, St. Luke's",386
"4769",2020,7,53,70,123,"51.5099923","-0.143495266","Grafton Street, Mayfair",193
"4770",2020,7,54,207,220,"51.52174785","-0.094475072","Golden Lane, Barbican",427
"4771",2020,7,55,565,650,"51.51707521","-0.086685542","Finsbury Circus, Liverpool Street",1215
"4772",2020,7,56,177,195,"51.52058381","-0.154701411","Paddington Street, Marylebone",372
"4773",2020,7,57,265,272,"51.52334672","-0.120202614","Guilford Street , Bloomsbury",537
"4774",2020,7,58,296,301,"51.52452699","-0.079248081","New Inn Yard, Shoreditch",597
"4775",2020,7,60,74,57,"51.52644828","-0.172190727","Lisson Grove, St. John's Wood",131
"4776",2020,7,61,202,187,"51.49738251","-0.089446947","Great Dover Street, The Borough",389
"4777",2020,7,62,103,74,"51.4907579","-0.106323685","Cotton Garden Estate, Kennington",177
"4778",2020,7,63,114,97,"51.53089041","-0.089782579","Murray Grove , Hoxton",211
"4779",2020,7,64,397,467,"51.50946212","-0.124749274","William IV Street, Strand",864
"4780",2020,7,65,174,180,NA,NA,NA,354
"4781",2020,7,66,591,951,"51.51795029","-0.108657431","Holborn Circus, Holborn",1542
"4782",2020,7,67,359,289,"51.51882555","-0.108028472","Hatton Garden, Holborn",648
"4783",2020,7,68,324,313,"51.52059681","-0.116688468","Theobald's Road , Holborn",637
"4784",2020,7,69,178,195,"51.5262363","-0.134407652","Euston Road, Euston",373
"4785",2020,7,70,89,76,"51.53136059","-0.117069978","Calshot Street , King's Cross",165
"4786",2020,7,71,440,557,"51.5154186","-0.098850915","Newgate Street , St. Paul's",997
"4787",2020,7,72,198,200,"51.52352001","-0.108340165","Farringdon Lane, Clerkenwell",398
"4788",2020,7,73,437,458,"51.52572618","-0.088486188","Old Street Station, St. Luke's",895
"4789",2020,7,74,456,454,"51.48591714","-0.124469948","Vauxhall Cross, Vauxhall",910
"4790",2020,7,75,216,216,"51.53219984","-0.105480698","Torrens Street, Angel",432
"4791",2020,7,76,107,86,"51.52559505","-0.144083893","Longford Street, The Regent's Park",193
"4792",2020,7,77,222,219,"51.52341837","-0.124121774","Russell Square Station, Bloomsbury",441
"4793",2020,7,78,257,275,"51.52486887","-0.099489485","Sadlers Sports Centre, Finsbury",532
"4794",2020,7,79,140,186,"51.511726","-0.11385596","Arundel Street, Temple",326
"4795",2020,7,80,175,154,"51.50069361","-0.102091246","Webber Street , Southwark",329
"4796",2020,7,81,241,228,"51.52025302","-0.141327271","Great Titchfield Street, Fitzrovia",469
"4797",2020,7,82,145,172,"51.514274","-0.111257","Chancery Lane, Holborn",317
"4798",2020,7,83,182,216,"51.50963938","-0.131510949","Panton Street, West End",398
"4799",2020,7,84,230,234,"51.51593725","-0.111778348","Breams Buildings, Holborn",464
"4800",2020,7,85,233,241,"51.50064702","-0.078600401","Tanner Street, Bermondsey",474
"4801",2020,7,86,122,109,"51.48947903","-0.115156562","Sancroft Street, Vauxhall",231
"4802",2020,7,87,252,260,"51.51646835","-0.079684557","Devonshire Square, Liverpool Street",512
"4803",2020,7,88,327,355,"51.51858757","-0.132053392","Bayley Street , Bloomsbury",682
"4804",2020,7,89,186,170,"51.5262503","-0.123509611","Tavistock Place, Bloomsbury",356
"4805",2020,7,90,74,64,"51.53301907","-0.139174593","Harrington Square 1, Camden Town",138
"4806",2020,7,91,143,104,"51.49368637","-0.111014912","Walnut Tree Walk, Vauxhall",247
"4807",2020,7,92,154,178,"51.49889832","-0.100440521","Borough Road, Elephant & Castle",332
"4808",2020,7,93,220,109,"51.53440868","-0.109025404","Cloudesley Road, Angel",329
"4809",2020,7,94,277,250,"51.49506109","-0.085814489","Bricklayers Arms, Borough",527
"4810",2020,7,95,428,436,"51.5208417","-0.097340162","Aldersgate Street, Barbican",864
"4811",2020,7,96,173,166,"51.53095071","-0.078505384","Falkirk Street, Hoxton",339
"4812",2020,7,97,186,196,"51.49792478","-0.183834706","Gloucester Road (North), Kensington",382
"4813",2020,7,98,287,269,"51.52554222","-0.138231303","Hampstead Road, Euston",556
"4814",2020,7,99,261,264,"51.51457763","-0.158264483","Old Quebec Street, Marylebone",525
"4815",2020,7,100,130,118,"51.49043573","-0.122806861","Albert Embankment, Vauxhall",248
"4816",2020,7,101,609,627,"51.51155322","-0.0929401","Queen Street 1, Bank",1236
"4817",2020,7,102,214,231,"51.51340693","-0.076793375","Jewry Street, Aldgate",445
"4818",2020,7,103,78,69,"51.50472376","-0.192538767","Vicarage Gate, Kensington",147
"4819",2020,7,104,583,659,"51.51159481","-0.077121322","Crosswall, Tower",1242
"4820",2020,7,105,190,168,"51.51552971","-0.190240716","Westbourne Grove, Bayswater",358
"4821",2020,7,106,90,108,"51.51410514","-0.147301667","Woodstock Street, Mayfair",198
"4822",2020,7,107,412,440,"51.52600832","-0.096317627","Finsbury Leisure Centre, St. Luke's",852
"4823",2020,7,108,223,299,"51.49812559","-0.132102166","Abbey Orchard Street, Westminster",522
"4824",2020,7,109,473,523,"51.51563144","-0.132328837","Soho Square , Soho",996
"4825",2020,7,110,108,102,"51.53304322","-0.172528678","Wellington Road, St. John's Wood",210
"4826",2020,7,111,172,157,"51.5100172","-0.157275636","Park Lane , Hyde Park",329
"4827",2020,7,112,230,233,"51.51580998","-0.105270275","Stonecutter Street, Holborn",463
"4828",2020,7,113,125,146,"51.49646288","-0.183289032","Gloucester Road (Central), South Kensington",271
"4829",2020,7,114,176,180,"51.52451738","-0.158963647","Park Road (Baker Street), The Regent's Park",356
"4830",2020,7,115,325,381,"51.51423368","-0.073537654","Braham Street, Aldgate",706
"4831",2020,7,116,349,381,"51.51449962","-0.141423695","Little Argyll Street, West End",730
"4832",2020,7,117,210,199,"51.49288067","-0.114934001","Lollard Street, Vauxhall",409
"4833",2020,7,118,136,178,"51.49582705","-0.13547809","Rochester Row, Westminster",314
"4834",2020,7,119,356,380,"51.52589324","-0.090847761","Bath Street, St. Luke's",736
"4835",2020,7,120,192,196,"51.51573534","-0.093080779","The Guildhall, Guildhall",388
"4836",2020,7,121,238,226,"51.51891348","-0.156166631","Baker Street, Marylebone",464
"4837",2020,7,122,234,274,"51.52111369","-0.078869751","Norton Folgate, Liverpool Street",508
"4838",2020,7,123,126,117,"51.52836014","-0.104724625","St. John Street, Finsbury",243
"4839",2020,7,124,93,102,"51.49654462","-0.150905245","Eaton Square, Belgravia",195
"4840",2020,7,125,176,160,"51.50069491","-0.094524319","Borough High Street, The Borough",336
"4841",2020,7,126,340,342,"51.51782144","-0.096496865","Museum of London, Barbican",682
"4842",2020,7,127,204,183,"51.51700801","-0.09388536","Wood Street, Guildhall",387
"4843",2020,7,128,129,127,"51.49536226","-0.185296516","Emperor's Gate, South Kensington",256
"4844",2020,7,129,217,251,"51.5118973","-0.137043852","Golden Square, Soho",468
"4845",2020,7,130,253,300,"51.50950627","-0.075459482","Tower Gardens , Tower",553
"4846",2020,7,131,123,106,"51.53300545","-0.136792671","Eversholt Street , Camden Town",229
"4847",2020,7,132,591,563,"51.52364804","-0.074754872","Bethnal Green Road, Shoreditch",1154
"4848",2020,7,133,304,318,NA,NA,NA,622
"4849",2020,7,134,76,67,"51.504904","-0.06797","Wapping High Street, Wapping",143
"4850",2020,7,135,333,344,"51.52326004","-0.104708922","Clerkenwell Green, Clerkenwell",677
"4851",2020,7,136,325,341,"51.51196176","-0.097441687","Queen Victoria Street, St. Paul's",666
"4852",2020,7,138,175,182,"51.51227622","-0.157436972","Green Street, Mayfair",357
"4853",2020,7,139,141,144,"51.49488108","-0.117974901","Lambeth Road, Vauxhall",285
"4854",2020,7,140,337,392,"51.52096262","-0.085634242","Finsbury Square , Moorgate",729
"4855",2020,7,141,216,215,"51.51530805","-0.147203711","Chapel Place, Marylebone",431
"4856",2020,7,142,119,101,"51.49372451","-0.198286569","West Cromwell Road, Earl's Court",220
"4857",2020,7,143,130,158,"51.4968865","-0.161203828","Pont Street, Knightsbridge",288
"4858",2020,7,144,277,253,"51.48894022","-0.111435796","Kennington Cross, Kennington",530
"4859",2020,7,145,29,29,"51.50074359","-0.202759212","Ilchester Place, Kensington",58
"4860",2020,7,146,85,73,"51.48836528","-0.129361842","Vauxhall Bridge , Pimlico",158
"4861",2020,7,148,221,223,"51.49211134","-0.138364847","Tachbrook Street, Victoria",444
"4862",2020,7,149,159,160,"51.48478899","-0.110683213","Kennington Road Post Office, Oval",319
"4863",2020,7,150,80,144,"51.49705603","-0.168917077","Holy Trinity Brompton, Knightsbridge",224
"4864",2020,7,151,104,73,"51.51213691","-0.201554966","Chepstow Villas, Notting Hill",177
"4865",2020,7,152,184,159,"51.49217002","-0.101536865","Hampton Street, Walworth",343
"4866",2020,7,153,310,301,"51.511933","-0.174411","Bayswater Road, Hyde Park",611
"4867",2020,7,154,1442,1384,"51.50379168","-0.11282408","Waterloo Station 3, Waterloo",2826
"4868",2020,7,155,184,180,"51.49586666","-0.191933711","Lexham Gardens, Kensington",364
"4869",2020,7,156,115,125,"51.49443626","-0.092921165","New Kent Road, The Borough",240
"4870",2020,7,157,193,214,"51.50039792","-0.193068385","Wright's Lane, Kensington",407
"4871",2020,7,158,141,140,"51.49085368","-0.196170309","Trebovir Road, Earl's Court",281
"4872",2020,7,159,352,418,"51.51461995","-0.137841333","Great Marlborough Street, Soho",770
"4873",2020,7,160,175,206,"51.50663341","-0.131773845","Waterloo Place, St. James's",381
"4874",2020,7,162,212,229,"51.51760685","-0.121328408","Southampton Place, Holborn",441
"4875",2020,7,163,242,255,"51.4931848","-0.167894973","Sloane Avenue, Knightsbridge",497
"4876",2020,7,164,127,104,"51.515607","-0.183118788","Cleveland Gardens, Bayswater",231
"4877",2020,7,165,67,46,"51.517932","-0.183716959","Orsett Terrace, Bayswater",113
"4878",2020,7,166,169,163,"51.50185512","-0.159237081","Seville Street, Knightsbridge",332
"4879",2020,7,167,415,406,"51.49395092","-0.147624377","Eccleston Place, Victoria",821
"4880",2020,7,168,95,113,"51.50040123","-0.195455928","Argyll Road, Kensington",208
"4881",2020,7,169,206,190,"51.51474612","-0.165164288","Porchester Place, Paddington",396
"4882",2020,7,170,131,124,"51.52784273","-0.108068155","Hardwick Street, Clerkenwell",255
"4883",2020,7,171,143,145,"51.4916156","-0.186753859","Collingham Gardens, Earl's Court",288
"4884",2020,7,172,74,84,"51.49121192","-0.173715911","Sumner Place, South Kensington",158
"4885",2020,7,173,192,209,"51.50486","-0.113001","Waterloo Road, South Bank",401
"4886",2020,7,174,219,284,"51.512529","-0.115163","Strand, Strand",503
"4887",2020,7,175,274,313,"51.521668","-0.079608554","Worship Street, Shoreditch",587
"4888",2020,7,176,145,102,"51.51791921","-0.188098863","Gloucester Terrace, Bayswater",247
"4889",2020,7,177,342,417,"51.49616092","-0.140947636","Ashley Place, Victoria",759
"4890",2020,7,178,209,168,"51.48985626","-0.141923621","Warwick Square, Pimlico",377
"4891",2020,7,180,162,174,"51.5129118","-0.153645496","North Audley Street, Mayfair",336
"4892",2020,7,181,113,115,"51.49941247","-0.152317537","Belgrave Square, Belgravia",228
"4893",2020,7,182,183,173,"51.52202903","-0.165842551","Bell Street , Marylebone",356
"4894",2020,7,183,243,231,"51.482362","-0.13612398","Riverlight North, Nine Elms",474
"4895",2020,7,184,165,171,"51.52071513","-0.14521173","Portland Place, Marylebone",336
"4896",2020,7,185,223,193,"51.48805753","-0.140741432","Alderney Street, Pimlico",416
"4897",2020,7,186,536,475,"51.51733558","-0.175810943","South Wharf Road, Paddington",1011
"4898",2020,7,187,221,239,"51.49247977","-0.178433004","Queen's Gate (South), South Kensington",460
"4899",2020,7,188,91,81,"51.5165179","-0.164393768","Nutford Place, Marylebone",172
"4900",2020,7,189,140,68,"51.53166681","-0.109914711","Claremont Square, Angel",208
"4901",2020,7,190,200,175,"51.48997562","-0.132845681","Rampayne Street, Pimlico",375
"4902",2020,7,191,383,382,"51.50311799","-0.153520935","Hyde Park Corner, Hyde Park",765
"4903",2020,7,192,294,305,"51.51251523","-0.133201961","Wardour Street, Soho",599
"4904",2020,7,193,325,380,"51.50581776","-0.100186337","Bankside Mix, Bankside",705
"4905",2020,7,194,669,960,"51.50462759","-0.091773776","Hop Exchange, The Borough",1629
"4906",2020,7,195,228,206,"51.50724437","-0.106237501","Milroy Walk, South Bank",434
"4907",2020,7,196,228,225,"51.50368837","-0.098497684","Union Street, The Borough",453
"4908",2020,7,197,281,324,"51.50556905","-0.111606696","Stamford Street, South Bank",605
"4909",2020,7,199,459,507,"51.51048489","-0.082989638","Great Tower Street, Monument",966
"4910",2020,7,200,259,232,"51.51492456","-0.066078037","LMU Commercial Road, Whitechapel",491
"4911",2020,7,201,281,297,"51.5225965","-0.161113413","Dorset Square, Marylebone",578
"4912",2020,7,202,343,361,"51.51236389","-0.06954201","Leman Street, Aldgate",704
"4913",2020,7,203,313,315,"51.51821864","-0.100791005","West Smithfield Rotunda, Farringdon",628
"4914",2020,7,204,150,158,"51.52659961","-0.112432615","Margery Street, Clerkenwell",308
"4915",2020,7,206,239,245,"51.518154","-0.062697","New Road 1 , Whitechapel",484
"4916",2020,7,207,45,51,"51.50135267","-0.153194766","Grosvenor Crescent, Belgravia",96
"4917",2020,7,208,63,36,"51.52505151","-0.166304359","Mallory Street, Marylebone",99
"4918",2020,7,209,89,89,"51.49358391","-0.165101392","Denyer Street, Knightsbridge",178
"4919",2020,7,210,294,308,"51.51681444","-0.151926305","Hinde Street, Marylebone",602
"4920",2020,7,211,119,114,"51.49464523","-0.158105512","Cadogan Place, Knightsbridge",233
"4921",2020,7,212,56,34,"51.50658458","-0.199004026","Campden Hill Road, Notting Hill",90
"4922",2020,7,213,405,383,"51.50274025","-0.149569201","Wellington Arch, Hyde Park",788
"4923",2020,7,214,400,411,"51.52683806","-0.130504336","Endsleigh Gardens, Euston",811
"4924",2020,7,215,466,538,"51.51906932","-0.088285377","Moorfields, Moorgate",1004
"4925",2020,7,216,3,53,"51.49094565","-0.181190899","Old Brompton Road, South Kensington",56
"4926",2020,7,217,775,801,"51.51615461","-0.082422399","Wormwood Street, Liverpool Street",1576
"4927",2020,7,218,170,159,"51.48971651","-0.170194408","St. Luke's Church, Chelsea",329
"4928",2020,7,219,222,203,"51.49016361","-0.19039362","Bramham Gardens, Earl's Court",425
"4929",2020,7,220,108,121,"51.49066456","-0.166485083","Chelsea Green, Chelsea",229
"4930",2020,7,221,233,241,"51.49481649","-0.13045856","Horseferry Road, Westminster",474
"4931",2020,7,222,62,73,"51.50275704","-0.155349725","Knightsbridge, Hyde Park",135
"4932",2020,7,223,144,129,"51.49148474","-0.090220911","Rodney Road , Walworth",273
"4933",2020,7,224,178,169,"51.51031","-0.18740235","Queensway, Kensington Gardens",347
"4934",2020,7,225,325,248,"51.50935342","-0.196422","Notting Hill Gate Station, Notting Hill",573
"4935",2020,7,226,158,185,"51.50844614","-0.131961389","Charles II Street, West End",343
"4936",2020,7,227,185,179,"51.52891573","-0.115480888","Great Percy Street, Clerkenwell",364
"4937",2020,7,228,401,596,"51.50742485","-0.134621209","St. James's Square, St. James's",997
"4938",2020,7,229,362,393,"51.50654321","-0.123179697","Whitehall Place, Strand",755
"4939",2020,7,230,124,135,"51.50669284","-0.103137426","Poured Lines, Bankside",259
"4940",2020,7,231,215,216,"51.49396755","-0.17873226","Queen's Gate (Central), South Kensington",431
"4941",2020,7,232,111,112,"51.51501025","-0.112753217","Carey Street, Holborn",223
"4942",2020,7,233,218,262,"51.50777049","-0.130699733","Pall Mall East, West End",480
"4943",2020,7,234,199,196,"51.53450449","-0.106992706","Liverpool Road (N1 Centre), Angel",395
"4944",2020,7,235,136,99,"51.49571828","-0.110889274","Kennington Road  , Vauxhall",235
"4945",2020,7,236,116,132,"51.51838043","-0.073438925","Fashion Street, Whitechapel",248
"4946",2020,7,237,227,211,"51.5097860151","-0.0681619805156","Dock Street, Wapping",438
"4947",2020,7,238,77,36,"51.5233534","-0.175116099","Frampton Street, Paddington",113
"4948",2020,7,239,303,272,"51.52443845","-0.138019439","Warren Street Station, Euston",575
"4949",2020,7,240,93,101,"51.50545935","-0.10569204","Colombo Street, Southwark",194
"4950",2020,7,242,161,163,"51.52200801","-0.151359288","Beaumont Street, Marylebone",324
"4951",2020,7,243,208,186,"51.49096258","-0.139625122","Gloucester Street, Pimlico",394
"4952",2020,7,244,227,235,"51.51611887","-0.128585022","Earnshaw Street , Covent Garden",462
"4953",2020,7,245,107,79,"51.4853572","-0.142207481","Grosvenor Road, Pimlico",186
"4954",2020,7,246,313,365,"51.52285301","-0.099994052","Berry Street, Clerkenwell",678
"4955",2020,7,247,102,62,"51.530529","-0.167515","St. John's Wood Church, The Regent's Park",164
"4956",2020,7,248,246,242,"51.50645179","-0.170279555","Triangle Car Park, Hyde Park",488
"4957",2020,7,249,105,105,"51.49859784","-0.096191134","Harper Road, The Borough",210
"4958",2020,7,250,81,80,"51.489932","-0.162727","Royal Avenue 1, Chelsea",161
"4959",2020,7,251,538,710,"51.518908","-0.079249","Brushfield Street, Liverpool Street",1248
"4960",2020,7,252,325,341,"51.5046364","-0.116542278","Jubilee Gardens, South Bank",666
"4961",2020,7,253,254,221,"51.53404294","-0.086379717","Shoreditch Park, Hoxton",475
"4962",2020,7,254,232,189,"51.53051587","-0.106408455","Chadwell Street, Angel",421
"4963",2020,7,255,144,137,"51.52557531","-0.179592915","Clifton Road, Maida Vale",281
"4964",2020,7,256,137,150,"51.51362054","-0.116764211","Houghton Street, Strand",287
"4965",2020,7,257,112,102,"51.52248185","-0.154907218","Westminster University, Marylebone",214
"4966",2020,7,258,101,108,NA,NA,NA,209
"4967",2020,7,259,151,153,"51.490959","-0.1532331","Bourne Street, Belgravia",304
"4968",2020,7,260,220,237,"51.5136846","-0.135580879","Broadwick Street, Soho",457
"4969",2020,7,261,77,57,"51.5134891","-0.191351186","Princes Square, Bayswater",134
"4970",2020,7,262,119,125,"51.49874469","-0.103132904","LSBU (Borough Road), Elephant & Castle",244
"4971",2020,7,263,196,219,"51.51422502","-0.080660083","St. Mary Axe, Aldgate",415
"4972",2020,7,264,305,303,"51.52644342","-0.109256828","Tysoe Street, Clerkenwell",608
"4973",2020,7,265,162,137,"51.51595344","-0.169249375","Southwick Street, Paddington",299
"4974",2020,7,266,207,250,"51.50102668","-0.180246101","Queen's Gate (North), Kensington",457
"4975",2020,7,267,178,167,"51.49206037","-0.132224622","Regency Street, Westminster",345
"4976",2020,7,268,298,293,"51.49320445","-0.144132875","Belgrave Road, Victoria",591
"4977",2020,7,269,194,188,"51.50082346","-0.089740764","Empire Square, The Borough",382
"4978",2020,7,270,494,501,"51.4863434","-0.122492418","Kennington Lane Rail Bridge, Vauxhall",995
"4979",2020,7,271,63,43,"51.53583617","-0.156285395","London Zoo,  The Regent's Park",106
"4980",2020,7,272,442,456,"51.50144456","-0.110699309","Baylis Road, Waterloo",898
"4981",2020,7,273,209,282,"51.50613324","-0.114686385","Belvedere Road 1, South Bank",491
"4982",2020,7,274,136,113,"51.49671237","-0.20528437","Warwick Road, Olympia",249
"4983",2020,7,275,198,214,"51.52004497","-0.092176447","Barbican Centre, Barbican",412
"4984",2020,7,276,114,93,"51.50930161","-0.084985356","Lower Thames Street, Monument",207
"4985",2020,7,277,208,210,"51.50315739","-0.191496313","Kensington Church Street, Kensington",418
"4986",2020,7,278,505,506,"51.5034938","-0.07962099","Tooley Street, Bermondsey",1011
"4987",2020,7,279,255,242,"51.51862243","-0.176645823","North Wharf Road, Paddington",497
"4988",2020,7,280,142,152,"51.490083","-0.162418","Royal Avenue 2, Chelsea",294
"4989",2020,7,281,202,214,"51.49580589","-0.127575233","Smith Square, Westminster",416
"4990",2020,7,282,390,397,"51.51906446","-0.059642081","Royal London Hospital, Whitechapel",787
"4991",2020,7,283,65,64,"51.51440928","-0.118478757","Kingsway, Covent Garden",129
"4992",2020,7,284,119,138,"51.49914063","-0.112031483","Lambeth North Station, Waterloo",257
"4993",2020,7,286,120,49,"51.5272947","-0.174653609","St. John's Wood Road, St. John's Wood",169
"4994",2020,7,287,163,166,"51.52367314","-0.128377673","Bedford Way, Bloomsbury",329
"4995",2020,7,288,246,265,"51.49236962","-0.147478734","Elizabeth Bridge, Victoria",511
"4996",2020,7,289,57,73,"51.50923022","-0.151296092","South Audley Street, Mayfair",130
"4997",2020,7,290,209,180,"51.518268","-0.17110323","St Mary's Hospital, Paddington",389
"4998",2020,7,291,154,139,"51.48483991","-0.138089062","Claverton Street, Pimlico",293
"4999",2020,7,292,130,146,"51.49888404","-0.165471605","Montpelier Street, Knightsbridge",276
"5000",2020,7,293,102,100,"51.49815779","-0.209494128","Kensington Olympia Station, Olympia",202
"5001",2020,7,294,255,239,"51.488226","-0.135635511","St. George's Square, Pimlico",494
"5002",2020,7,295,185,193,"51.50029631","-0.092762704","Swan Street, The Borough",378
"5003",2020,7,296,130,113,"51.49363156","-0.190603326","Knaresborough Place, Earl's Court",243
"5004",2020,7,297,55,44,"51.49612799","-0.106000855","Geraldine Street, Elephant & Castle",99
"5005",2020,7,298,380,374,"51.50227992","-0.074189225","Curlew Street, Shad Thames",754
"5006",2020,7,299,79,103,"51.49398524","-0.136928582","Vincent Square, Westminster",182
"5007",2020,7,300,184,198,"51.505014","-0.17306032","Serpentine Car Park, Hyde Park",382
"5008",2020,7,301,234,260,"51.51475963","-0.148105415","Marylebone Lane, Marylebone",494
"5009",2020,7,302,98,91,"51.466907","-0.216573","Putney Pier, Wandsworth",189
"5010",2020,7,303,382,376,"51.50295379","-0.158456089","Albert Gate, Hyde Park",758
"5011",2020,7,306,179,185,"51.51816295","-0.135025698","Rathbone Street, Fitzrovia",364
"5012",2020,7,307,287,279,"51.50990837","-0.187842717","Black Lion Gate, Kensington Gardens",566
"5013",2020,7,308,157,146,"51.49907558","-0.085666316","Long Lane , Bermondsey",303
"5014",2020,7,309,115,125,"51.50963123","-0.119047563","Embankment (Savoy), Strand",240
"5015",2020,7,310,189,190,"51.4908679","-0.116911864","Black Prince Road, Vauxhall",379
"5016",2020,7,311,202,208,"51.51918144","-0.140485596","Foley Street, Fitzrovia",410
"5017",2020,7,312,132,105,"51.53088935","-0.176770502","Grove End Road, St. John's Wood",237
"5018",2020,7,313,234,255,"51.51734403","-0.138072691","Wells Street, Fitzrovia",489
"5019",2020,7,314,183,194,"51.50088934","-0.083159352","Tyers Gate, Bermondsey",377
"5020",2020,7,315,93,85,"51.52536703","-0.153463612","The Tennis Courts, The Regent's Park",178
"5021",2020,7,316,178,180,NA,NA,NA,358
"5022",2020,7,317,81,59,"51.49679128","-0.093913472","Dickens Square, Borough",140
"5023",2020,7,318,199,230,"51.51004801","-0.138846453","Sackville Street, Mayfair",429
"5024",2020,7,319,214,228,"51.52702563","-0.088542771","Baldwin Street, St. Luke's",442
"5025",2020,7,320,281,288,"51.49357351","-0.139956043","Queen Mother Sports Centre, Victoria",569
"5026",2020,7,321,294,280,"51.49785559","-0.081608045","Bermondsey Street, Bermondsey",574
"5027",2020,7,322,113,100,"51.526293","-0.073955","Palissy Street, Shoreditch",213
"5028",2020,7,323,153,167,"51.523196","-0.083067","Clifton Street, Shoreditch",320
"5029",2020,7,324,214,218,"51.49652013","-0.101384068","Ontario Street, Elephant & Castle",432
"5030",2020,7,325,127,150,"51.50908747","-0.129697889","St. Martin's Street, West End",277
"5031",2020,7,326,284,255,"51.53266186","-0.099981142","Graham Street, Angel",539
"5032",2020,7,327,64,42,"51.53095","-0.085603","New North Road 1, Hoxton",106
"5033",2020,7,328,60,46,"51.53114","-0.086016","New North Road 2, Hoxton",106
"5034",2020,7,329,120,100,"51.53589283","-0.160854428","Prince Albert Road, The Regent's Park",220
"5035",2020,7,330,266,235,"51.51641749","-0.179135079","Eastbourne Mews, Paddington",501
"5036",2020,7,331,322,370,"51.52085887","-0.089887855","Bunhill Row, Moorgate",692
"5037",2020,7,332,93,67,"51.49334336","-0.194757949","Nevern Place, Earl's Court",160
"5038",2020,7,333,178,125,"51.50860544","-0.193764092","Palace Gardens Terrace, Notting Hill",303
"5039",2020,7,334,172,170,"51.505044","-0.115851","Concert Hall Approach 1, South Bank",342
"5040",2020,7,335,210,271,"51.51196803","-0.120718759","Tavistock Street, Covent Garden",481
"5041",2020,7,336,140,255,"51.504942","-0.115533","Concert Hall Approach 2, South Bank",395
"5042",2020,7,337,75,65,"51.51108452","-0.197524944","Pembridge Villas, Notting Hill",140
"5043",2020,7,338,380,398,"51.51175646","-0.119643424","Wellington Street , Strand",778
"5044",2020,7,339,98,57,"51.5333196","-0.1117812","Risinghill Street, Angel",155
"5045",2020,7,340,419,448,"51.51444134","-0.087587447","Bank of England Museum, Bank",867
"5046",2020,7,341,473,505,"51.50810309","-0.12602103","Craven Street, Strand",978
"5047",2020,7,343,96,75,"51.53692216","-0.150181444","London Zoo Car Park, The Regent's Park",171
"5048",2020,7,344,128,122,"51.528246","-0.10102611","Goswell Road (City Uni), Finsbury",250
"5049",2020,7,345,312,331,"51.48802358","-0.166878535","Flood Street, Chelsea",643
"5050",2020,7,347,168,180,"51.50013942","-0.113936001","Lower Marsh, Waterloo",348
"5051",2020,7,348,123,172,"51.51217033","-0.150481272","Grosvenor Square, Mayfair",295
"5052",2020,7,349,132,158,"51.51196","-0.142783033","St. George Street, Mayfair",290
"5053",2020,7,350,167,169,"51.5017154373867","-0.1798541843891","Queen's Gate, Kensington Gardens",336
"5054",2020,7,351,220,156,"51.529423","-0.097122","Macclesfield Rd, St Lukes",376
"5055",2020,7,352,174,179,"51.486965","-0.116625","Vauxhall Street, Vauxhall",353
"5056",2020,7,353,87,88,"51.49459148","-0.134234258","Greycoat Street , Westminster",175
"5057",2020,7,354,231,311,"51.506767","-0.123702","Northumberland Avenue, Strand",542
"5058",2020,7,356,355,361,"51.494412","-0.173881","South Kensington Station, South Kensington",716
"5059",2020,7,357,305,327,"51.520994","-0.139016","Howland Street, Fitzrovia",632
"5060",2020,7,358,209,235,"51.516226","-0.124826","High Holborn , Covent Garden",444
"5061",2020,7,359,131,128,"51.49782999","-0.135440826","Butler Place, Westminster",259
"5062",2020,7,360,301,375,"51.49675303","-0.138733562","Howick Place, Westminster",676
"5063",2020,7,361,708,481,"51.50391973","-0.11342629","Waterloo Station 2, Waterloo",1189
"5064",2020,7,362,180,156,"51.536264","-0.133952","Royal College Street, Camden Town",336
"5065",2020,7,363,42,27,"51.5291212008901","-0.171185284853","Lord's, St. John's Wood",69
"5066",2020,7,364,274,299,"51.519656","-0.132339","Alfred Place, Bloomsbury",573
"5067",2020,7,365,199,149,"51.530344","-0.100168","City Road, Angel",348
"5068",2020,7,366,83,106,"51.5109192966489","-0.1511263847351","Millennium Hotel, Mayfair",189
"5069",2020,7,367,109,100,"51.5173721","-0.1642075","Harrowby Street, Marylebone",209
"5070",2020,7,368,206,209,"51.50024195","-0.15934065","Harriet Street, Knightsbridge",415
"5071",2020,7,370,42,27,"51.520205","-0.174593","Paddington Green, Paddington",69
"5072",2020,7,371,99,86,"51.49775","-0.10988","King Edward Walk, Waterloo",185
"5073",2020,7,372,195,213,"51.515208","-0.117863","Sardinia Street, Holborn",408
"5074",2020,7,373,172,157,"51.49980661","-0.176415994","Prince Consort Road, Knightsbridge",329
"5075",2020,7,374,1319,1321,"51.50402794","-0.11386436","Waterloo Station 1, Waterloo",2640
"5076",2020,7,375,92,84,"51.50194596","-0.194392952","Kensington Town Hall, Kensington",176
"5077",2020,7,376,210,232,"51.49188409","-0.125674815","Millbank Tower, Pimlico",442
"5078",2020,7,377,118,114,"51.50535447","-0.113656543","Waterloo Bridge, South Bank",232
"5079",2020,7,378,97,175,"51.49559291","-0.179077626","Natural History Museum, South Kensington",272
"5080",2020,7,379,165,153,"51.51431171","-0.200838199","Turquoise Island, Notting Hill",318
"5081",2020,7,380,110,112,"51.50686435","-0.150666888","Stanhope Gate, Mayfair",222
"5082",2020,7,381,212,213,"51.51953043","-0.13577731","Charlotte Street, Fitzrovia",425
"5083",2020,7,382,96,118,"51.50935171","-0.14744969","Farm Street, Mayfair",214
"5084",2020,7,383,219,232,"51.51310333","-0.13121385","Frith Street, Soho",451
"5085",2020,7,384,74,73,"51.496481","-0.192404","Marloes Road, Kensington",147
"5086",2020,7,386,318,346,"51.51352755","-0.130110822","Moor Street, Soho",664
"5087",2020,7,387,179,180,"51.49369988","-0.121394101","Fire Brigade Pier, Vauxhall",359
"5088",2020,7,388,234,248,"51.51070161","-0.121723604","Southampton Street, Strand",482
"5089",2020,7,389,30,19,"51.51013066","-0.155757901","Upper Grosvenor Street, Mayfair",49
"5090",2020,7,390,82,83,"51.521776","-0.068856","Buxton Street 1, Shoreditch",165
"5091",2020,7,392,299,325,"51.49942855","-0.179702476","Imperial College, Knightsbridge",624
"5092",2020,7,393,336,339,"51.51733427","-0.103604248","Snow Hill, Farringdon",675
"5093",2020,7,394,103,71,"51.524826","-0.176268","Aberdeen Place, St. John's Wood",174
"5094",2020,7,395,219,241,"51.492462","-0.159919","Cadogan Gardens, Chelsea",460
"5095",2020,7,396,140,141,"51.51809","-0.163609","Shouldham Street, Marylebone",281
"5096",2020,7,397,231,189,"51.51348","-0.17977","Devonshire Terrace, Bayswater",420
"5097",2020,7,398,57,31,"51.502319","-0.200742","Holland Park, Kensington",88
"5098",2020,7,399,167,170,"51.52261762","-0.071653961","Brick Lane Market, Shoreditch",337
"5099",2020,7,401,200,164,"51.528187","-0.075375","Columbia Road, Shoreditch",364
"5100",2020,7,402,88,76,"51.52289229","-0.171681991","Penfold Street, Marylebone",164
"5101",2020,7,403,171,180,"51.51689296","-0.158249929","George Place Mews, Marylebone",351
"5102",2020,7,404,201,191,"51.50204238","-0.184400221","Palace Gate, Kensington Gardens",392
"5103",2020,7,405,348,346,"51.49418566","-0.18267094","Gloucester Road Station, South Kensington",694
"5104",2020,7,408,46,46,NA,NA,NA,92
"5105",2020,7,409,202,198,"51.493146","-0.099828","Strata, Elephant & Castle",400
"5106",2020,7,410,117,121,"51.519968","-0.169774","Edgware Road Station, Marylebone",238
"5107",2020,7,411,236,241,"51.49337264","-0.09968067","Walworth Road, Elephant & Castle",477
"5108",2020,7,412,103,98,"51.488105","-0.110121","Cleaver Street, Kennington",201
"5109",2020,7,419,131,115,"51.485821","-0.149004","Chelsea Bridge, Pimlico",246
"5110",2020,7,420,118,127,"51.504043","-0.105312","Southwark Station 1, Southwark",245
"5111",2020,7,421,303,297,"51.504044","-0.104778","Southwark Station 2, Southwark",600
"5112",2020,7,423,86,113,"51.49456127","-0.15393398","Eaton Square (South), Belgravia",199
"5113",2020,7,424,146,123,"51.490491","-0.149186","Ebury Bridge, Pimlico",269
"5114",2020,7,425,184,156,"51.533379","-0.139159","Harrington Square 2, Camden Town",340
"5115",2020,7,426,130,136,"51.493072","-0.129925","Vincent Street, Pimlico",266
"5116",2020,7,427,619,680,"51.51397065","-0.09294031","Cheapside, Bank",1299
"5117",2020,7,428,407,466,"51.499917","-0.174554","Exhibition Road, Knightsbridge",873
"5118",2020,7,430,92,94,"51.48902","-0.17524","South Parade, Chelsea",186
"5119",2020,7,431,78,97,"51.534474","-0.122203","Crinan Street, King's Cross",175
"5120",2020,7,432,255,283,"51.496957","-0.173894","Exhibition Road Museums, South Kensington",538
"5121",2020,7,433,337,309,"51.524564","-0.116279","Wren Street, Holborn",646
"5122",2020,7,435,147,146,"51.488852","-0.105593","Kennington Station, Kennington",293
"5123",2020,7,436,402,380,"51.51824","-0.11655","Red Lion Street, Holborn",782
"5124",2020,7,437,159,150,"51.488124","-0.120903","Vauxhall Walk, Vauxhall",309
"5125",2020,7,439,92,71,"51.5338","-0.118677","Killick Street, King's Cross",163
"5126",2020,7,440,135,128,"51.483145","-0.113134","Kennington Oval, Oval",263
"5127",2020,7,441,164,138,"51.495656","-0.114605","Sail Street, Vauxhall",302
"5128",2020,7,442,52,44,"51.510101","-0.211358","Walmer Road, Avondale",96
"5129",2020,7,443,198,169,"51.515256","-0.058641","Philpot Street, Whitechapel",367
"5130",2020,7,444,175,176,"51.52568","-0.055312","Bethnal Green Garden, Bethnal Green",351
"5131",2020,7,445,107,94,"51.52388","-0.065076","Cheshire Street, Bethnal Green",201
"5132",2020,7,446,239,220,"51.528936","-0.055894","York Hall, Bethnal Green",459
"5133",2020,7,447,31,31,"51.493381","-0.007542","Jubilee Crescent, Cubitt Town",62
"5134",2020,7,448,126,124,"51.50623","-0.02296","Fisherman's Walk West, Canary Wharf",250
"5135",2020,7,449,226,233,"51.511088","-0.057159","Shadwell Station, Shadwell",459
"5136",2020,7,450,163,129,"51.515975","-0.053177","Jubilee Street, Stepney",292
"5137",2020,7,451,138,126,"51.504719","-0.063531","Hermitage Court, Wapping",264
"5138",2020,7,452,142,136,"51.505697","-0.070542","St. Katharine's Way, Tower",278
"5139",2020,7,453,140,123,"51.508447","-0.055167","Garnet Street, Shadwell",263
"5140",2020,7,454,34,38,"51.487679","-0.021582","Napier Avenue, Millwall",72
"5141",2020,7,455,30,28,"51.49447","-0.014409","East Ferry Road, Cubitt Town",58
"5142",2020,7,456,68,92,"51.538071","-0.144664","Parkway, Camden Town",160
"5143",2020,7,457,153,138,"51.542138","-0.145393","Castlehaven Road, Camden Town",291
"5144",2020,7,458,167,176,"51.504749","-0.057544","Wapping Lane, Wapping",343
"5145",2020,7,459,126,113,"51.535179","-0.03338","Gunmakers Lane, Old Ford",239
"5146",2020,7,460,117,125,"51.516196","-0.029138","Burdett Road, Mile End",242
"5147",2020,7,461,96,83,"51.516","-0.038775","Aston Street, Stepney",179
"5148",2020,7,462,244,183,"51.541603","-0.138853","Bonny Street, Camden Town",427
"5149",2020,7,463,108,71,"51.534776","-0.071881","Thurtle Road, Haggerston",179
"5150",2020,7,464,53,55,"51.51417","-0.052099","St. Mary & St. Michael Church, Stepney",108
"5151",2020,7,465,277,218,"51.53558","-0.08249","Pitfield Street North,Hoxton",495
"5152",2020,7,466,150,110,"51.534464","-0.076341","Whiston Road, Haggerston",260
"5153",2020,7,467,90,71,"51.523538","-0.030556","Southern Grove, Bow",161
"5154",2020,7,468,45,44,"51.521564","-0.022694","Cantrell Road, Bow",89
"5155",2020,7,469,121,128,"51.513757","-0.020467","Lindfield Street, Poplar",249
"5156",2020,7,470,136,127,"51.530535","-0.025492","Mostyn Grove, Bow",263
"5157",2020,7,471,137,138,"51.533283","-0.028155","Hewison Street, Old Ford",275
"5158",2020,7,472,30,20,"51.529452","-0.027616","Malmesbury Road, Bow",50
"5159",2020,7,473,45,40,"51.496137","-0.019355","Millharbour, Millwall",85
"5160",2020,7,475,44,39,"51.499041","-0.020157","Lightermans Road, Millwall",83
"5161",2020,7,476,10,22,"51.489096","-0.009205","Stebondale Street, Cubitt Town",32
"5162",2020,7,477,47,51,"51.49109","-0.018716","Spindrift Avenue, Millwall",98
"5163",2020,7,478,267,262,"51.521889","-0.04667","Stepney Green Station, Stepney",529
"5164",2020,7,479,214,216,"51.527152","-0.058005","Pott Street, Bethnal Green",430
"5165",2020,7,480,288,281,"51.5128711","-0.0389866","Flamborough Street, Limehouse",569
"5166",2020,7,481,68,71,"51.487129","-0.009001","Saunders Ness Road, Cubitt Town",139
"5167",2020,7,483,154,135,"51.51328","-0.047784","Albert Gardens, Stepney",289
"5168",2020,7,484,60,60,"51.528828","-0.013258","Bromley High Street, Bow",120
"5169",2020,7,485,117,109,"51.531127","-0.048017","Old Ford Road, Bethnal Green",226
"5170",2020,7,486,269,228,"51.525645","-0.069543","Granby Street, Shoreditch",497
"5171",2020,7,488,156,137,"51.506946","-0.058681","Reardon Street, Wapping",293
"5172",2020,7,489,212,179,"51.513074","-0.064094","Christian Street, Whitechapel",391
"5173",2020,7,490,76,73,"51.508622","-0.065006","Pennington Street, Wapping",149
"5174",2020,7,491,287,286,"51.522507","-0.041378","Queen Mary's, Mile End",573
"5175",2020,7,492,224,225,"51.525501","-0.032267204","Maplin Street, Mile End",449
"5176",2020,7,494,2,2,"51.50196","-0.016251","South Quay East, Canary Wharf",4
"5177",2020,7,495,136,130,"51.528169","-0.018703","Bow Church Station, Bow",266
"5178",2020,7,496,63,63,"51.52512","-0.015578","Devons Road, Bow",126
"5179",2020,7,497,77,66,"51.526149","-0.027396845","Merchant Street, Bow",143
"5180",2020,7,498,143,135,"51.527058","-0.025296","Bow Road Station, Bow",278
"5181",2020,7,499,169,172,"51.519265","-0.021345","Furze Green, Bow",341
"5182",2020,7,500,249,210,"51.519806","-0.055731","Ansell House, Stepney",459
"5183",2020,7,501,111,108,"51.522561","-0.054883","Cephas Street, Bethnal Green",219
"5184",2020,7,502,137,130,"51.53341","-0.049591815","Bonner Gate, Victoria Park",267
"5185",2020,7,503,271,271,"51.520893","-0.051394","Cleveland Way, Stepney",542
"5186",2020,7,504,6,9,"51.496454","-0.009506","St. John's Park, Cubitt Town",15
"5187",2020,7,505,121,106,"51.520398","-0.026768","Ackroyd Drive, Bow",227
"5188",2020,7,506,149,199,"51.517475","-0.075855","Bell Lane, Liverpool Street",348
"5189",2020,7,507,92,50,"51.528692","-0.059091","Clarkson Street, Bethnal Green",142
"5190",2020,7,508,226,237,"51.519362","-0.074431","Fournier Street, Whitechapel",463
"5191",2020,7,509,197,221,"51.517842","-0.090075","Fore Street, Guildhall",418
"5192",2020,7,510,243,251,"51.509303","-0.025996","Westferry DLR, Limehouse",494
"5193",2020,7,511,193,176,"51.511066","-0.053558","Sutton Street, Shadwell",369
"5194",2020,7,512,324,329,"51.532091","-0.06142","Pritchard's Road, Bethnal Green",653
"5195",2020,7,513,135,137,"51.5142228","-0.055656","Watney Market, Stepney",272
"5196",2020,7,514,150,171,"51.516204","-0.155525","Portman Square, Marylebone",321
"5197",2020,7,515,72,60,"51.500088","-0.211316","Russell Gardens, Olympia",132
"5198",2020,7,516,85,81,"51.5112","-0.014438","Chrisp Street Market, Poplar",166
"5199",2020,7,517,126,118,"51.532513","-0.033085","Ford Road, Old Ford",244
"5200",2020,7,518,129,119,"51.528224","-0.037471","Antill Road, Mile End",248
"5201",2020,7,519,13,14,"51.518811","-0.011662","Teviot Street, Poplar",27
"5202",2020,7,520,148,126,"51.526041","-0.047218","Bancroft Road, Bethnal Green",274
"5203",2020,7,521,121,105,"51.534137","-0.037366","Driffield Road, Old Ford",226
"5204",2020,7,522,188,181,"51.525941","-0.036017","Clinton Road, Mile End",369
"5205",2020,7,523,21,22,"51.51549","-0.013475","Langdon Park, Poplar",43
"5206",2020,7,524,156,117,"51.511654","-0.179668","Lancaster Gate , Bayswater",273
"5207",2020,7,526,25,30,"51.503143","-0.008428","Lancaster Drive, Blackwall",55
"5208",2020,7,527,91,91,"51.503802","-0.215808","Hansard Mews, Holland Park",182
"5209",2020,7,528,77,108,"51.507326","-0.145827","Clarges Street, Mayfair",185
"5210",2020,7,529,122,118,"51.486892","-0.170983","Manresa Road, Chelsea",240
"5211",2020,7,530,37,33,"51.508896","-0.012413","Newby Place, Poplar",70
"5212",2020,7,531,173,164,"51.530326","-0.042744","Twig Folly Bridge, Mile End",337
"5213",2020,7,532,145,114,"51.50357","-0.020068","Jubilee Plaza, Canary Wharf",259
"5214",2020,7,533,172,149,"51.528222","-0.069743","Wellington Row, Bethnal Green",321
"5215",2020,7,534,194,159,"51.531864","-0.066035","Goldsmith's Row, Haggerston",353
"5216",2020,7,535,167,136,"51.537349","-0.147154","Gloucester Avenue, Camden Town",303
"5217",2020,7,536,122,70,"51.53385","-0.06992","Queensbridge Road, Haggerston",192
"5218",2020,7,537,223,187,"51.51793","-0.067937","Old Montague Street, Whitechapel",410
"5219",2020,7,538,61,62,"51.508981","-0.00699","Naval Row, Blackwall",123
"5220",2020,7,540,123,99,"51.528302","-0.144466","Albany Street, The Regent's Park",222
"5221",2020,7,541,334,321,"51.506613","-0.142844","Green Park Station, Mayfair",655
"5222",2020,7,542,133,138,"51.514115","-0.033828","Salmon Lane, Limehouse",271
"5223",2020,7,543,26,17,"51.509591","-0.204666","Lansdowne Walk, Ladbroke Grove",43
"5224",2020,7,544,159,166,"51.526153","-0.102208","Percival Street, Finsbury",325
"5225",2020,7,545,120,107,"51.539957","-0.145246","Arlington Road, Camden Town",227
"5226",2020,7,546,353,297,"51.517428","-0.107987","New Fetter Lane, Holborn",650
"5227",2020,7,547,41,40,"51.509474","-0.002275","East India DLR, Blackwall",81
"5228",2020,7,548,75,69,"51.498386","-0.107913","Westminster Bridge Road, Elephant & Castle",144
"5229",2020,7,549,108,95,"51.49605","-0.104193","Gaywood  Street, Elephant & Castle",203
"5230",2020,7,550,123,108,"51.521564","-0.039264","Harford Street, Mile End",231
"5231",2020,7,551,88,89,"51.505772","-0.016460175","Import Dock, Canary Wharf",177
"5232",2020,7,552,250,231,"51.511542","-0.056667","Watney Street, Shadwell",481
"5233",2020,7,553,404,366,"51.535678","-0.062546","Regent's Row , Haggerston",770
"5234",2020,7,554,26,33,"51.513548","-0.005659","Aberfeldy Street, Poplar",59
"5235",2020,7,556,75,73,"51.502661","-0.021596","Heron Quays DLR, Canary Wharf",148
"5236",2020,7,557,145,148,"51.51601","-0.0985","King Edward Street, St Pauls",293
"5237",2020,7,558,324,344,"51.493978","-0.127554","Page Street, Westminster",668
"5238",2020,7,559,43,37,"51.501391","-0.205991","Abbotsbury Road, Holland Park",80
"5239",2020,7,560,52,25,"51.511624","-0.205921","Ladbroke Grove Central, Ladbroke Grove",77
"5240",2020,7,561,100,90,"51.518369","-0.043371","Rectory Square, Stepney",190
"5241",2020,7,562,179,185,"51.51746","-0.12335","Bury Place, Holborn",364
"5242",2020,7,563,43,48,"51.499286","-0.009152","Preston's Road, Cubitt Town",91
"5243",2020,7,564,254,350,"51.509943","-0.117619","Somerset House, Strand",604
"5244",2020,7,565,74,69,"51.521905","-0.063386","Selby Street, Whitechapel",143
"5245",2020,7,566,117,119,"51.509158","-0.224103","Westfield Ariel Way, White City",236
"5246",2020,7,568,209,184,"51.51616","-0.18697","Bishop's Bridge Road West, Bayswater",393
"5247",2020,7,569,185,151,"51.53213","-0.08299","Pitfield Street Central, Hoxton",336
"5248",2020,7,570,177,192,"51.503083","-0.017676","Upper Bank Street, Canary Wharf",369
"5249",2020,7,571,85,84,"51.506256","-0.218337","Westfield Southern Terrace ,Shepherd's Bush",169
"5250",2020,7,572,167,195,"51.539099","-0.141728","Greenland Road, Camden Town",362
"5251",2020,7,573,345,334,"51.485587","-0.18119","Limerston Street, West Chelsea",679
"5252",2020,7,574,431,364,"51.53356","-0.09315","Eagle Wharf Road, Hoxton",795
"5253",2020,7,576,44,45,"51.497304","-0.022793","Alpha Grove, Millwall",89
"5254",2020,7,577,178,166,"51.528869","-0.047548","Globe Town Market, Bethnal Green",344
"5255",2020,7,578,83,100,"51.527607","-0.057133","Hollybush Gardens, Bethnal Green",183
"5256",2020,7,579,450,600,"51.511246","-0.093051","Queen Street 2, Bank",1050
"5257",2020,7,580,139,132,"51.48692917","-0.102996299","Doddington Grove, Kennington",271
"5258",2020,7,581,262,271,"51.519167","-0.147983","New Cavendish Street, Marylebone",533
"5259",2020,7,583,218,306,"51.497622","-0.125978","Abingdon Green, Westminster",524
"5260",2020,7,584,153,144,"51.51244","-0.19096","Ilchester Gardens, Bayswater",297
"5261",2020,7,586,30,20,"51.490645","-0.014582","Mudchute DLR, Cubitt Town",50
"5262",2020,7,587,318,327,"51.50964","-0.08497","Monument Street, Monument",645
"5263",2020,7,588,120,119,"51.52959","-0.0801","Hoxton Street, Hoxton",239
"5264",2020,7,589,275,273,"51.487196","-0.179369","Drayton Gardens, West Chelsea",548
"5265",2020,7,590,58,34,"51.53256","-0.16862","Greenberry Street, St.John's Wood",92
"5266",2020,7,592,101,76,"51.5171","-0.18377","Bishop's Bridge Road East, Bayswater",177
"5267",2020,7,593,125,109,"51.531066","-0.11934","Northdown Street, King's Cross",234
"5268",2020,7,594,217,237,"51.513875","-0.117774","Kingsway Southbound, Strand",454
"5269",2020,7,595,224,218,"51.493267","-0.21985","Hammersmith Road, Hammersmith",442
"5270",2020,7,596,187,186,"51.472817","-0.199783","Parson's Green , Parson's Green",373
"5271",2020,7,597,119,114,"51.473471","-0.20782","Fulham Park Road, Fulham",233
"5272",2020,7,598,133,153,"51.494499","-0.228188","Southerton Road, Hammersmith",286
"5273",2020,7,599,86,87,"51.485743","-0.223616","Manbre Road, Hammersmith",173
"5274",2020,7,600,191,194,"51.481747","-0.124642","South Lambeth Road, Vauxhall",385
"5275",2020,7,601,106,127,"51.514767","-0.225787","BBC White City, White City",233
"5276",2020,7,602,189,145,"51.472993","-0.133972","Union Grove, Wandsworth Road",334
"5277",2020,7,603,135,131,"51.477839","-0.116493","Caldwell Street, Stockwell",266
"5278",2020,7,604,95,92,"51.538792","-0.138535","St Martins Close, Camden Town",187
"5279",2020,7,605,167,136,"51.520331","-0.163667","Seymour Place, Marylebone",303
"5280",2020,7,606,62,66,"51.504199","-0.210941","Addison Road, Holland Park",128
"5281",2020,7,607,114,109,"51.468814","-0.210279","Putney Bridge Station, Fulham",223
"5282",2020,7,608,15,19,"51.491093","-0.216493","Colet Gardens, Hammersmith",34
"5283",2020,7,609,63,48,"51.46512358","-0.157788279","Sugden Road, Clapham",111
"5284",2020,7,610,116,115,"51.48256792","-0.172078187","Danvers Street, West Chelsea",231
"5285",2020,7,611,80,65,"51.50646524","-0.208486599","Princedale Road , Holland Park",145
"5286",2020,7,612,154,129,"51.46925984","-0.141812513","Wandsworth Rd, Isley Court, Wandsworth Road",283
"5287",2020,7,613,283,282,"51.50403821","-0.217400093","Woodstock Grove, Shepherd's Bush",565
"5288",2020,7,614,84,66,"51.47817208","-0.144690541","Bradmead, Battersea Park",150
"5289",2020,7,615,153,123,"51.4768851","-0.215895601","Finlay Street, Fulham",276
"5290",2020,7,616,166,151,"51.48102131","-0.209973497","Aintree Street, Fulham",317
"5291",2020,7,617,88,86,"51.47107905","-0.207842908","Elysium Place, Fulham",174
"5292",2020,7,618,124,115,"51.47625965","-0.193254007","Eel Brook Common, Walham Green",239
"5293",2020,7,619,109,97,"51.4737636","-0.197010096","Irene Road, Parsons Green",206
"5294",2020,7,620,147,118,"51.47518024","-0.167160736","Surrey Lane, Battersea",265
"5295",2020,7,621,162,164,"51.46086446","-0.187427294","Wandsworth Town Station, Wandsworth",326
"5296",2020,7,622,175,160,"51.50748124","-0.205535908","Lansdowne Road, Ladbroke Grove",335
"5297",2020,7,623,63,55,"51.46193072","-0.180791784","Nantes Close, Wandsworth",118
"5298",2020,7,624,116,82,"51.4729184","-0.132102704","Courland Grove, Wandsworth Road",198
"5299",2020,7,625,182,152,"51.47761941","-0.149551631","Queen's Circus, Battersea Park",334
"5300",2020,7,626,210,194,"51.48438657","-0.20481514","Normand Park, West Kensington",404
"5301",2020,7,627,70,62,"51.4687905","-0.158230901","Holden Street, Battersea",132
"5302",2020,7,628,127,132,"51.46881971","-0.184318843","William Morris Way, Sands End",259
"5303",2020,7,629,25,29,"51.45995384","-0.190184054","Morie Street, Wandsworth",54
"5304",2020,7,630,84,79,"51.47073264","-0.126994068","Clarence Walk, Stockwell",163
"5305",2020,7,631,172,170,"51.4795017","-0.141770709","Battersea Park Road, Nine Elms",342
"5306",2020,7,632,88,82,"51.47053858","-0.163041605","Sheepcote Lane, Battersea",170
"5307",2020,7,633,143,152,"51.48959104","-0.209378594","Vereker Road, West Kensington",295
"5308",2020,7,634,91,94,"51.49434708","-0.215804559","Brook Green South, Brook Green",185
"5309",2020,7,635,171,164,"51.48606206","-0.214428378","Greyhound Road, Hammersmith",335
"5310",2020,7,636,163,145,"51.46706414","-0.193502076","South Park, Sands End",308
"5311",2020,7,637,53,29,"51.45787019","-0.174691623","Spencer Park, Wandsworth Common",82
"5312",2020,7,638,354,362,"51.46663393","-0.169821175","Falcon Road, Clapham Junction",716
"5313",2020,7,639,184,166,"51.48357068","-0.202038682","Coomer Place, West Kensington",350
"5314",2020,7,640,123,103,"51.47286577","-0.148059277","Silverthorne Road, Battersea",226
"5315",2020,7,641,94,109,"51.49824168","-0.117495865","Archbishop's Park, Waterloo",203
"5316",2020,7,642,55,40,"51.46916161","-0.174485792","Fawcett Close, Battersea",95
"5317",2020,7,643,74,64,"51.5190427","-0.204764421","All Saints' Road, Portobello",138
"5318",2020,7,644,127,131,"51.48373225","-0.223852256","Rainville Road, Hammersmith",258
"5319",2020,7,645,185,183,"51.50173215","-0.100292412","Great Suffolk Street, The Borough",368
"5320",2020,7,646,166,209,"51.49886563","-0.137424571","Buckingham Gate, Westminster",375
"5321",2020,7,647,103,96,"51.50035306","-0.217515071","Richmond Way, Shepherd's Bush",199
"5322",2020,7,648,75,60,"51.46904022","-0.19627483","Peterborough Road, Sands End",135
"5323",2020,7,649,141,136,"51.48180515","-0.18027465","World's End Place, West Chelsea",277
"5324",2020,7,650,85,97,"51.51687069","-0.213872396","St. Mark's Road, North Kensington",182
"5325",2020,7,651,85,91,"51.48089844","-0.183853573","Thorndike Close, West Chelsea",176
"5326",2020,7,652,52,63,"51.51148696","-0.218190203","Evesham Street, Avondale",115
"5327",2020,7,653,157,154,"51.47084722","-0.17070367","Simpson Street, Clapham Junction",311
"5328",2020,7,654,143,119,"51.48267821","-0.117661574","Ashmole Estate, Oval",262
"5329",2020,7,655,78,63,"51.48294452","-0.219346128","Crabtree Lane, Fulham",141
"5330",2020,7,656,64,65,"51.46841875","-0.199135704","Broomhouse Lane, Parsons Green",129
"5331",2020,7,657,56,56,"51.4996806","-0.221791552","Blythe Road West, Shepherd's Bush",112
"5332",2020,7,658,233,220,"51.47729232","-0.16478637","Ethelburga Estate, Battersea Park",453
"5333",2020,7,659,248,256,"51.511934","-0.10307894","Blackfriars Station, St. Paul's",504
"5334",2020,7,660,114,90,"51.49087074","-0.206029743","West Kensington Station, West Kensington",204
"5335",2020,7,661,223,207,"51.51632095","-0.202608612","All Saints Church, Portobello",430
"5336",2020,7,662,149,148,"51.48498496","-0.167919869","Phene Street, Chelsea",297
"5337",2020,7,663,82,70,"51.51323001","-0.211593602","Clarendon Road, Avondale",152
"5338",2020,7,664,158,140,"51.474376","-0.155442787","Austin Road, Battersea Park",298
"5339",2020,7,665,87,82,"51.46108367","-0.191722864","Smugglers Way, Wandsworth",169
"5340",2020,7,666,117,111,"51.49610093","-0.208158259","Olympia Way, Olympia",228
"5341",2020,7,667,122,106,"51.5015946","-0.222293381","Shepherd's Bush Road North, Shepherd's Bush",228
"5342",2020,7,668,157,161,"51.49422354","-0.236769936","Ravenscourt Park Station, Hammersmith",318
"5343",2020,7,669,75,54,"51.47614939","-0.1232585","Teversham Lane, Stockwell",129
"5344",2020,7,670,133,123,"51.46718562","-0.152248582","Ashley Crescent, Battersea",256
"5345",2020,7,671,291,293,"51.475089","-0.201968","Parsons Green Station, Parsons Green",584
"5346",2020,7,673,128,121,"51.46517078","-0.18038939","Hibbert Street, Battersea",249
"5347",2020,7,674,121,81,"51.53546778","-0.11619105","Carnegie Street, King's Cross",202
"5348",2020,7,675,98,84,"51.46348914","-0.182126248","Usk Road, Clapham Junction",182
"5349",2020,7,676,192,176,"51.47787084","-0.126874471","Hartington Road, Stockwell",368
"5350",2020,7,677,67,47,"51.46866929","-0.146544642","Heath Road, Battersea",114
"5351",2020,7,678,32,33,"51.46231278","-0.211468596","Esmond Street, Putney",65
"5352",2020,7,679,156,121,"51.47453545","-0.170210533","Orbel Street, Battersea",277
"5353",2020,7,680,295,294,"51.47768469","-0.170329317","Westbridge Road, Battersea",589
"5354",2020,7,681,105,92,"51.47303687","-0.214749808","Bishop's Avenue, Fulham",197
"5355",2020,7,682,160,168,"51.48810829","-0.22660621","Crisp Road, Hammersmith",328
"5356",2020,7,683,61,68,"51.46506424","-0.163750945","Dorothy Road, Clapham Junction",129
"5357",2020,7,684,71,70,"51.45475251","-0.195197203","Neville Gill Close, Wandsworth",141
"5358",2020,7,685,113,108,"51.46067005","-0.198735357","Osiers Road, Wandsworth",221
"5359",2020,7,686,140,143,"51.48814438","-0.222456468","Beryl Road, Hammersmith",283
"5360",2020,7,687,150,141,"51.49760804","-0.21145598","Maclise Road, Olympia",291
"5361",2020,7,688,58,58,"51.46095151","-0.20066766","Northfields, Wandsworth",116
"5362",2020,7,689,36,23,"51.45922541","-0.180884959","Spanish Road, Clapham Junction",59
"5363",2020,7,690,70,71,"51.47047503","-0.152130083","Stanley Grove, Battersea",141
"5364",2020,7,691,165,175,"51.47946386","-0.195777222","Erin Close, Walham Green",340
"5365",2020,7,692,160,159,"51.54211855","-0.028941601","Cadogan Close, Victoria Park",319
"5366",2020,7,693,67,63,"51.464786","-0.215618902","Felsham Road, Putney",130
"5367",2020,7,694,42,35,"51.46071722","-0.216526155","Putney Rail Station, Putney",77
"5368",2020,7,695,372,336,"51.53638435","-0.102757578","Islington Green, Angel",708
"5369",2020,7,696,191,187,"51.48728535","-0.217995921","Charing Cross Hospital, Hammersmith",378
"5370",2020,7,697,133,82,"51.53639219","-0.112721065","Charlotte Terrace, Angel",215
"5371",2020,7,698,137,101,"51.53908372","-0.070329419","Shoreditch Court, Haggerston",238
"5372",2020,7,699,82,50,"51.5366541","-0.07023031","Belford House, Haggerston",132
"5373",2020,7,700,143,126,"51.47696496","-0.174347066","Battersea Church Road, Battersea",269
"5374",2020,7,701,184,164,"51.47287627","-0.176267008","Vicarage Crescent, Battersea",348
"5375",2020,7,702,159,126,"51.52868155","-0.065550321","Durant Street, Bethnal Green",285
"5376",2020,7,703,269,444,"51.51505991","-0.10534448","St. Bride Street, Holborn",713
"5377",2020,7,704,41,23,"51.45682071","-0.202802098","Mexfield Road, East Putney",64
"5378",2020,7,705,43,35,NA,NA,NA,78
"5379",2020,7,706,184,192,"51.50215353","-0.083632928","Snowsfields, London Bridge",376
"5380",2020,7,707,282,264,"51.49021762","-0.215087092","Barons Court Station, West Kensington",546
"5381",2020,7,708,76,93,"51.46161068","-0.21614583","Disraeli Road, Putney",169
"5382",2020,7,709,38,34,"51.46321128","-0.215550761","Montserrat Road , Putney",72
"5383",2020,7,710,165,162,"51.47439218","-0.163347594","Albert Bridge Road, Battersea Park",327
"5384",2020,7,711,117,107,"51.48335692","-0.216305546","Everington Street, Fulham",224
"5385",2020,7,712,125,118,"51.51854104","-0.034903714","Mile End Stadium, Mile End",243
"5386",2020,7,713,69,75,"51.54100708","-0.14326094","Hawley Crescent, Camden Town",144
"5387",2020,7,714,75,68,"51.47311696","-0.137235175","Stewart's Road, Wandsworth Road",143
"5388",2020,7,715,104,85,"51.51563007","-0.049067243","Aylward Street, Stepney",189
"5389",2020,7,716,65,74,"51.51542791","-0.02356501","Stainsby Road , Poplar",139
"5390",2020,7,717,361,306,"51.53658514","-0.075885686","Dunston Road , Haggerston",667
"5391",2020,7,718,231,194,"51.53571683","-0.060291813","Ada Street, Hackney Central",425
"5392",2020,7,719,188,181,"51.53642464","-0.054162264","Victoria Park Road, Hackney Central",369
"5393",2020,7,720,120,106,"51.48724429","-0.205279052","Star Road, West Kensington",226
"5394",2020,7,721,104,100,"51.53603947","-0.026262677","Wendon Street, Old Ford",204
"5395",2020,7,722,152,131,"51.52458353","-0.058631453","Finnis Street, Bethnal Green",283
"5396",2020,7,723,196,196,"51.46822047","-0.190346493","Stephendale Road, Sands End",392
"5397",2020,7,724,52,43,"51.45799126","-0.184806157","Alma Road, Wandsworth",95
"5398",2020,7,725,189,191,"51.491327","-0.096518684","Walworth Square, Walworth",380
"5399",2020,7,726,179,170,"51.47505096","-0.150908371","Alfreda Street, Battersea Park",349
"5400",2020,7,727,140,131,"51.47569809","-0.20587627","Chesilton Road, Fulham",271
"5401",2020,7,728,61,54,"51.46199911","-0.206240805","Putney Bridge Road, East Putney",115
"5402",2020,7,729,226,193,"51.47893931","-0.208485293","St. Peter's Terrace, Fulham",419
"5403",2020,7,730,153,155,"51.49208492","-0.229116862","Bridge Avenue, Hammersmith",308
"5404",2020,7,731,122,110,"51.47727637","-0.189210466","Michael Road, Walham Green",232
"5405",2020,7,732,624,663,"51.50630441","-0.087262995","Duke Street Hill, London Bridge",1287
"5406",2020,7,733,90,97,"51.50542628","-0.150817316","Park Lane, Mayfair",187
"5407",2020,7,734,69,61,"51.46230566","-0.175407201","Plough Terrace, Clapham Junction",130
"5408",2020,7,735,207,214,"51.46489445","-0.17302926","Grant Road East, Clapham Junction",421
"5409",2020,7,736,51,57,"51.50659035","-0.216104479","Queensdale Road, Shepherd's Bush",108
"5410",2020,7,737,443,446,"51.47993289","-0.19411695","Fulham Broadway, Walham Green",889
"5411",2020,7,738,134,145,"51.47514228","-0.187278987","Imperial Road, Sands End",279
"5412",2020,7,739,131,130,"51.48176572","-0.185273723","Hortensia Road, West Brompton",261
"5413",2020,7,740,26,21,"51.51092871","-0.214594781","Sirdar Road, Avondale",47
"5414",2020,7,741,43,56,"51.5129814","-0.219486603","Freston Road, Avondale",99
"5415",2020,7,742,110,109,"51.51510818","-0.208565479","Blenheim Crescent, Ladbroke Grove",219
"5416",2020,7,743,39,25,"51.46079243","-0.212607684","Oxford Road, Putney",64
"5417",2020,7,744,29,39,"51.46745485","-0.172293499","Ingrave Street, Clapham Junction",68
"5418",2020,7,745,89,80,"51.47816972","-0.18243547","Upcerne Road, West Chelsea",169
"5419",2020,7,746,98,94,"51.4795738","-0.17903854","Lots Road, West Chelsea",192
"5420",2020,7,747,139,143,"51.48796408","-0.161765173","Ormonde Gate, Chelsea",282
"5421",2020,7,748,242,205,"51.53727795","-0.079201849","Hertford Road, De Beauvoir Town",447
"5422",2020,7,749,223,210,"51.53932857","-0.074284675","Haggerston Road, Haggerston",433
"5423",2020,7,750,55,42,"51.4710956","-0.157850096","Culvert Road, Battersea",97
"5424",2020,7,751,142,166,"51.51612862","-0.120909408","Newton Street, Covent Garden",308
"5425",2020,7,754,64,68,"51.5129006","-0.214762686","Grenfell Road, Avondale",132
"5426",2020,7,755,178,183,"51.48512191","-0.174971902","The Vale, Chelsea",361
"5427",2020,7,756,141,116,"51.47515398","-0.159169801","Prince of Wales Drive, Battersea Park",257
"5428",2020,7,757,156,142,"51.48795853","-0.187404506","Harcourt Terrace, West Brompton",298
"5429",2020,7,758,101,91,"51.51787005","-0.201005397","Westbourne Park Road, Portobello",192
"5430",2020,7,759,60,47,"51.52456169","-0.165668686","Broadley Terrace, Marylebone",107
"5431",2020,7,760,65,64,"51.52526975","-0.163795009","Rossmore Road, Marylebone",129
"5432",2020,7,761,140,126,"51.48321729","-0.211860644","Humbolt Road, Fulham",266
"5433",2020,7,762,364,435,"51.50070305","-0.129698963","Storey's Gate, Westminster",799
"5434",2020,7,763,136,127,"51.52059714","-0.032566533","Mile End Park Leisure Centre, Mile End",263
"5435",2020,7,764,112,137,"51.46239255","-0.16829214","St. John's Road, Clapham Junction",249
"5436",2020,7,765,49,47,"51.46760141","-0.20682737","Ranelagh Gardens, Fulham",96
"5437",2020,7,766,160,164,"51.45752945","-0.192165613","Ram Street, Wandsworth",324
"5438",2020,7,767,28,23,"51.45705988","-0.200806304","Santos Road, Wandsworth",51
"5439",2020,7,768,115,72,"51.46134382","-0.159322467","Clapham Common North Side, Clapham Common",187
"5440",2020,7,769,167,147,"51.473611","-0.191803","Sandilands Road, Walham Green",314
"5441",2020,7,770,85,79,"51.491026","-0.209121","Gwendwr Road, West Kensington",164
"5442",2020,7,771,58,48,"51.509224","-0.216016","Rifle Place, Avondale",106
"5443",2020,7,772,300,275,"51.47250956","-0.122831913","Binfield Road, Stockwell",575
"5444",2020,7,773,344,393,"51.511891","-0.107349","Tallis Street, Temple",737
"5445",2020,7,774,44,44,"51.470131","-0.20464","Hurlingham Park, Parsons Green",88
"5446",2020,7,775,100,109,"51.496664","-0.223868","Little Brook Green, Brook Green",209
"5447",2020,7,776,83,85,"51.460333","-0.167029","Abyssinia Close, Clapham Junction",168
"5448",2020,7,777,32,27,"51.4619230679","-0.165297856693","Limburg Road, Clapham Junction",59
"5449",2020,7,779,224,248,"51.514449","-0.077178979","Houndsditch, Aldgate",472
"5450",2020,7,780,254,251,"51.474665","-0.18316517","Imperial Wharf Station, Sands End",505
"5451",2020,7,781,161,183,"51.495898","-0.173009","Victoria & Albert Museum, South Kensington",344
"5452",2020,7,782,155,133,"51.483911","-0.19760944","Halford Road, West Kensington",288
"5453",2020,7,783,191,191,"51.5403115","-0.021630359","Monier Road, Hackney Wick",382
"5454",2020,7,784,98,99,"51.546326","-0.00993526","East Village, Queen Elizabeth Olympic Park",197
"5455",2020,7,785,281,306,"51.54094","-0.010510565","Aquatic Centre, Queen Elizabeth Olympic Park",587
"5456",2020,7,786,67,56,"51.549369","-0.015717614","Lee Valley VeloPark, Queen Elizabeth Olympic Park",123
"5457",2020,7,787,56,55,"51.546805","-0.01469126","Timber Lodge, Queen Elizabeth Olympic Park",111
"5458",2020,7,789,52,51,"51.538718","-0.011889482","Podium, Queen Elizabeth Olympic Park",103
"5459",2020,7,790,131,148,"51.541793","-0.00481","Stratford Station, Stratford",279
"5460",2020,7,792,214,199,"51.505461","-0.10454093","Blackfriars Road, Southwark",413
"5461",2020,7,793,88,75,"51.528279","-0.11955857","Cromer Street, Bloomsbury",163
"5462",2020,7,795,144,165,"51.527068","-0.13186102","Euston Square Gardens, Euston",309
"5463",2020,7,796,134,130,"51.524","-0.12640984","Coram Street, Bloomsbury",264
"5464",2020,7,797,221,243,"51.5293","-0.12827903","Ossulston Street, Somers Town",464
"5465",2020,7,798,275,300,"51.5301998755","-0.122299440803","Birkenhead Street, King's Cross",575
"5466",2020,7,799,145,168,"51.4976984561","-0.137598896295","Kings Gate House, Westminster",313
"5467",2020,7,800,167,170,"51.4811219398","-0.149035374873","Sopwith Way, Battersea Park",337
"5468",2020,7,801,224,253,"51.5052241745","-0.0980318118664","Lavington Street, Bankside",477
"5469",2020,7,802,141,112,"51.4765900593","-0.118256789081","Albert Square, Stockwell",253
"5470",2020,7,803,169,165,"51.5054099403","-0.0983410884509","Southwark Street, Bankside",334
"5471",2020,7,804,290,285,"51.5346677396","-0.125078652873","Good's Way, King's Cross",575
"5472",2020,7,806,165,151,"51.5372405623","-0.124807385707","Handyside Street, King's Cross",316
"5473",2020,7,807,137,133,"51.5212","-0.20888818","Bevington Road West, North Kensington",270
"5474",2020,7,809,186,221,"51.5162778834","-0.118272991635","Lincoln's Inn Fields, Holborn",407
"5475",2020,7,810,274,328,"51.5067252868","-0.0988072461627","Tate Modern, Bankside",602
"5476",2020,7,811,182,196,"51.5057030357","-0.0277727426235","Westferry Circus, Canary Wharf",378
"5477",2020,7,812,42,51,"51.5487311915","-0.0226065549321","Here East North, Queen Elizabeth Olympic Park",93
"5478",2020,7,813,148,141,"51.4878074485","-0.122759625866","New Spring Gardens Walk, Vauxhall",289
"5479",2020,7,814,76,69,"51.4714330677","-0.123670735702","Clapham Road, Lingham Street, Stockwell",145
"5480",2020,7,815,297,292,"51.5000891978","-0.116628700672","Lambeth Palace Road, Waterloo",589
"5481",2020,7,816,37,52,"51.5465327935","-0.0205975904647","Here East South, Queen Elizabeth Olympic Park",89
"5482",2020,7,817,216,199,"51.4813354746","-0.138212295869","Riverlight South, Nine Elms",415
"5483",2020,7,818,282,292,"51.501513","-0.12382322","Westminster Pier, Westminster",574
"5484",2020,7,819,159,158,"51.50621","-0.114842","Belvedere Road 2, South Bank",317
"5485",2020,7,820,127,121,"51.492807","-0.091938","Victory Place, Walworth",248
"5486",2020,7,821,258,251,"51.4835074867","-0.147714557371","Battersea Power Station, Battersea Park",509
"5487",2020,7,826,374,376,"51.496863","-0.1429434","Allington Street, Victoria",750
"5488",2020,7,827,162,170,"51.479601","-0.11147178","Cranmer Road, Stockwell",332
"5489",2020,7,828,127,119,"51.473874","-0.11258096","Normandy Road, Stockwell",246
"5490",2020,7,829,53,42,"51.469217","-0.11268674","Wynne Road, Stockwell",95
"5491",2020,7,830,94,74,"51.469202","-0.11902256","Sidney Road, Stockwell",168
"5492",2020,7,831,92,82,"51.466232","-0.11317995","St John's Crescent, Brixton",174
"5493",2020,7,832,118,111,"51.464019","-0.11578197","Ferndale Road, Brixton",229
"5494",2020,7,833,75,76,"51.460232","-0.11537509","Saltoun Road, Brixton",151
"5495",2020,7,834,140,131,"51.477966","-0.14785703","Gas Holders, Battersea Park",271
"5496",2020,7,835,168,169,"51.516785","-0.10494775","Farringdon Street, Holborn",337
"5497",2020,7,836,158,104,"51.541596","-0.12544145","York Way, Kings Cross",262
"5498",2020,7,838,163,198,"51.518093","-0.0914017","Fore Street Avenue, Guildhall",361
"5499",2020,7,839,340,349,"51.508033","-0.10682363","Sea Containers, South Bank",689
"5500",2020,8,1,128,82,"51.52916347","-0.109970527","River Street , Clerkenwell",210
"5501",2020,8,2,218,220,"51.49960695","-0.197574246","Phillimore Gardens, Kensington",438
"5502",2020,8,3,220,253,"51.52128377","-0.084605692","Christopher Street, Liverpool Street",473
"5503",2020,8,4,105,114,"51.53005939","-0.120973687","St. Chad's Street, King's Cross",219
"5504",2020,8,5,290,338,"51.49313","-0.156876","Sedding Street, Sloane Square",628
"5505",2020,8,6,215,229,"51.51811784","-0.144228881","Broadcasting House, Marylebone",444
"5506",2020,8,7,110,99,"51.53430039","-0.1680743","Charlbert Street, St. John's Wood",209
"5507",2020,8,8,178,174,"51.529857","-0.18348604","Maida Vale, Maida Vale",352
"5508",2020,8,9,199,224,"51.5073853","-0.096440751","New Globe Walk, Bankside",423
"5509",2020,8,10,104,128,"51.50597426","-0.092754157","Park Street, Bankside",232
"5510",2020,8,11,197,177,"51.52395143","-0.122502346","Brunswick Square, Bloomsbury",374
"5511",2020,8,12,421,423,"51.52168078","-0.130431727","Malet Street, Bloomsbury",844
"5512",2020,8,13,154,169,"51.51991453","-0.136039674","Scala Street, Fitzrovia",323
"5513",2020,8,14,1354,1323,"51.52994371","-0.123616824","Belgrove Street , King's Cross",2677
"5514",2020,8,15,212,227,"51.51772703","-0.127854211","Great Russell Street, Bloomsbury",439
"5515",2020,8,16,232,211,"51.52635795","-0.125979294","Cartwright Gardens , Bloomsbury",443
"5516",2020,8,17,350,396,"51.5216612","-0.109006325","Hatton Wall, Holborn",746
"5517",2020,8,18,375,386,"51.51477076","-0.12221963","Drury Lane, Covent Garden",761
"5518",2020,8,19,252,250,"51.52505093","-0.131161087","Taviton Street, Bloomsbury",502
"5519",2020,8,20,171,107,"51.527326","-0.13605286","Drummond Street , Euston",278
"5520",2020,8,21,77,66,"51.53007835","-0.13884627","Hampstead Road (Cartmel), Euston",143
"5521",2020,8,22,310,319,"51.5222641","-0.114079481","Northington Street , Holborn",629
"5522",2020,8,23,160,165,"51.51943538","-0.119123345","Red Lion Square, Holborn",325
"5523",2020,8,24,313,314,"51.51908011","-0.124678402","British Museum, Bloomsbury",627
"5524",2020,8,25,393,336,"51.5288338","-0.132250369","Doric Way , Somers Town",729
"5525",2020,8,26,159,144,"51.52728093","-0.11829517","Ampton Street , Clerkenwell",303
"5526",2020,8,27,270,303,"51.51382102","-0.107927706","Bouverie Street, Temple",573
"5527",2020,8,28,253,238,"51.52351808","-0.143613641","Bolsover Street, Fitzrovia",491
"5528",2020,8,29,165,146,"51.513735","-0.193487","Hereford Road, Bayswater",311
"5529",2020,8,30,237,220,"51.52915444","-0.093421615","Windsor Terrace, Hoxton",457
"5530",2020,8,31,247,226,"51.52953709","-0.083353323","Fanshaw Street, Hoxton",473
"5531",2020,8,32,408,475,"51.52469624","-0.084439283","Leonard Circus , Shoreditch",883
"5532",2020,8,33,219,228,"51.5156","-0.070056","Central House, Aldgate",447
"5533",2020,8,34,132,131,"51.5341235","-0.129386874","Pancras Road, King's Cross",263
"5534",2020,8,36,204,153,"51.50173726","-0.184980612","De Vere Gardens, Kensington",357
"5535",2020,8,37,230,203,"51.49159394","-0.192369256","Penywern Road, Earl's Court",433
"5536",2020,8,38,96,83,"51.4973875","-0.197245586","Abingdon Villas, Kensington",179
"5537",2020,8,39,462,469,"51.5263778","-0.078130921","Shoreditch High Street, Shoreditch",931
"5538",2020,8,40,142,150,"51.52127071","-0.0755789","Commercial Street, Shoreditch",292
"5539",2020,8,41,316,350,"51.520955","-0.083493552","Pindar Street, Liverpool Street",666
"5540",2020,8,42,229,204,"51.53099181","-0.093903825","Wenlock Road , Hoxton",433
"5541",2020,8,43,238,237,"51.52026","-0.157183945","Crawford Street, Marylebone",475
"5542",2020,8,44,142,153,"51.51073687","-0.144165239","Bruton Street, Mayfair",295
"5543",2020,8,45,408,348,"51.522511","-0.162298","Boston Place, Marylebone",756
"5544",2020,8,46,414,399,"51.507131","-0.06691","Nesham Street, Wapping",813
"5545",2020,8,47,229,203,"51.52334476","-0.183846408","Warwick Avenue Station, Maida Vale",432
"5546",2020,8,48,261,298,"51.51248445","-0.099141408","Godliman Street, St. Paul's",559
"5547",2020,8,49,119,135,"51.50706909","-0.145904427","Curzon Street, Mayfair",254
"5548",2020,8,50,193,197,"51.52867339","-0.087459376","East Road, Hoxton",390
"5549",2020,8,51,173,160,"51.52671796","-0.104298194","Finsbury Library , Finsbury",333
"5550",2020,8,52,181,192,"51.52295439","-0.094934859","Roscoe Street, St. Luke's",373
"5551",2020,8,53,120,164,"51.5099923","-0.143495266","Grafton Street, Mayfair",284
"5552",2020,8,54,204,254,"51.52174785","-0.094475072","Golden Lane, Barbican",458
"5553",2020,8,55,530,626,"51.51707521","-0.086685542","Finsbury Circus, Liverpool Street",1156
"5554",2020,8,56,173,188,"51.52058381","-0.154701411","Paddington Street, Marylebone",361
"5555",2020,8,57,240,245,"51.52334672","-0.120202614","Guilford Street , Bloomsbury",485
"5556",2020,8,58,296,301,"51.52452699","-0.079248081","New Inn Yard, Shoreditch",597
"5557",2020,8,60,89,74,"51.52644828","-0.172190727","Lisson Grove, St. John's Wood",163
"5558",2020,8,61,218,196,"51.49738251","-0.089446947","Great Dover Street, The Borough",414
"5559",2020,8,62,127,106,"51.4907579","-0.106323685","Cotton Garden Estate, Kennington",233
"5560",2020,8,63,116,102,"51.53089041","-0.089782579","Murray Grove , Hoxton",218
"5561",2020,8,64,383,473,"51.50946212","-0.124749274","William IV Street, Strand",856
"5562",2020,8,65,191,186,NA,NA,NA,377
"5563",2020,8,66,539,779,"51.51795029","-0.108657431","Holborn Circus, Holborn",1318
"5564",2020,8,67,307,288,"51.51882555","-0.108028472","Hatton Garden, Holborn",595
"5565",2020,8,68,246,264,"51.52059681","-0.116688468","Theobald's Road , Holborn",510
"5566",2020,8,69,177,188,"51.5262363","-0.134407652","Euston Road, Euston",365
"5567",2020,8,70,112,89,"51.53136059","-0.117069978","Calshot Street , King's Cross",201
"5568",2020,8,71,478,521,"51.5154186","-0.098850915","Newgate Street , St. Paul's",999
"5569",2020,8,72,195,181,"51.52352001","-0.108340165","Farringdon Lane, Clerkenwell",376
"5570",2020,8,73,466,466,"51.52572618","-0.088486188","Old Street Station, St. Luke's",932
"5571",2020,8,74,467,468,"51.48591714","-0.124469948","Vauxhall Cross, Vauxhall",935
"5572",2020,8,75,231,228,"51.53219984","-0.105480698","Torrens Street, Angel",459
"5573",2020,8,76,114,78,"51.52559505","-0.144083893","Longford Street, The Regent's Park",192
"5574",2020,8,77,229,224,"51.52341837","-0.124121774","Russell Square Station, Bloomsbury",453
"5575",2020,8,78,247,244,"51.52486887","-0.099489485","Sadlers Sports Centre, Finsbury",491
"5576",2020,8,79,120,168,"51.511726","-0.11385596","Arundel Street, Temple",288
"5577",2020,8,80,203,167,"51.50069361","-0.102091246","Webber Street , Southwark",370
"5578",2020,8,81,228,229,"51.52025302","-0.141327271","Great Titchfield Street, Fitzrovia",457
"5579",2020,8,82,159,149,"51.514274","-0.111257","Chancery Lane, Holborn",308
"5580",2020,8,83,305,348,"51.50963938","-0.131510949","Panton Street, West End",653
"5581",2020,8,84,189,211,"51.51593725","-0.111778348","Breams Buildings, Holborn",400
"5582",2020,8,85,313,314,"51.50064702","-0.078600401","Tanner Street, Bermondsey",627
"5583",2020,8,86,142,122,"51.48947903","-0.115156562","Sancroft Street, Vauxhall",264
"5584",2020,8,87,240,252,"51.51646835","-0.079684557","Devonshire Square, Liverpool Street",492
"5585",2020,8,88,321,347,"51.51858757","-0.132053392","Bayley Street , Bloomsbury",668
"5586",2020,8,89,176,176,"51.5262503","-0.123509611","Tavistock Place, Bloomsbury",352
"5587",2020,8,90,64,48,"51.53301907","-0.139174593","Harrington Square 1, Camden Town",112
"5588",2020,8,91,175,123,"51.49368637","-0.111014912","Walnut Tree Walk, Vauxhall",298
"5589",2020,8,92,157,170,"51.49889832","-0.100440521","Borough Road, Elephant & Castle",327
"5590",2020,8,93,180,74,"51.53440868","-0.109025404","Cloudesley Road, Angel",254
"5591",2020,8,94,277,238,"51.49506109","-0.085814489","Bricklayers Arms, Borough",515
"5592",2020,8,95,412,445,"51.5208417","-0.097340162","Aldersgate Street, Barbican",857
"5593",2020,8,96,177,160,"51.53095071","-0.078505384","Falkirk Street, Hoxton",337
"5594",2020,8,97,185,193,"51.49792478","-0.183834706","Gloucester Road (North), Kensington",378
"5595",2020,8,98,236,211,"51.52554222","-0.138231303","Hampstead Road, Euston",447
"5596",2020,8,99,290,299,"51.51457763","-0.158264483","Old Quebec Street, Marylebone",589
"5597",2020,8,100,151,143,"51.49043573","-0.122806861","Albert Embankment, Vauxhall",294
"5598",2020,8,101,589,599,"51.51155322","-0.0929401","Queen Street 1, Bank",1188
"5599",2020,8,102,260,274,"51.51340693","-0.076793375","Jewry Street, Aldgate",534
"5600",2020,8,103,112,92,"51.50472376","-0.192538767","Vicarage Gate, Kensington",204
"5601",2020,8,104,584,617,"51.51159481","-0.077121322","Crosswall, Tower",1201
"5602",2020,8,105,175,141,"51.51552971","-0.190240716","Westbourne Grove, Bayswater",316
"5603",2020,8,106,113,124,"51.51410514","-0.147301667","Woodstock Street, Mayfair",237
"5604",2020,8,107,484,478,"51.52600832","-0.096317627","Finsbury Leisure Centre, St. Luke's",962
"5605",2020,8,108,224,283,"51.49812559","-0.132102166","Abbey Orchard Street, Westminster",507
"5606",2020,8,109,524,590,"51.51563144","-0.132328837","Soho Square , Soho",1114
"5607",2020,8,110,129,115,"51.53304322","-0.172528678","Wellington Road, St. John's Wood",244
"5608",2020,8,111,355,393,"51.5100172","-0.157275636","Park Lane , Hyde Park",748
"5609",2020,8,112,166,231,"51.51580998","-0.105270275","Stonecutter Street, Holborn",397
"5610",2020,8,113,160,160,"51.49646288","-0.183289032","Gloucester Road (Central), South Kensington",320
"5611",2020,8,114,221,231,"51.52451738","-0.158963647","Park Road (Baker Street), The Regent's Park",452
"5612",2020,8,115,350,373,"51.51423368","-0.073537654","Braham Street, Aldgate",723
"5613",2020,8,116,357,377,"51.51449962","-0.141423695","Little Argyll Street, West End",734
"5614",2020,8,117,255,225,"51.49288067","-0.114934001","Lollard Street, Vauxhall",480
"5615",2020,8,118,111,152,"51.49582705","-0.13547809","Rochester Row, Westminster",263
"5616",2020,8,119,334,361,"51.52589324","-0.090847761","Bath Street, St. Luke's",695
"5617",2020,8,120,162,169,"51.51573534","-0.093080779","The Guildhall, Guildhall",331
"5618",2020,8,121,260,278,"51.51891348","-0.156166631","Baker Street, Marylebone",538
"5619",2020,8,122,219,268,"51.52111369","-0.078869751","Norton Folgate, Liverpool Street",487
"5620",2020,8,123,110,104,"51.52836014","-0.104724625","St. John Street, Finsbury",214
"5621",2020,8,124,99,99,"51.49654462","-0.150905245","Eaton Square, Belgravia",198
"5622",2020,8,125,196,193,"51.50069491","-0.094524319","Borough High Street, The Borough",389
"5623",2020,8,126,319,311,"51.51782144","-0.096496865","Museum of London, Barbican",630
"5624",2020,8,127,139,166,"51.51700801","-0.09388536","Wood Street, Guildhall",305
"5625",2020,8,128,133,121,"51.49536226","-0.185296516","Emperor's Gate, South Kensington",254
"5626",2020,8,129,233,265,"51.5118973","-0.137043852","Golden Square, Soho",498
"5627",2020,8,130,290,325,"51.50950627","-0.075459482","Tower Gardens , Tower",615
"5628",2020,8,131,136,137,"51.53300545","-0.136792671","Eversholt Street , Camden Town",273
"5629",2020,8,132,699,700,"51.52364804","-0.074754872","Bethnal Green Road, Shoreditch",1399
"5630",2020,8,133,312,334,NA,NA,NA,646
"5631",2020,8,134,104,109,"51.504904","-0.06797","Wapping High Street, Wapping",213
"5632",2020,8,135,353,362,"51.52326004","-0.104708922","Clerkenwell Green, Clerkenwell",715
"5633",2020,8,136,263,319,"51.51196176","-0.097441687","Queen Victoria Street, St. Paul's",582
"5634",2020,8,138,214,228,"51.51227622","-0.157436972","Green Street, Mayfair",442
"5635",2020,8,139,141,142,"51.49488108","-0.117974901","Lambeth Road, Vauxhall",283
"5636",2020,8,140,327,370,"51.52096262","-0.085634242","Finsbury Square , Moorgate",697
"5637",2020,8,141,219,230,"51.51530805","-0.147203711","Chapel Place, Marylebone",449
"5638",2020,8,142,128,118,"51.49372451","-0.198286569","West Cromwell Road, Earl's Court",246
"5639",2020,8,143,149,156,"51.4968865","-0.161203828","Pont Street, Knightsbridge",305
"5640",2020,8,144,365,336,"51.48894022","-0.111435796","Kennington Cross, Kennington",701
"5641",2020,8,145,42,36,"51.50074359","-0.202759212","Ilchester Place, Kensington",78
"5642",2020,8,146,95,110,"51.48836528","-0.129361842","Vauxhall Bridge , Pimlico",205
"5643",2020,8,148,251,235,"51.49211134","-0.138364847","Tachbrook Street, Victoria",486
"5644",2020,8,149,179,168,"51.48478899","-0.110683213","Kennington Road Post Office, Oval",347
"5645",2020,8,150,139,173,"51.49705603","-0.168917077","Holy Trinity Brompton, Knightsbridge",312
"5646",2020,8,151,116,73,"51.51213691","-0.201554966","Chepstow Villas, Notting Hill",189
"5647",2020,8,152,183,170,"51.49217002","-0.101536865","Hampton Street, Walworth",353
"5648",2020,8,153,358,355,"51.511933","-0.174411","Bayswater Road, Hyde Park",713
"5649",2020,8,154,1432,1425,"51.50379168","-0.11282408","Waterloo Station 3, Waterloo",2857
"5650",2020,8,155,161,164,"51.49586666","-0.191933711","Lexham Gardens, Kensington",325
"5651",2020,8,156,132,125,"51.49443626","-0.092921165","New Kent Road, The Borough",257
"5652",2020,8,157,184,219,"51.50039792","-0.193068385","Wright's Lane, Kensington",403
"5653",2020,8,158,149,134,"51.49085368","-0.196170309","Trebovir Road, Earl's Court",283
"5654",2020,8,159,402,480,"51.51461995","-0.137841333","Great Marlborough Street, Soho",882
"5655",2020,8,160,221,258,"51.50663341","-0.131773845","Waterloo Place, St. James's",479
"5656",2020,8,161,10,15,"51.49234577","-0.141334487","Guildhouse Street, Victoria",25
"5657",2020,8,162,251,263,"51.51760685","-0.121328408","Southampton Place, Holborn",514
"5658",2020,8,163,257,258,"51.4931848","-0.167894973","Sloane Avenue, Knightsbridge",515
"5659",2020,8,164,127,94,"51.515607","-0.183118788","Cleveland Gardens, Bayswater",221
"5660",2020,8,165,74,61,"51.517932","-0.183716959","Orsett Terrace, Bayswater",135
"5661",2020,8,166,200,200,"51.50185512","-0.159237081","Seville Street, Knightsbridge",400
"5662",2020,8,167,432,434,"51.49395092","-0.147624377","Eccleston Place, Victoria",866
"5663",2020,8,168,126,141,"51.50040123","-0.195455928","Argyll Road, Kensington",267
"5664",2020,8,169,246,205,"51.51474612","-0.165164288","Porchester Place, Paddington",451
"5665",2020,8,170,136,118,"51.52784273","-0.108068155","Hardwick Street, Clerkenwell",254
"5666",2020,8,171,112,107,"51.4916156","-0.186753859","Collingham Gardens, Earl's Court",219
"5667",2020,8,172,108,106,"51.49121192","-0.173715911","Sumner Place, South Kensington",214
"5668",2020,8,173,184,181,"51.50486","-0.113001","Waterloo Road, South Bank",365
"5669",2020,8,174,208,278,"51.512529","-0.115163","Strand, Strand",486
"5670",2020,8,175,279,316,"51.521668","-0.079608554","Worship Street, Shoreditch",595
"5671",2020,8,176,120,117,"51.51791921","-0.188098863","Gloucester Terrace, Bayswater",237
"5672",2020,8,177,336,388,"51.49616092","-0.140947636","Ashley Place, Victoria",724
"5673",2020,8,178,209,186,"51.48985626","-0.141923621","Warwick Square, Pimlico",395
"5674",2020,8,180,168,194,"51.5129118","-0.153645496","North Audley Street, Mayfair",362
"5675",2020,8,181,107,101,"51.49941247","-0.152317537","Belgrave Square, Belgravia",208
"5676",2020,8,182,189,199,"51.52202903","-0.165842551","Bell Street , Marylebone",388
"5677",2020,8,183,238,239,"51.482362","-0.13612398","Riverlight North, Nine Elms",477
"5678",2020,8,184,160,161,"51.52071513","-0.14521173","Portland Place, Marylebone",321
"5679",2020,8,185,239,225,"51.48805753","-0.140741432","Alderney Street, Pimlico",464
"5680",2020,8,186,524,484,"51.51733558","-0.175810943","South Wharf Road, Paddington",1008
"5681",2020,8,187,173,165,"51.49247977","-0.178433004","Queen's Gate (South), South Kensington",338
"5682",2020,8,188,103,103,"51.5165179","-0.164393768","Nutford Place, Marylebone",206
"5683",2020,8,189,124,79,"51.53166681","-0.109914711","Claremont Square, Angel",203
"5684",2020,8,190,224,187,"51.48997562","-0.132845681","Rampayne Street, Pimlico",411
"5685",2020,8,191,801,823,"51.50311799","-0.153520935","Hyde Park Corner, Hyde Park",1624
"5686",2020,8,192,367,405,"51.51251523","-0.133201961","Wardour Street, Soho",772
"5687",2020,8,193,332,422,"51.50581776","-0.100186337","Bankside Mix, Bankside",754
"5688",2020,8,194,629,955,"51.50462759","-0.091773776","Hop Exchange, The Borough",1584
"5689",2020,8,195,262,277,"51.50724437","-0.106237501","Milroy Walk, South Bank",539
"5690",2020,8,196,218,224,"51.50368837","-0.098497684","Union Street, The Borough",442
"5691",2020,8,197,211,304,"51.50556905","-0.111606696","Stamford Street, South Bank",515
"5692",2020,8,199,527,581,"51.51048489","-0.082989638","Great Tower Street, Monument",1108
"5693",2020,8,200,247,243,"51.51492456","-0.066078037","LMU Commercial Road, Whitechapel",490
"5694",2020,8,201,268,290,"51.5225965","-0.161113413","Dorset Square, Marylebone",558
"5695",2020,8,202,394,395,"51.51236389","-0.06954201","Leman Street, Aldgate",789
"5696",2020,8,203,310,301,"51.51821864","-0.100791005","West Smithfield Rotunda, Farringdon",611
"5697",2020,8,204,138,134,"51.52659961","-0.112432615","Margery Street, Clerkenwell",272
"5698",2020,8,206,283,304,"51.518154","-0.062697","New Road 1 , Whitechapel",587
"5699",2020,8,207,65,55,"51.50135267","-0.153194766","Grosvenor Crescent, Belgravia",120
"5700",2020,8,208,60,48,"51.52505151","-0.166304359","Mallory Street, Marylebone",108
"5701",2020,8,209,111,106,"51.49358391","-0.165101392","Denyer Street, Knightsbridge",217
"5702",2020,8,210,312,368,"51.51681444","-0.151926305","Hinde Street, Marylebone",680
"5703",2020,8,211,104,139,"51.49464523","-0.158105512","Cadogan Place, Knightsbridge",243
"5704",2020,8,212,82,61,"51.50658458","-0.199004026","Campden Hill Road, Notting Hill",143
"5705",2020,8,213,472,502,"51.50274025","-0.149569201","Wellington Arch, Hyde Park",974
"5706",2020,8,214,382,376,"51.52683806","-0.130504336","Endsleigh Gardens, Euston",758
"5707",2020,8,215,367,488,"51.51906932","-0.088285377","Moorfields, Moorgate",855
"5708",2020,8,216,170,175,"51.49094565","-0.181190899","Old Brompton Road, South Kensington",345
"5709",2020,8,217,735,765,"51.51615461","-0.082422399","Wormwood Street, Liverpool Street",1500
"5710",2020,8,218,150,157,"51.48971651","-0.170194408","St. Luke's Church, Chelsea",307
"5711",2020,8,219,206,190,"51.49016361","-0.19039362","Bramham Gardens, Earl's Court",396
"5712",2020,8,220,125,127,"51.49066456","-0.166485083","Chelsea Green, Chelsea",252
"5713",2020,8,221,212,229,"51.49481649","-0.13045856","Horseferry Road, Westminster",441
"5714",2020,8,222,149,82,"51.50275704","-0.155349725","Knightsbridge, Hyde Park",231
"5715",2020,8,223,186,161,"51.49148474","-0.090220911","Rodney Road , Walworth",347
"5716",2020,8,224,213,205,"51.51031","-0.18740235","Queensway, Kensington Gardens",418
"5717",2020,8,225,365,249,"51.50935342","-0.196422","Notting Hill Gate Station, Notting Hill",614
"5718",2020,8,226,31,39,"51.50844614","-0.131961389","Charles II Street, West End",70
"5719",2020,8,227,244,217,"51.52891573","-0.115480888","Great Percy Street, Clerkenwell",461
"5720",2020,8,228,460,637,"51.50742485","-0.134621209","St. James's Square, St. James's",1097
"5721",2020,8,229,433,480,"51.50654321","-0.123179697","Whitehall Place, Strand",913
"5722",2020,8,230,130,149,"51.50669284","-0.103137426","Poured Lines, Bankside",279
"5723",2020,8,231,166,164,"51.49396755","-0.17873226","Queen's Gate (Central), South Kensington",330
"5724",2020,8,232,90,97,"51.51501025","-0.112753217","Carey Street, Holborn",187
"5725",2020,8,233,305,405,"51.50777049","-0.130699733","Pall Mall East, West End",710
"5726",2020,8,234,257,253,"51.53450449","-0.106992706","Liverpool Road (N1 Centre), Angel",510
"5727",2020,8,235,169,128,"51.49571828","-0.110889274","Kennington Road  , Vauxhall",297
"5728",2020,8,236,146,150,"51.51838043","-0.073438925","Fashion Street, Whitechapel",296
"5729",2020,8,237,192,198,"51.5097860151","-0.0681619805156","Dock Street, Wapping",390
"5730",2020,8,238,103,65,"51.5233534","-0.175116099","Frampton Street, Paddington",168
"5731",2020,8,239,321,329,"51.52443845","-0.138019439","Warren Street Station, Euston",650
"5732",2020,8,240,87,89,"51.50545935","-0.10569204","Colombo Street, Southwark",176
"5733",2020,8,242,154,130,"51.52200801","-0.151359288","Beaumont Street, Marylebone",284
"5734",2020,8,243,245,195,"51.49096258","-0.139625122","Gloucester Street, Pimlico",440
"5735",2020,8,244,251,261,"51.51611887","-0.128585022","Earnshaw Street , Covent Garden",512
"5736",2020,8,245,121,92,"51.4853572","-0.142207481","Grosvenor Road, Pimlico",213
"5737",2020,8,246,353,393,"51.52285301","-0.099994052","Berry Street, Clerkenwell",746
"5738",2020,8,247,97,62,"51.530529","-0.167515","St. John's Wood Church, The Regent's Park",159
"5739",2020,8,248,334,350,"51.50645179","-0.170279555","Triangle Car Park, Hyde Park",684
"5740",2020,8,249,126,136,"51.49859784","-0.096191134","Harper Road, The Borough",262
"5741",2020,8,250,79,78,"51.489932","-0.162727","Royal Avenue 1, Chelsea",157
"5742",2020,8,251,581,691,"51.518908","-0.079249","Brushfield Street, Liverpool Street",1272
"5743",2020,8,252,282,363,"51.5046364","-0.116542278","Jubilee Gardens, South Bank",645
"5744",2020,8,253,293,232,"51.53404294","-0.086379717","Shoreditch Park, Hoxton",525
"5745",2020,8,254,213,186,"51.53051587","-0.106408455","Chadwell Street, Angel",399
"5746",2020,8,255,172,142,"51.52557531","-0.179592915","Clifton Road, Maida Vale",314
"5747",2020,8,256,152,143,"51.51362054","-0.116764211","Houghton Street, Strand",295
"5748",2020,8,257,159,152,"51.52248185","-0.154907218","Westminster University, Marylebone",311
"5749",2020,8,259,146,138,"51.490959","-0.1532331","Bourne Street, Belgravia",284
"5750",2020,8,260,216,218,"51.5136846","-0.135580879","Broadwick Street, Soho",434
"5751",2020,8,261,140,94,"51.5134891","-0.191351186","Princes Square, Bayswater",234
"5752",2020,8,262,146,132,"51.49874469","-0.103132904","LSBU (Borough Road), Elephant & Castle",278
"5753",2020,8,263,216,213,"51.51422502","-0.080660083","St. Mary Axe, Aldgate",429
"5754",2020,8,264,277,288,"51.52644342","-0.109256828","Tysoe Street, Clerkenwell",565
"5755",2020,8,265,180,131,"51.51595344","-0.169249375","Southwick Street, Paddington",311
"5756",2020,8,266,293,292,"51.50102668","-0.180246101","Queen's Gate (North), Kensington",585
"5757",2020,8,267,180,163,"51.49206037","-0.132224622","Regency Street, Westminster",343
"5758",2020,8,268,296,285,"51.49320445","-0.144132875","Belgrave Road, Victoria",581
"5759",2020,8,269,193,214,"51.50082346","-0.089740764","Empire Square, The Borough",407
"5760",2020,8,270,553,549,"51.4863434","-0.122492418","Kennington Lane Rail Bridge, Vauxhall",1102
"5761",2020,8,271,91,75,"51.53583617","-0.156285395","London Zoo,  The Regent's Park",166
"5762",2020,8,272,426,438,"51.50144456","-0.110699309","Baylis Road, Waterloo",864
"5763",2020,8,273,205,270,"51.50613324","-0.114686385","Belvedere Road 1, South Bank",475
"5764",2020,8,274,126,122,"51.49671237","-0.20528437","Warwick Road, Olympia",248
"5765",2020,8,275,241,243,"51.52004497","-0.092176447","Barbican Centre, Barbican",484
"5766",2020,8,276,127,136,"51.50930161","-0.084985356","Lower Thames Street, Monument",263
"5767",2020,8,277,215,215,"51.50315739","-0.191496313","Kensington Church Street, Kensington",430
"5768",2020,8,278,576,626,"51.5034938","-0.07962099","Tooley Street, Bermondsey",1202
"5769",2020,8,279,262,248,"51.51862243","-0.176645823","North Wharf Road, Paddington",510
"5770",2020,8,280,204,212,"51.490083","-0.162418","Royal Avenue 2, Chelsea",416
"5771",2020,8,281,193,211,"51.49580589","-0.127575233","Smith Square, Westminster",404
"5772",2020,8,282,402,408,"51.51906446","-0.059642081","Royal London Hospital, Whitechapel",810
"5773",2020,8,283,81,70,"51.51440928","-0.118478757","Kingsway, Covent Garden",151
"5774",2020,8,284,176,164,"51.49914063","-0.112031483","Lambeth North Station, Waterloo",340
"5775",2020,8,286,119,75,"51.5272947","-0.174653609","St. John's Wood Road, St. John's Wood",194
"5776",2020,8,287,109,128,"51.52367314","-0.128377673","Bedford Way, Bloomsbury",237
"5777",2020,8,288,274,311,"51.49236962","-0.147478734","Elizabeth Bridge, Victoria",585
"5778",2020,8,289,60,51,"51.50923022","-0.151296092","South Audley Street, Mayfair",111
"5779",2020,8,290,181,152,"51.518268","-0.17110323","St Mary's Hospital, Paddington",333
"5780",2020,8,291,207,174,"51.48483991","-0.138089062","Claverton Street, Pimlico",381
"5781",2020,8,292,191,214,"51.49888404","-0.165471605","Montpelier Street, Knightsbridge",405
"5782",2020,8,293,141,106,"51.49815779","-0.209494128","Kensington Olympia Station, Olympia",247
"5783",2020,8,294,257,234,"51.488226","-0.135635511","St. George's Square, Pimlico",491
"5784",2020,8,295,214,211,"51.50029631","-0.092762704","Swan Street, The Borough",425
"5785",2020,8,296,136,142,"51.49363156","-0.190603326","Knaresborough Place, Earl's Court",278
"5786",2020,8,297,73,57,"51.49612799","-0.106000855","Geraldine Street, Elephant & Castle",130
"5787",2020,8,298,375,379,"51.50227992","-0.074189225","Curlew Street, Shad Thames",754
"5788",2020,8,299,104,103,"51.49398524","-0.136928582","Vincent Square, Westminster",207
"5789",2020,8,300,361,350,"51.505014","-0.17306032","Serpentine Car Park, Hyde Park",711
"5790",2020,8,301,215,226,"51.51475963","-0.148105415","Marylebone Lane, Marylebone",441
"5791",2020,8,302,115,125,"51.466907","-0.216573","Putney Pier, Wandsworth",240
"5792",2020,8,303,447,469,"51.50295379","-0.158456089","Albert Gate, Hyde Park",916
"5793",2020,8,306,193,210,"51.51816295","-0.135025698","Rathbone Street, Fitzrovia",403
"5794",2020,8,307,485,495,"51.50990837","-0.187842717","Black Lion Gate, Kensington Gardens",980
"5795",2020,8,308,170,168,"51.49907558","-0.085666316","Long Lane , Bermondsey",338
"5796",2020,8,309,121,117,"51.50963123","-0.119047563","Embankment (Savoy), Strand",238
"5797",2020,8,310,235,224,"51.4908679","-0.116911864","Black Prince Road, Vauxhall",459
"5798",2020,8,311,199,200,"51.51918144","-0.140485596","Foley Street, Fitzrovia",399
"5799",2020,8,312,133,92,"51.53088935","-0.176770502","Grove End Road, St. John's Wood",225
"5800",2020,8,313,284,305,"51.51734403","-0.138072691","Wells Street, Fitzrovia",589
"5801",2020,8,314,202,204,"51.50088934","-0.083159352","Tyers Gate, Bermondsey",406
"5802",2020,8,315,116,113,"51.52536703","-0.153463612","The Tennis Courts, The Regent's Park",229
"5803",2020,8,316,200,240,NA,NA,NA,440
"5804",2020,8,317,73,68,"51.49679128","-0.093913472","Dickens Square, Borough",141
"5805",2020,8,318,219,241,"51.51004801","-0.138846453","Sackville Street, Mayfair",460
"5806",2020,8,319,229,258,"51.52702563","-0.088542771","Baldwin Street, St. Luke's",487
"5807",2020,8,320,273,299,"51.49357351","-0.139956043","Queen Mother Sports Centre, Victoria",572
"5808",2020,8,321,334,316,"51.49785559","-0.081608045","Bermondsey Street, Bermondsey",650
"5809",2020,8,322,124,101,"51.526293","-0.073955","Palissy Street, Shoreditch",225
"5810",2020,8,323,152,179,"51.523196","-0.083067","Clifton Street, Shoreditch",331
"5811",2020,8,324,248,245,"51.49652013","-0.101384068","Ontario Street, Elephant & Castle",493
"5812",2020,8,325,119,160,"51.50908747","-0.129697889","St. Martin's Street, West End",279
"5813",2020,8,326,335,299,"51.53266186","-0.099981142","Graham Street, Angel",634
"5814",2020,8,327,70,46,"51.53095","-0.085603","New North Road 1, Hoxton",116
"5815",2020,8,328,81,65,"51.53114","-0.086016","New North Road 2, Hoxton",146
"5816",2020,8,329,129,98,"51.53589283","-0.160854428","Prince Albert Road, The Regent's Park",227
"5817",2020,8,330,293,244,"51.51641749","-0.179135079","Eastbourne Mews, Paddington",537
"5818",2020,8,331,339,392,"51.52085887","-0.089887855","Bunhill Row, Moorgate",731
"5819",2020,8,332,101,84,"51.49334336","-0.194757949","Nevern Place, Earl's Court",185
"5820",2020,8,333,175,137,"51.50860544","-0.193764092","Palace Gardens Terrace, Notting Hill",312
"5821",2020,8,334,140,177,"51.505044","-0.115851","Concert Hall Approach 1, South Bank",317
"5822",2020,8,335,198,263,"51.51196803","-0.120718759","Tavistock Street, Covent Garden",461
"5823",2020,8,336,90,183,"51.504942","-0.115533","Concert Hall Approach 2, South Bank",273
"5824",2020,8,337,92,83,"51.51108452","-0.197524944","Pembridge Villas, Notting Hill",175
"5825",2020,8,338,325,335,"51.51175646","-0.119643424","Wellington Street , Strand",660
"5826",2020,8,339,103,62,"51.5333196","-0.1117812","Risinghill Street, Angel",165
"5827",2020,8,340,415,452,"51.51444134","-0.087587447","Bank of England Museum, Bank",867
"5828",2020,8,341,513,570,"51.50810309","-0.12602103","Craven Street, Strand",1083
"5829",2020,8,343,108,91,"51.53692216","-0.150181444","London Zoo Car Park, The Regent's Park",199
"5830",2020,8,344,167,137,"51.528246","-0.10102611","Goswell Road (City Uni), Finsbury",304
"5831",2020,8,345,302,319,"51.48802358","-0.166878535","Flood Street, Chelsea",621
"5832",2020,8,347,207,249,"51.50013942","-0.113936001","Lower Marsh, Waterloo",456
"5833",2020,8,348,160,195,"51.51217033","-0.150481272","Grosvenor Square, Mayfair",355
"5834",2020,8,349,171,234,"51.51196","-0.142783033","St. George Street, Mayfair",405
"5835",2020,8,350,310,303,"51.5017154373867","-0.1798541843891","Queen's Gate, Kensington Gardens",613
"5836",2020,8,351,216,174,"51.529423","-0.097122","Macclesfield Rd, St Lukes",390
"5837",2020,8,352,192,181,"51.486965","-0.116625","Vauxhall Street, Vauxhall",373
"5838",2020,8,353,60,63,"51.49459148","-0.134234258","Greycoat Street , Westminster",123
"5839",2020,8,354,306,378,"51.506767","-0.123702","Northumberland Avenue, Strand",684
"5840",2020,8,356,452,451,"51.494412","-0.173881","South Kensington Station, South Kensington",903
"5841",2020,8,357,291,311,"51.520994","-0.139016","Howland Street, Fitzrovia",602
"5842",2020,8,358,222,261,"51.516226","-0.124826","High Holborn , Covent Garden",483
"5843",2020,8,359,130,150,"51.49782999","-0.135440826","Butler Place, Westminster",280
"5844",2020,8,360,249,342,"51.49675303","-0.138733562","Howick Place, Westminster",591
"5845",2020,8,361,667,397,"51.50391973","-0.11342629","Waterloo Station 2, Waterloo",1064
"5846",2020,8,362,183,144,"51.536264","-0.133952","Royal College Street, Camden Town",327
"5847",2020,8,363,55,43,"51.5291212008901","-0.171185284853","Lord's, St. John's Wood",98
"5848",2020,8,364,281,287,"51.519656","-0.132339","Alfred Place, Bloomsbury",568
"5849",2020,8,365,178,169,"51.530344","-0.100168","City Road, Angel",347
"5850",2020,8,366,77,122,"51.5109192966489","-0.1511263847351","Millennium Hotel, Mayfair",199
"5851",2020,8,367,104,89,"51.5173721","-0.1642075","Harrowby Street, Marylebone",193
"5852",2020,8,368,175,189,"51.50024195","-0.15934065","Harriet Street, Knightsbridge",364
"5853",2020,8,370,41,41,"51.520205","-0.174593","Paddington Green, Paddington",82
"5854",2020,8,371,70,78,"51.49775","-0.10988","King Edward Walk, Waterloo",148
"5855",2020,8,372,186,202,"51.515208","-0.117863","Sardinia Street, Holborn",388
"5856",2020,8,373,197,227,"51.49980661","-0.176415994","Prince Consort Road, Knightsbridge",424
"5857",2020,8,374,1239,975,"51.50402794","-0.11386436","Waterloo Station 1, Waterloo",2214
"5858",2020,8,375,90,105,"51.50194596","-0.194392952","Kensington Town Hall, Kensington",195
"5859",2020,8,376,223,226,"51.49188409","-0.125674815","Millbank Tower, Pimlico",449
"5860",2020,8,377,76,101,"51.50535447","-0.113656543","Waterloo Bridge, South Bank",177
"5861",2020,8,378,103,134,"51.49559291","-0.179077626","Natural History Museum, South Kensington",237
"5862",2020,8,379,161,145,"51.51431171","-0.200838199","Turquoise Island, Notting Hill",306
"5863",2020,8,380,116,127,"51.50686435","-0.150666888","Stanhope Gate, Mayfair",243
"5864",2020,8,381,168,179,"51.51953043","-0.13577731","Charlotte Street, Fitzrovia",347
"5865",2020,8,382,114,118,"51.50935171","-0.14744969","Farm Street, Mayfair",232
"5866",2020,8,383,230,272,"51.51310333","-0.13121385","Frith Street, Soho",502
"5867",2020,8,384,83,71,"51.496481","-0.192404","Marloes Road, Kensington",154
"5868",2020,8,386,331,345,"51.51352755","-0.130110822","Moor Street, Soho",676
"5869",2020,8,387,219,215,"51.49369988","-0.121394101","Fire Brigade Pier, Vauxhall",434
"5870",2020,8,388,262,274,"51.51070161","-0.121723604","Southampton Street, Strand",536
"5871",2020,8,389,34,23,"51.51013066","-0.155757901","Upper Grosvenor Street, Mayfair",57
"5872",2020,8,390,112,129,"51.521776","-0.068856","Buxton Street 1, Shoreditch",241
"5873",2020,8,392,338,385,"51.49942855","-0.179702476","Imperial College, Knightsbridge",723
"5874",2020,8,393,308,327,"51.51733427","-0.103604248","Snow Hill, Farringdon",635
"5875",2020,8,394,122,78,"51.524826","-0.176268","Aberdeen Place, St. John's Wood",200
"5876",2020,8,395,232,259,"51.492462","-0.159919","Cadogan Gardens, Chelsea",491
"5877",2020,8,396,132,101,"51.51809","-0.163609","Shouldham Street, Marylebone",233
"5878",2020,8,397,221,194,"51.51348","-0.17977","Devonshire Terrace, Bayswater",415
"5879",2020,8,398,88,64,"51.502319","-0.200742","Holland Park, Kensington",152
"5880",2020,8,399,114,129,"51.52261762","-0.071653961","Brick Lane Market, Shoreditch",243
"5881",2020,8,401,220,201,"51.528187","-0.075375","Columbia Road, Shoreditch",421
"5882",2020,8,402,83,75,"51.52289229","-0.171681991","Penfold Street, Marylebone",158
"5883",2020,8,403,157,160,"51.51689296","-0.158249929","George Place Mews, Marylebone",317
"5884",2020,8,404,274,285,"51.50204238","-0.184400221","Palace Gate, Kensington Gardens",559
"5885",2020,8,405,383,381,"51.49418566","-0.18267094","Gloucester Road Station, South Kensington",764
"5886",2020,8,408,58,51,NA,NA,NA,109
"5887",2020,8,409,226,226,"51.493146","-0.099828","Strata, Elephant & Castle",452
"5888",2020,8,410,172,145,"51.519968","-0.169774","Edgware Road Station, Marylebone",317
"5889",2020,8,411,277,289,"51.49337264","-0.09968067","Walworth Road, Elephant & Castle",566
"5890",2020,8,412,123,105,"51.488105","-0.110121","Cleaver Street, Kennington",228
"5891",2020,8,419,143,121,"51.485821","-0.149004","Chelsea Bridge, Pimlico",264
"5892",2020,8,420,123,139,"51.504043","-0.105312","Southwark Station 1, Southwark",262
"5893",2020,8,421,273,272,"51.504044","-0.104778","Southwark Station 2, Southwark",545
"5894",2020,8,423,99,123,"51.49456127","-0.15393398","Eaton Square (South), Belgravia",222
"5895",2020,8,424,156,139,"51.490491","-0.149186","Ebury Bridge, Pimlico",295
"5896",2020,8,425,160,153,"51.533379","-0.139159","Harrington Square 2, Camden Town",313
"5897",2020,8,426,156,141,"51.493072","-0.129925","Vincent Street, Pimlico",297
"5898",2020,8,427,632,715,"51.51397065","-0.09294031","Cheapside, Bank",1347
"5899",2020,8,428,412,488,"51.499917","-0.174554","Exhibition Road, Knightsbridge",900
"5900",2020,8,430,96,78,"51.48902","-0.17524","South Parade, Chelsea",174
"5901",2020,8,431,115,111,"51.534474","-0.122203","Crinan Street, King's Cross",226
"5902",2020,8,432,272,280,"51.496957","-0.173894","Exhibition Road Museums, South Kensington",552
"5903",2020,8,433,290,271,"51.524564","-0.116279","Wren Street, Holborn",561
"5904",2020,8,435,192,176,"51.488852","-0.105593","Kennington Station, Kennington",368
"5905",2020,8,436,423,430,"51.51824","-0.11655","Red Lion Street, Holborn",853
"5906",2020,8,437,137,156,"51.488124","-0.120903","Vauxhall Walk, Vauxhall",293
"5907",2020,8,439,85,76,"51.5338","-0.118677","Killick Street, King's Cross",161
"5908",2020,8,440,166,162,"51.483145","-0.113134","Kennington Oval, Oval",328
"5909",2020,8,441,183,166,"51.495656","-0.114605","Sail Street, Vauxhall",349
"5910",2020,8,442,48,62,"51.510101","-0.211358","Walmer Road, Avondale",110
"5911",2020,8,443,179,162,"51.515256","-0.058641","Philpot Street, Whitechapel",341
"5912",2020,8,444,192,175,"51.52568","-0.055312","Bethnal Green Garden, Bethnal Green",367
"5913",2020,8,445,135,138,"51.52388","-0.065076","Cheshire Street, Bethnal Green",273
"5914",2020,8,446,226,235,"51.528936","-0.055894","York Hall, Bethnal Green",461
"5915",2020,8,447,47,44,"51.493381","-0.007542","Jubilee Crescent, Cubitt Town",91
"5916",2020,8,448,147,161,"51.50623","-0.02296","Fisherman's Walk West, Canary Wharf",308
"5917",2020,8,449,241,230,"51.511088","-0.057159","Shadwell Station, Shadwell",471
"5918",2020,8,450,157,130,"51.515975","-0.053177","Jubilee Street, Stepney",287
"5919",2020,8,451,169,134,"51.504719","-0.063531","Hermitage Court, Wapping",303
"5920",2020,8,452,148,152,"51.505697","-0.070542","St. Katharine's Way, Tower",300
"5921",2020,8,453,156,152,"51.508447","-0.055167","Garnet Street, Shadwell",308
"5922",2020,8,454,59,60,"51.487679","-0.021582","Napier Avenue, Millwall",119
"5923",2020,8,455,42,44,"51.49447","-0.014409","East Ferry Road, Cubitt Town",86
"5924",2020,8,456,124,140,"51.538071","-0.144664","Parkway, Camden Town",264
"5925",2020,8,457,225,222,"51.542138","-0.145393","Castlehaven Road, Camden Town",447
"5926",2020,8,458,169,181,"51.504749","-0.057544","Wapping Lane, Wapping",350
"5927",2020,8,459,178,161,"51.535179","-0.03338","Gunmakers Lane, Old Ford",339
"5928",2020,8,460,154,162,"51.516196","-0.029138","Burdett Road, Mile End",316
"5929",2020,8,461,107,103,"51.516","-0.038775","Aston Street, Stepney",210
"5930",2020,8,462,205,194,"51.541603","-0.138853","Bonny Street, Camden Town",399
"5931",2020,8,463,126,85,"51.534776","-0.071881","Thurtle Road, Haggerston",211
"5932",2020,8,464,62,54,"51.51417","-0.052099","St. Mary & St. Michael Church, Stepney",116
"5933",2020,8,465,267,229,"51.53558","-0.08249","Pitfield Street North,Hoxton",496
"5934",2020,8,466,189,133,"51.534464","-0.076341","Whiston Road, Haggerston",322
"5935",2020,8,467,118,87,"51.523538","-0.030556","Southern Grove, Bow",205
"5936",2020,8,468,52,34,"51.521564","-0.022694","Cantrell Road, Bow",86
"5937",2020,8,469,132,134,"51.513757","-0.020467","Lindfield Street, Poplar",266
"5938",2020,8,470,133,129,"51.530535","-0.025492","Mostyn Grove, Bow",262
"5939",2020,8,471,154,145,"51.533283","-0.028155","Hewison Street, Old Ford",299
"5940",2020,8,472,38,28,"51.529452","-0.027616","Malmesbury Road, Bow",66
"5941",2020,8,473,49,38,"51.496137","-0.019355","Millharbour, Millwall",87
"5942",2020,8,475,41,37,"51.499041","-0.020157","Lightermans Road, Millwall",78
"5943",2020,8,476,22,23,"51.489096","-0.009205","Stebondale Street, Cubitt Town",45
"5944",2020,8,477,49,45,"51.49109","-0.018716","Spindrift Avenue, Millwall",94
"5945",2020,8,478,280,270,"51.521889","-0.04667","Stepney Green Station, Stepney",550
"5946",2020,8,479,238,248,"51.527152","-0.058005","Pott Street, Bethnal Green",486
"5947",2020,8,480,312,293,"51.5128711","-0.0389866","Flamborough Street, Limehouse",605
"5948",2020,8,481,107,117,"51.487129","-0.009001","Saunders Ness Road, Cubitt Town",224
"5949",2020,8,483,161,139,"51.51328","-0.047784","Albert Gardens, Stepney",300
"5950",2020,8,484,63,63,"51.528828","-0.013258","Bromley High Street, Bow",126
"5951",2020,8,485,147,106,"51.531127","-0.048017","Old Ford Road, Bethnal Green",253
"5952",2020,8,486,278,249,"51.525645","-0.069543","Granby Street, Shoreditch",527
"5953",2020,8,488,191,173,"51.506946","-0.058681","Reardon Street, Wapping",364
"5954",2020,8,489,228,190,"51.513074","-0.064094","Christian Street, Whitechapel",418
"5955",2020,8,490,58,82,"51.508622","-0.065006","Pennington Street, Wapping",140
"5956",2020,8,491,297,304,"51.522507","-0.041378","Queen Mary's, Mile End",601
"5957",2020,8,492,246,267,"51.525501","-0.032267204","Maplin Street, Mile End",513
"5958",2020,8,494,1,5,"51.50196","-0.016251","South Quay East, Canary Wharf",6
"5959",2020,8,495,157,143,"51.528169","-0.018703","Bow Church Station, Bow",300
"5960",2020,8,496,85,83,"51.52512","-0.015578","Devons Road, Bow",168
"5961",2020,8,497,83,77,"51.526149","-0.027396845","Merchant Street, Bow",160
"5962",2020,8,498,153,120,"51.527058","-0.025296","Bow Road Station, Bow",273
"5963",2020,8,499,203,198,"51.519265","-0.021345","Furze Green, Bow",401
"5964",2020,8,500,260,217,"51.519806","-0.055731","Ansell House, Stepney",477
"5965",2020,8,501,144,131,"51.522561","-0.054883","Cephas Street, Bethnal Green",275
"5966",2020,8,502,178,168,"51.53341","-0.049591815","Bonner Gate, Victoria Park",346
"5967",2020,8,503,377,369,"51.520893","-0.051394","Cleveland Way, Stepney",746
"5968",2020,8,504,22,16,"51.496454","-0.009506","St. John's Park, Cubitt Town",38
"5969",2020,8,505,131,110,"51.520398","-0.026768","Ackroyd Drive, Bow",241
"5970",2020,8,506,180,198,"51.517475","-0.075855","Bell Lane, Liverpool Street",378
"5971",2020,8,507,90,70,"51.528692","-0.059091","Clarkson Street, Bethnal Green",160
"5972",2020,8,508,292,285,"51.519362","-0.074431","Fournier Street, Whitechapel",577
"5973",2020,8,509,181,193,"51.517842","-0.090075","Fore Street, Guildhall",374
"5974",2020,8,510,231,297,"51.509303","-0.025996","Westferry DLR, Limehouse",528
"5975",2020,8,511,258,232,"51.511066","-0.053558","Sutton Street, Shadwell",490
"5976",2020,8,512,361,324,"51.532091","-0.06142","Pritchard's Road, Bethnal Green",685
"5977",2020,8,513,120,112,"51.5142228","-0.055656","Watney Market, Stepney",232
"5978",2020,8,514,167,181,"51.516204","-0.155525","Portman Square, Marylebone",348
"5979",2020,8,515,81,86,"51.500088","-0.211316","Russell Gardens, Olympia",167
"5980",2020,8,516,71,76,"51.5112","-0.014438","Chrisp Street Market, Poplar",147
"5981",2020,8,517,45,41,"51.532513","-0.033085","Ford Road, Old Ford",86
"5982",2020,8,518,150,133,"51.528224","-0.037471","Antill Road, Mile End",283
"5983",2020,8,519,10,12,"51.518811","-0.011662","Teviot Street, Poplar",22
"5984",2020,8,520,185,155,"51.526041","-0.047218","Bancroft Road, Bethnal Green",340
"5985",2020,8,521,159,148,"51.534137","-0.037366","Driffield Road, Old Ford",307
"5986",2020,8,522,158,179,"51.525941","-0.036017","Clinton Road, Mile End",337
"5987",2020,8,523,18,30,"51.51549","-0.013475","Langdon Park, Poplar",48
"5988",2020,8,524,167,118,"51.511654","-0.179668","Lancaster Gate , Bayswater",285
"5989",2020,8,526,49,36,"51.503143","-0.008428","Lancaster Drive, Blackwall",85
"5990",2020,8,527,96,111,"51.503802","-0.215808","Hansard Mews, Holland Park",207
"5991",2020,8,528,106,120,"51.507326","-0.145827","Clarges Street, Mayfair",226
"5992",2020,8,529,136,129,"51.486892","-0.170983","Manresa Road, Chelsea",265
"5993",2020,8,530,35,36,"51.508896","-0.012413","Newby Place, Poplar",71
"5994",2020,8,531,229,198,"51.530326","-0.042744","Twig Folly Bridge, Mile End",427
"5995",2020,8,532,120,177,"51.50357","-0.020068","Jubilee Plaza, Canary Wharf",297
"5996",2020,8,533,184,164,"51.528222","-0.069743","Wellington Row, Bethnal Green",348
"5997",2020,8,534,245,212,"51.531864","-0.066035","Goldsmith's Row, Haggerston",457
"5998",2020,8,535,100,107,"51.537349","-0.147154","Gloucester Avenue, Camden Town",207
"5999",2020,8,536,116,82,"51.53385","-0.06992","Queensbridge Road, Haggerston",198
"6000",2020,8,537,253,258,"51.51793","-0.067937","Old Montague Street, Whitechapel",511
"6001",2020,8,538,54,51,"51.508981","-0.00699","Naval Row, Blackwall",105
"6002",2020,8,540,168,124,"51.528302","-0.144466","Albany Street, The Regent's Park",292
"6003",2020,8,541,407,403,"51.506613","-0.142844","Green Park Station, Mayfair",810
"6004",2020,8,542,151,117,"51.514115","-0.033828","Salmon Lane, Limehouse",268
"6005",2020,8,543,35,19,"51.509591","-0.204666","Lansdowne Walk, Ladbroke Grove",54
"6006",2020,8,544,157,161,"51.526153","-0.102208","Percival Street, Finsbury",318
"6007",2020,8,545,143,131,"51.539957","-0.145246","Arlington Road, Camden Town",274
"6008",2020,8,546,281,279,"51.517428","-0.107987","New Fetter Lane, Holborn",560
"6009",2020,8,547,41,40,"51.509474","-0.002275","East India DLR, Blackwall",81
"6010",2020,8,548,70,75,"51.498386","-0.107913","Westminster Bridge Road, Elephant & Castle",145
"6011",2020,8,549,136,124,"51.49605","-0.104193","Gaywood  Street, Elephant & Castle",260
"6012",2020,8,550,118,111,"51.521564","-0.039264","Harford Street, Mile End",229
"6013",2020,8,551,98,108,"51.505772","-0.016460175","Import Dock, Canary Wharf",206
"6014",2020,8,552,249,235,"51.511542","-0.056667","Watney Street, Shadwell",484
"6015",2020,8,553,507,474,"51.535678","-0.062546","Regent's Row , Haggerston",981
"6016",2020,8,554,30,24,"51.513548","-0.005659","Aberfeldy Street, Poplar",54
"6017",2020,8,556,61,79,"51.502661","-0.021596","Heron Quays DLR, Canary Wharf",140
"6018",2020,8,557,148,144,"51.51601","-0.0985","King Edward Street, St Pauls",292
"6019",2020,8,558,283,290,"51.493978","-0.127554","Page Street, Westminster",573
"6020",2020,8,559,46,43,"51.501391","-0.205991","Abbotsbury Road, Holland Park",89
"6021",2020,8,560,53,14,"51.511624","-0.205921","Ladbroke Grove Central, Ladbroke Grove",67
"6022",2020,8,561,102,71,"51.518369","-0.043371","Rectory Square, Stepney",173
"6023",2020,8,562,186,191,"51.51746","-0.12335","Bury Place, Holborn",377
"6024",2020,8,563,56,39,"51.499286","-0.009152","Preston's Road, Cubitt Town",95
"6025",2020,8,564,375,462,"51.509943","-0.117619","Somerset House, Strand",837
"6026",2020,8,565,97,93,"51.521905","-0.063386","Selby Street, Whitechapel",190
"6027",2020,8,566,108,150,"51.509158","-0.224103","Westfield Ariel Way, White City",258
"6028",2020,8,568,220,204,"51.51616","-0.18697","Bishop's Bridge Road West, Bayswater",424
"6029",2020,8,569,204,149,"51.53213","-0.08299","Pitfield Street Central, Hoxton",353
"6030",2020,8,570,195,199,"51.503083","-0.017676","Upper Bank Street, Canary Wharf",394
"6031",2020,8,571,89,76,"51.506256","-0.218337","Westfield Southern Terrace ,Shepherd's Bush",165
"6032",2020,8,572,188,173,"51.539099","-0.141728","Greenland Road, Camden Town",361
"6033",2020,8,573,361,371,"51.485587","-0.18119","Limerston Street, West Chelsea",732
"6034",2020,8,574,502,399,"51.53356","-0.09315","Eagle Wharf Road, Hoxton",901
"6035",2020,8,576,55,56,"51.497304","-0.022793","Alpha Grove, Millwall",111
"6036",2020,8,577,189,187,"51.528869","-0.047548","Globe Town Market, Bethnal Green",376
"6037",2020,8,578,104,115,"51.527607","-0.057133","Hollybush Gardens, Bethnal Green",219
"6038",2020,8,579,424,575,"51.511246","-0.093051","Queen Street 2, Bank",999
"6039",2020,8,580,172,165,"51.48692917","-0.102996299","Doddington Grove, Kennington",337
"6040",2020,8,581,258,266,"51.519167","-0.147983","New Cavendish Street, Marylebone",524
"6041",2020,8,583,239,325,"51.497622","-0.125978","Abingdon Green, Westminster",564
"6042",2020,8,584,189,170,"51.51244","-0.19096","Ilchester Gardens, Bayswater",359
"6043",2020,8,586,25,30,"51.490645","-0.014582","Mudchute DLR, Cubitt Town",55
"6044",2020,8,587,326,368,"51.50964","-0.08497","Monument Street, Monument",694
"6045",2020,8,588,118,123,"51.52959","-0.0801","Hoxton Street, Hoxton",241
"6046",2020,8,589,242,232,"51.487196","-0.179369","Drayton Gardens, West Chelsea",474
"6047",2020,8,590,75,53,"51.53256","-0.16862","Greenberry Street, St.John's Wood",128
"6048",2020,8,592,122,99,"51.5171","-0.18377","Bishop's Bridge Road East, Bayswater",221
"6049",2020,8,593,138,125,"51.531066","-0.11934","Northdown Street, King's Cross",263
"6050",2020,8,594,205,230,"51.513875","-0.117774","Kingsway Southbound, Strand",435
"6051",2020,8,595,229,228,"51.493267","-0.21985","Hammersmith Road, Hammersmith",457
"6052",2020,8,596,227,214,"51.472817","-0.199783","Parson's Green , Parson's Green",441
"6053",2020,8,597,126,125,"51.473471","-0.20782","Fulham Park Road, Fulham",251
"6054",2020,8,598,124,141,"51.494499","-0.228188","Southerton Road, Hammersmith",265
"6055",2020,8,599,97,93,"51.485743","-0.223616","Manbre Road, Hammersmith",190
"6056",2020,8,600,223,226,"51.481747","-0.124642","South Lambeth Road, Vauxhall",449
"6057",2020,8,601,133,145,"51.514767","-0.225787","BBC White City, White City",278
"6058",2020,8,602,164,157,"51.472993","-0.133972","Union Grove, Wandsworth Road",321
"6059",2020,8,603,139,172,"51.477839","-0.116493","Caldwell Street, Stockwell",311
"6060",2020,8,604,75,66,"51.538792","-0.138535","St Martins Close, Camden Town",141
"6061",2020,8,605,166,157,"51.520331","-0.163667","Seymour Place, Marylebone",323
"6062",2020,8,606,49,52,"51.504199","-0.210941","Addison Road, Holland Park",101
"6063",2020,8,607,137,135,"51.468814","-0.210279","Putney Bridge Station, Fulham",272
"6064",2020,8,608,19,11,"51.491093","-0.216493","Colet Gardens, Hammersmith",30
"6065",2020,8,609,94,60,"51.46512358","-0.157788279","Sugden Road, Clapham",154
"6066",2020,8,610,137,128,"51.48256792","-0.172078187","Danvers Street, West Chelsea",265
"6067",2020,8,611,76,57,"51.50646524","-0.208486599","Princedale Road , Holland Park",133
"6068",2020,8,612,166,148,"51.46925984","-0.141812513","Wandsworth Rd, Isley Court, Wandsworth Road",314
"6069",2020,8,613,275,270,"51.50403821","-0.217400093","Woodstock Grove, Shepherd's Bush",545
"6070",2020,8,614,71,64,"51.47817208","-0.144690541","Bradmead, Battersea Park",135
"6071",2020,8,615,144,136,"51.4768851","-0.215895601","Finlay Street, Fulham",280
"6072",2020,8,616,216,196,"51.48102131","-0.209973497","Aintree Street, Fulham",412
"6073",2020,8,617,100,83,"51.47107905","-0.207842908","Elysium Place, Fulham",183
"6074",2020,8,618,133,111,"51.47625965","-0.193254007","Eel Brook Common, Walham Green",244
"6075",2020,8,619,105,98,"51.4737636","-0.197010096","Irene Road, Parsons Green",203
"6076",2020,8,620,135,122,"51.47518024","-0.167160736","Surrey Lane, Battersea",257
"6077",2020,8,621,183,188,"51.46086446","-0.187427294","Wandsworth Town Station, Wandsworth",371
"6078",2020,8,622,189,177,"51.50748124","-0.205535908","Lansdowne Road, Ladbroke Grove",366
"6079",2020,8,623,56,55,"51.46193072","-0.180791784","Nantes Close, Wandsworth",111
"6080",2020,8,624,114,90,"51.4729184","-0.132102704","Courland Grove, Wandsworth Road",204
"6081",2020,8,625,226,203,"51.47761941","-0.149551631","Queen's Circus, Battersea Park",429
"6082",2020,8,626,213,206,"51.48438657","-0.20481514","Normand Park, West Kensington",419
"6083",2020,8,627,70,60,"51.4687905","-0.158230901","Holden Street, Battersea",130
"6084",2020,8,628,110,118,"51.46881971","-0.184318843","William Morris Way, Sands End",228
"6085",2020,8,629,29,14,"51.45995384","-0.190184054","Morie Street, Wandsworth",43
"6086",2020,8,630,91,71,"51.47073264","-0.126994068","Clarence Walk, Stockwell",162
"6087",2020,8,631,183,158,"51.4795017","-0.141770709","Battersea Park Road, Nine Elms",341
"6088",2020,8,632,94,85,"51.47053858","-0.163041605","Sheepcote Lane, Battersea",179
"6089",2020,8,633,165,167,"51.48959104","-0.209378594","Vereker Road, West Kensington",332
"6090",2020,8,634,99,90,"51.49434708","-0.215804559","Brook Green South, Brook Green",189
"6091",2020,8,635,166,155,"51.48606206","-0.214428378","Greyhound Road, Hammersmith",321
"6092",2020,8,636,158,129,"51.46706414","-0.193502076","South Park, Sands End",287
"6093",2020,8,637,37,22,"51.45787019","-0.174691623","Spencer Park, Wandsworth Common",59
"6094",2020,8,638,322,343,"51.46663393","-0.169821175","Falcon Road, Clapham Junction",665
"6095",2020,8,639,209,194,"51.48357068","-0.202038682","Coomer Place, West Kensington",403
"6096",2020,8,640,136,123,"51.47286577","-0.148059277","Silverthorne Road, Battersea",259
"6097",2020,8,641,124,129,"51.49824168","-0.117495865","Archbishop's Park, Waterloo",253
"6098",2020,8,642,70,52,"51.46916161","-0.174485792","Fawcett Close, Battersea",122
"6099",2020,8,643,98,83,"51.5190427","-0.204764421","All Saints' Road, Portobello",181
"6100",2020,8,644,155,168,"51.48373225","-0.223852256","Rainville Road, Hammersmith",323
"6101",2020,8,645,221,215,"51.50173215","-0.100292412","Great Suffolk Street, The Borough",436
"6102",2020,8,646,189,228,"51.49886563","-0.137424571","Buckingham Gate, Westminster",417
"6103",2020,8,647,112,106,"51.50035306","-0.217515071","Richmond Way, Shepherd's Bush",218
"6104",2020,8,648,53,51,"51.46904022","-0.19627483","Peterborough Road, Sands End",104
"6105",2020,8,649,138,149,"51.48180515","-0.18027465","World's End Place, West Chelsea",287
"6106",2020,8,650,125,119,"51.51687069","-0.213872396","St. Mark's Road, North Kensington",244
"6107",2020,8,651,140,107,"51.48089844","-0.183853573","Thorndike Close, West Chelsea",247
"6108",2020,8,652,52,54,"51.51148696","-0.218190203","Evesham Street, Avondale",106
"6109",2020,8,653,197,181,"51.47084722","-0.17070367","Simpson Street, Clapham Junction",378
"6110",2020,8,654,184,152,"51.48267821","-0.117661574","Ashmole Estate, Oval",336
"6111",2020,8,655,93,76,"51.48294452","-0.219346128","Crabtree Lane, Fulham",169
"6112",2020,8,656,59,55,"51.46841875","-0.199135704","Broomhouse Lane, Parsons Green",114
"6113",2020,8,657,76,74,"51.4996806","-0.221791552","Blythe Road West, Shepherd's Bush",150
"6114",2020,8,658,291,254,"51.47729232","-0.16478637","Ethelburga Estate, Battersea Park",545
"6115",2020,8,659,291,317,"51.511934","-0.10307894","Blackfriars Station, St. Paul's",608
"6116",2020,8,660,129,123,"51.49087074","-0.206029743","West Kensington Station, West Kensington",252
"6117",2020,8,661,248,256,"51.51632095","-0.202608612","All Saints Church, Portobello",504
"6118",2020,8,662,213,205,"51.48498496","-0.167919869","Phene Street, Chelsea",418
"6119",2020,8,663,89,84,"51.51323001","-0.211593602","Clarendon Road, Avondale",173
"6120",2020,8,664,170,145,"51.474376","-0.155442787","Austin Road, Battersea Park",315
"6121",2020,8,665,98,109,"51.46108367","-0.191722864","Smugglers Way, Wandsworth",207
"6122",2020,8,666,139,116,"51.49610093","-0.208158259","Olympia Way, Olympia",255
"6123",2020,8,667,105,106,"51.5015946","-0.222293381","Shepherd's Bush Road North, Shepherd's Bush",211
"6124",2020,8,668,143,157,"51.49422354","-0.236769936","Ravenscourt Park Station, Hammersmith",300
"6125",2020,8,669,80,83,"51.47614939","-0.1232585","Teversham Lane, Stockwell",163
"6126",2020,8,670,138,124,"51.46718562","-0.152248582","Ashley Crescent, Battersea",262
"6127",2020,8,671,264,315,"51.475089","-0.201968","Parsons Green Station, Parsons Green",579
"6128",2020,8,673,155,145,"51.46517078","-0.18038939","Hibbert Street, Battersea",300
"6129",2020,8,674,141,104,"51.53546778","-0.11619105","Carnegie Street, King's Cross",245
"6130",2020,8,675,103,98,"51.46348914","-0.182126248","Usk Road, Clapham Junction",201
"6131",2020,8,676,201,180,"51.47787084","-0.126874471","Hartington Road, Stockwell",381
"6132",2020,8,677,86,58,"51.46866929","-0.146544642","Heath Road, Battersea",144
"6133",2020,8,678,31,38,"51.46231278","-0.211468596","Esmond Street, Putney",69
"6134",2020,8,679,131,106,"51.47453545","-0.170210533","Orbel Street, Battersea",237
"6135",2020,8,680,283,269,"51.47768469","-0.170329317","Westbridge Road, Battersea",552
"6136",2020,8,681,113,102,"51.47303687","-0.214749808","Bishop's Avenue, Fulham",215
"6137",2020,8,682,152,163,"51.48810829","-0.22660621","Crisp Road, Hammersmith",315
"6138",2020,8,683,69,62,"51.46506424","-0.163750945","Dorothy Road, Clapham Junction",131
"6139",2020,8,684,95,84,"51.45475251","-0.195197203","Neville Gill Close, Wandsworth",179
"6140",2020,8,685,158,154,"51.46067005","-0.198735357","Osiers Road, Wandsworth",312
"6141",2020,8,686,156,158,"51.48814438","-0.222456468","Beryl Road, Hammersmith",314
"6142",2020,8,687,165,162,"51.49760804","-0.21145598","Maclise Road, Olympia",327
"6143",2020,8,688,54,45,"51.46095151","-0.20066766","Northfields, Wandsworth",99
"6144",2020,8,689,46,17,"51.45922541","-0.180884959","Spanish Road, Clapham Junction",63
"6145",2020,8,690,94,64,"51.47047503","-0.152130083","Stanley Grove, Battersea",158
"6146",2020,8,691,238,244,"51.47946386","-0.195777222","Erin Close, Walham Green",482
"6147",2020,8,692,191,186,"51.54211855","-0.028941601","Cadogan Close, Victoria Park",377
"6148",2020,8,693,62,64,"51.464786","-0.215618902","Felsham Road, Putney",126
"6149",2020,8,694,55,49,"51.46071722","-0.216526155","Putney Rail Station, Putney",104
"6150",2020,8,695,412,398,"51.53638435","-0.102757578","Islington Green, Angel",810
"6151",2020,8,696,200,196,"51.48728535","-0.217995921","Charing Cross Hospital, Hammersmith",396
"6152",2020,8,697,126,80,"51.53639219","-0.112721065","Charlotte Terrace, Angel",206
"6153",2020,8,698,173,125,"51.53908372","-0.070329419","Shoreditch Court, Haggerston",298
"6154",2020,8,699,123,79,"51.5366541","-0.07023031","Belford House, Haggerston",202
"6155",2020,8,700,147,111,"51.47696496","-0.174347066","Battersea Church Road, Battersea",258
"6156",2020,8,701,197,178,"51.47287627","-0.176267008","Vicarage Crescent, Battersea",375
"6157",2020,8,702,218,170,"51.52868155","-0.065550321","Durant Street, Bethnal Green",388
"6158",2020,8,703,288,409,"51.51505991","-0.10534448","St. Bride Street, Holborn",697
"6159",2020,8,704,48,23,"51.45682071","-0.202802098","Mexfield Road, East Putney",71
"6160",2020,8,705,54,56,NA,NA,NA,110
"6161",2020,8,706,203,221,"51.50215353","-0.083632928","Snowsfields, London Bridge",424
"6162",2020,8,707,313,299,"51.49021762","-0.215087092","Barons Court Station, West Kensington",612
"6163",2020,8,708,112,101,"51.46161068","-0.21614583","Disraeli Road, Putney",213
"6164",2020,8,709,60,51,"51.46321128","-0.215550761","Montserrat Road , Putney",111
"6165",2020,8,710,201,178,"51.47439218","-0.163347594","Albert Bridge Road, Battersea Park",379
"6166",2020,8,711,120,96,"51.48335692","-0.216305546","Everington Street, Fulham",216
"6167",2020,8,712,162,144,"51.51854104","-0.034903714","Mile End Stadium, Mile End",306
"6168",2020,8,713,66,61,"51.54100708","-0.14326094","Hawley Crescent, Camden Town",127
"6169",2020,8,714,79,65,"51.47311696","-0.137235175","Stewart's Road, Wandsworth Road",144
"6170",2020,8,715,99,76,"51.51563007","-0.049067243","Aylward Street, Stepney",175
"6171",2020,8,716,102,90,"51.51542791","-0.02356501","Stainsby Road , Poplar",192
"6172",2020,8,717,386,333,"51.53658514","-0.075885686","Dunston Road , Haggerston",719
"6173",2020,8,718,229,220,"51.53571683","-0.060291813","Ada Street, Hackney Central",449
"6174",2020,8,719,273,260,"51.53642464","-0.054162264","Victoria Park Road, Hackney Central",533
"6175",2020,8,720,129,117,"51.48724429","-0.205279052","Star Road, West Kensington",246
"6176",2020,8,721,115,91,"51.53603947","-0.026262677","Wendon Street, Old Ford",206
"6177",2020,8,722,155,136,"51.52458353","-0.058631453","Finnis Street, Bethnal Green",291
"6178",2020,8,723,235,228,"51.46822047","-0.190346493","Stephendale Road, Sands End",463
"6179",2020,8,724,97,47,"51.45799126","-0.184806157","Alma Road, Wandsworth",144
"6180",2020,8,725,235,225,"51.491327","-0.096518684","Walworth Square, Walworth",460
"6181",2020,8,726,162,158,"51.47505096","-0.150908371","Alfreda Street, Battersea Park",320
"6182",2020,8,727,170,168,"51.47569809","-0.20587627","Chesilton Road, Fulham",338
"6183",2020,8,728,57,51,"51.46199911","-0.206240805","Putney Bridge Road, East Putney",108
"6184",2020,8,729,223,203,"51.47893931","-0.208485293","St. Peter's Terrace, Fulham",426
"6185",2020,8,730,149,149,"51.49208492","-0.229116862","Bridge Avenue, Hammersmith",298
"6186",2020,8,731,153,148,"51.47727637","-0.189210466","Michael Road, Walham Green",301
"6187",2020,8,732,714,711,"51.50630441","-0.087262995","Duke Street Hill, London Bridge",1425
"6188",2020,8,733,102,104,"51.50542628","-0.150817316","Park Lane, Mayfair",206
"6189",2020,8,734,70,45,"51.46230566","-0.175407201","Plough Terrace, Clapham Junction",115
"6190",2020,8,735,234,231,"51.46489445","-0.17302926","Grant Road East, Clapham Junction",465
"6191",2020,8,736,47,37,"51.50659035","-0.216104479","Queensdale Road, Shepherd's Bush",84
"6192",2020,8,737,447,472,"51.47993289","-0.19411695","Fulham Broadway, Walham Green",919
"6193",2020,8,738,162,148,"51.47514228","-0.187278987","Imperial Road, Sands End",310
"6194",2020,8,739,162,148,"51.48176572","-0.185273723","Hortensia Road, West Brompton",310
"6195",2020,8,740,23,22,"51.51092871","-0.214594781","Sirdar Road, Avondale",45
"6196",2020,8,741,43,62,"51.5129814","-0.219486603","Freston Road, Avondale",105
"6197",2020,8,742,133,130,"51.51510818","-0.208565479","Blenheim Crescent, Ladbroke Grove",263
"6198",2020,8,743,23,23,"51.46079243","-0.212607684","Oxford Road, Putney",46
"6199",2020,8,744,30,28,"51.46745485","-0.172293499","Ingrave Street, Clapham Junction",58
"6200",2020,8,745,98,72,"51.47816972","-0.18243547","Upcerne Road, West Chelsea",170
"6201",2020,8,746,147,136,"51.4795738","-0.17903854","Lots Road, West Chelsea",283
"6202",2020,8,747,127,112,"51.48796408","-0.161765173","Ormonde Gate, Chelsea",239
"6203",2020,8,748,271,212,"51.53727795","-0.079201849","Hertford Road, De Beauvoir Town",483
"6204",2020,8,749,247,218,"51.53932857","-0.074284675","Haggerston Road, Haggerston",465
"6205",2020,8,750,56,47,"51.4710956","-0.157850096","Culvert Road, Battersea",103
"6206",2020,8,751,114,153,"51.51612862","-0.120909408","Newton Street, Covent Garden",267
"6207",2020,8,754,70,69,"51.5129006","-0.214762686","Grenfell Road, Avondale",139
"6208",2020,8,755,234,228,"51.48512191","-0.174971902","The Vale, Chelsea",462
"6209",2020,8,756,127,126,"51.47515398","-0.159169801","Prince of Wales Drive, Battersea Park",253
"6210",2020,8,757,174,154,"51.48795853","-0.187404506","Harcourt Terrace, West Brompton",328
"6211",2020,8,758,113,106,"51.51787005","-0.201005397","Westbourne Park Road, Portobello",219
"6212",2020,8,759,58,55,"51.52456169","-0.165668686","Broadley Terrace, Marylebone",113
"6213",2020,8,760,86,75,"51.52526975","-0.163795009","Rossmore Road, Marylebone",161
"6214",2020,8,761,174,147,"51.48321729","-0.211860644","Humbolt Road, Fulham",321
"6215",2020,8,762,462,545,"51.50070305","-0.129698963","Storey's Gate, Westminster",1007
"6216",2020,8,763,170,141,"51.52059714","-0.032566533","Mile End Park Leisure Centre, Mile End",311
"6217",2020,8,764,133,195,"51.46239255","-0.16829214","St. John's Road, Clapham Junction",328
"6218",2020,8,765,65,67,"51.46760141","-0.20682737","Ranelagh Gardens, Fulham",132
"6219",2020,8,766,169,190,"51.45752945","-0.192165613","Ram Street, Wandsworth",359
"6220",2020,8,767,29,20,"51.45705988","-0.200806304","Santos Road, Wandsworth",49
"6221",2020,8,768,111,100,"51.46134382","-0.159322467","Clapham Common North Side, Clapham Common",211
"6222",2020,8,769,177,178,"51.473611","-0.191803","Sandilands Road, Walham Green",355
"6223",2020,8,770,104,88,"51.491026","-0.209121","Gwendwr Road, West Kensington",192
"6224",2020,8,771,51,60,"51.509224","-0.216016","Rifle Place, Avondale",111
"6225",2020,8,772,280,279,"51.47250956","-0.122831913","Binfield Road, Stockwell",559
"6226",2020,8,773,298,346,"51.511891","-0.107349","Tallis Street, Temple",644
"6227",2020,8,774,45,46,"51.470131","-0.20464","Hurlingham Park, Parsons Green",91
"6228",2020,8,775,110,110,"51.496664","-0.223868","Little Brook Green, Brook Green",220
"6229",2020,8,776,87,86,"51.460333","-0.167029","Abyssinia Close, Clapham Junction",173
"6230",2020,8,777,39,22,"51.4619230679","-0.165297856693","Limburg Road, Clapham Junction",61
"6231",2020,8,779,206,240,"51.514449","-0.077178979","Houndsditch, Aldgate",446
"6232",2020,8,780,283,300,"51.474665","-0.18316517","Imperial Wharf Station, Sands End",583
"6233",2020,8,781,248,237,"51.495898","-0.173009","Victoria & Albert Museum, South Kensington",485
"6234",2020,8,782,183,127,"51.483911","-0.19760944","Halford Road, West Kensington",310
"6235",2020,8,783,246,237,"51.5403115","-0.021630359","Monier Road, Hackney Wick",483
"6236",2020,8,784,99,98,"51.546326","-0.00993526","East Village, Queen Elizabeth Olympic Park",197
"6237",2020,8,785,552,566,"51.54094","-0.010510565","Aquatic Centre, Queen Elizabeth Olympic Park",1118
"6238",2020,8,786,106,106,"51.549369","-0.015717614","Lee Valley VeloPark, Queen Elizabeth Olympic Park",212
"6239",2020,8,787,97,114,"51.546805","-0.01469126","Timber Lodge, Queen Elizabeth Olympic Park",211
"6240",2020,8,789,138,119,"51.538718","-0.011889482","Podium, Queen Elizabeth Olympic Park",257
"6241",2020,8,790,187,188,"51.541793","-0.00481","Stratford Station, Stratford",375
"6242",2020,8,792,217,243,"51.505461","-0.10454093","Blackfriars Road, Southwark",460
"6243",2020,8,793,89,84,"51.528279","-0.11955857","Cromer Street, Bloomsbury",173
"6244",2020,8,795,158,139,"51.527068","-0.13186102","Euston Square Gardens, Euston",297
"6245",2020,8,796,136,128,"51.524","-0.12640984","Coram Street, Bloomsbury",264
"6246",2020,8,797,221,225,"51.5293","-0.12827903","Ossulston Street, Somers Town",446
"6247",2020,8,798,252,278,"51.5301998755","-0.122299440803","Birkenhead Street, King's Cross",530
"6248",2020,8,799,108,152,"51.4976984561","-0.137598896295","Kings Gate House, Westminster",260
"6249",2020,8,800,206,192,"51.4811219398","-0.149035374873","Sopwith Way, Battersea Park",398
"6250",2020,8,801,242,262,"51.5052241745","-0.0980318118664","Lavington Street, Bankside",504
"6251",2020,8,802,179,129,"51.4765900593","-0.118256789081","Albert Square, Stockwell",308
"6252",2020,8,803,180,182,"51.5054099403","-0.0983410884509","Southwark Street, Bankside",362
"6253",2020,8,804,337,326,"51.5346677396","-0.125078652873","Good's Way, King's Cross",663
"6254",2020,8,806,181,138,"51.5372405623","-0.124807385707","Handyside Street, King's Cross",319
"6255",2020,8,807,157,145,"51.5212","-0.20888818","Bevington Road West, North Kensington",302
"6256",2020,8,809,161,193,"51.5162778834","-0.118272991635","Lincoln's Inn Fields, Holborn",354
"6257",2020,8,810,261,304,"51.5067252868","-0.0988072461627","Tate Modern, Bankside",565
"6258",2020,8,811,223,261,"51.5057030357","-0.0277727426235","Westferry Circus, Canary Wharf",484
"6259",2020,8,812,48,59,"51.5487311915","-0.0226065549321","Here East North, Queen Elizabeth Olympic Park",107
"6260",2020,8,813,174,197,"51.4878074485","-0.122759625866","New Spring Gardens Walk, Vauxhall",371
"6261",2020,8,814,144,148,"51.4714330677","-0.123670735702","Clapham Road, Lingham Street, Stockwell",292
"6262",2020,8,815,336,365,"51.5000891978","-0.116628700672","Lambeth Palace Road, Waterloo",701
"6263",2020,8,816,34,51,"51.5465327935","-0.0205975904647","Here East South, Queen Elizabeth Olympic Park",85
"6264",2020,8,817,252,210,"51.4813354746","-0.138212295869","Riverlight South, Nine Elms",462
"6265",2020,8,818,397,412,"51.501513","-0.12382322","Westminster Pier, Westminster",809
"6266",2020,8,819,153,200,"51.50621","-0.114842","Belvedere Road 2, South Bank",353
"6267",2020,8,820,166,138,"51.492807","-0.091938","Victory Place, Walworth",304
"6268",2020,8,821,332,310,"51.4835074867","-0.147714557371","Battersea Power Station, Battersea Park",642
"6269",2020,8,826,422,451,"51.496863","-0.1429434","Allington Street, Victoria",873
"6270",2020,8,827,206,195,"51.479601","-0.11147178","Cranmer Road, Stockwell",401
"6271",2020,8,828,157,148,"51.473874","-0.11258096","Normandy Road, Stockwell",305
"6272",2020,8,829,55,35,"51.469217","-0.11268674","Wynne Road, Stockwell",90
"6273",2020,8,830,96,78,"51.469202","-0.11902256","Sidney Road, Stockwell",174
"6274",2020,8,831,104,86,"51.466232","-0.11317995","St John's Crescent, Brixton",190
"6275",2020,8,832,156,145,"51.464019","-0.11578197","Ferndale Road, Brixton",301
"6276",2020,8,833,108,97,"51.460232","-0.11537509","Saltoun Road, Brixton",205
"6277",2020,8,834,184,168,"51.477966","-0.14785703","Gas Holders, Battersea Park",352
"6278",2020,8,835,165,170,"51.516785","-0.10494775","Farringdon Street, Holborn",335
"6279",2020,8,836,90,94,"51.541596","-0.12544145","York Way, Kings Cross",184
"6280",2020,8,838,150,155,"51.518093","-0.0914017","Fore Street Avenue, Guildhall",305
"6281",2020,8,839,303,329,"51.508033","-0.10682363","Sea Containers, South Bank",632
"6282",2020,9,1,146,92,"51.52916347","-0.109970527","River Street , Clerkenwell",238
"6283",2020,9,2,179,194,"51.49960695","-0.197574246","Phillimore Gardens, Kensington",373
"6284",2020,9,3,217,229,"51.52128377","-0.084605692","Christopher Street, Liverpool Street",446
"6285",2020,9,4,88,162,"51.53005939","-0.120973687","St. Chad's Street, King's Cross",250
"6286",2020,9,5,287,339,"51.49313","-0.156876","Sedding Street, Sloane Square",626
"6287",2020,9,6,212,224,"51.51811784","-0.144228881","Broadcasting House, Marylebone",436
"6288",2020,9,7,99,86,"51.53430039","-0.1680743","Charlbert Street, St. John's Wood",185
"6289",2020,9,8,131,142,"51.529857","-0.18348604","Maida Vale, Maida Vale",273
"6290",2020,9,9,197,194,"51.5073853","-0.096440751","New Globe Walk, Bankside",391
"6291",2020,9,10,86,94,"51.50597426","-0.092754157","Park Street, Bankside",180
"6292",2020,9,11,199,184,"51.52395143","-0.122502346","Brunswick Square, Bloomsbury",383
"6293",2020,9,12,432,433,"51.52168078","-0.130431727","Malet Street, Bloomsbury",865
"6294",2020,9,13,132,135,"51.51991453","-0.136039674","Scala Street, Fitzrovia",267
"6295",2020,9,14,1392,1430,"51.52994371","-0.123616824","Belgrove Street , King's Cross",2822
"6296",2020,9,15,211,234,"51.51772703","-0.127854211","Great Russell Street, Bloomsbury",445
"6297",2020,9,16,234,222,"51.52635795","-0.125979294","Cartwright Gardens , Bloomsbury",456
"6298",2020,9,17,334,347,"51.5216612","-0.109006325","Hatton Wall, Holborn",681
"6299",2020,9,18,349,334,"51.51477076","-0.12221963","Drury Lane, Covent Garden",683
"6300",2020,9,19,317,301,"51.52505093","-0.131161087","Taviton Street, Bloomsbury",618
"6301",2020,9,20,173,127,"51.527326","-0.13605286","Drummond Street , Euston",300
"6302",2020,9,21,61,54,"51.53007835","-0.13884627","Hampstead Road (Cartmel), Euston",115
"6303",2020,9,22,273,274,"51.5222641","-0.114079481","Northington Street , Holborn",547
"6304",2020,9,23,153,149,"51.51943538","-0.119123345","Red Lion Square, Holborn",302
"6305",2020,9,24,269,276,"51.51908011","-0.124678402","British Museum, Bloomsbury",545
"6306",2020,9,25,362,322,"51.5288338","-0.132250369","Doric Way , Somers Town",684
"6307",2020,9,26,150,127,"51.52728093","-0.11829517","Ampton Street , Clerkenwell",277
"6308",2020,9,27,237,262,"51.51382102","-0.107927706","Bouverie Street, Temple",499
"6309",2020,9,28,236,230,"51.52351808","-0.143613641","Bolsover Street, Fitzrovia",466
"6310",2020,9,29,184,147,"51.513735","-0.193487","Hereford Road, Bayswater",331
"6311",2020,9,30,212,175,"51.52915444","-0.093421615","Windsor Terrace, Hoxton",387
"6312",2020,9,31,245,221,"51.52953709","-0.083353323","Fanshaw Street, Hoxton",466
"6313",2020,9,32,411,427,"51.52469624","-0.084439283","Leonard Circus , Shoreditch",838
"6314",2020,9,33,193,184,"51.5156","-0.070056","Central House, Aldgate",377
"6315",2020,9,34,115,108,"51.5341235","-0.129386874","Pancras Road, King's Cross",223
"6316",2020,9,36,183,181,"51.50173726","-0.184980612","De Vere Gardens, Kensington",364
"6317",2020,9,37,205,184,"51.49159394","-0.192369256","Penywern Road, Earl's Court",389
"6318",2020,9,38,103,96,"51.4973875","-0.197245586","Abingdon Villas, Kensington",199
"6319",2020,9,39,439,409,"51.5263778","-0.078130921","Shoreditch High Street, Shoreditch",848
"6320",2020,9,40,121,142,"51.52127071","-0.0755789","Commercial Street, Shoreditch",263
"6321",2020,9,41,308,343,"51.520955","-0.083493552","Pindar Street, Liverpool Street",651
"6322",2020,9,42,215,162,"51.53099181","-0.093903825","Wenlock Road , Hoxton",377
"6323",2020,9,43,235,229,"51.52026","-0.157183945","Crawford Street, Marylebone",464
"6324",2020,9,44,130,132,"51.51073687","-0.144165239","Bruton Street, Mayfair",262
"6325",2020,9,45,337,365,"51.522511","-0.162298","Boston Place, Marylebone",702
"6326",2020,9,46,400,383,"51.507131","-0.06691","Nesham Street, Wapping",783
"6327",2020,9,47,223,214,"51.52334476","-0.183846408","Warwick Avenue Station, Maida Vale",437
"6328",2020,9,48,238,322,"51.51248445","-0.099141408","Godliman Street, St. Paul's",560
"6329",2020,9,49,119,142,"51.50706909","-0.145904427","Curzon Street, Mayfair",261
"6330",2020,9,50,181,178,"51.52867339","-0.087459376","East Road, Hoxton",359
"6331",2020,9,51,161,153,"51.52671796","-0.104298194","Finsbury Library , Finsbury",314
"6332",2020,9,52,161,187,"51.52295439","-0.094934859","Roscoe Street, St. Luke's",348
"6333",2020,9,53,129,120,"51.5099923","-0.143495266","Grafton Street, Mayfair",249
"6334",2020,9,54,207,221,"51.52174785","-0.094475072","Golden Lane, Barbican",428
"6335",2020,9,55,542,667,"51.51707521","-0.086685542","Finsbury Circus, Liverpool Street",1209
"6336",2020,9,56,179,197,"51.52058381","-0.154701411","Paddington Street, Marylebone",376
"6337",2020,9,57,266,248,"51.52334672","-0.120202614","Guilford Street , Bloomsbury",514
"6338",2020,9,58,281,286,"51.52452699","-0.079248081","New Inn Yard, Shoreditch",567
"6339",2020,9,60,95,55,"51.52644828","-0.172190727","Lisson Grove, St. John's Wood",150
"6340",2020,9,61,224,217,"51.49738251","-0.089446947","Great Dover Street, The Borough",441
"6341",2020,9,62,106,97,"51.4907579","-0.106323685","Cotton Garden Estate, Kennington",203
"6342",2020,9,63,110,91,"51.53089041","-0.089782579","Murray Grove , Hoxton",201
"6343",2020,9,64,315,405,"51.50946212","-0.124749274","William IV Street, Strand",720
"6344",2020,9,65,191,175,NA,NA,NA,366
"6345",2020,9,66,562,813,"51.51795029","-0.108657431","Holborn Circus, Holborn",1375
"6346",2020,9,67,311,271,"51.51882555","-0.108028472","Hatton Garden, Holborn",582
"6347",2020,9,68,300,271,"51.52059681","-0.116688468","Theobald's Road , Holborn",571
"6348",2020,9,69,193,196,"51.5262363","-0.134407652","Euston Road, Euston",389
"6349",2020,9,70,83,63,"51.53136059","-0.117069978","Calshot Street , King's Cross",146
"6350",2020,9,71,512,504,"51.5154186","-0.098850915","Newgate Street , St. Paul's",1016
"6351",2020,9,72,196,175,"51.52352001","-0.108340165","Farringdon Lane, Clerkenwell",371
"6352",2020,9,73,480,467,"51.52572618","-0.088486188","Old Street Station, St. Luke's",947
"6353",2020,9,74,425,424,"51.48591714","-0.124469948","Vauxhall Cross, Vauxhall",849
"6354",2020,9,75,216,210,"51.53219984","-0.105480698","Torrens Street, Angel",426
"6355",2020,9,76,98,90,"51.52559505","-0.144083893","Longford Street, The Regent's Park",188
"6356",2020,9,77,233,236,"51.52341837","-0.124121774","Russell Square Station, Bloomsbury",469
"6357",2020,9,78,216,211,"51.52486887","-0.099489485","Sadlers Sports Centre, Finsbury",427
"6358",2020,9,79,100,122,"51.511726","-0.11385596","Arundel Street, Temple",222
"6359",2020,9,80,177,140,"51.50069361","-0.102091246","Webber Street , Southwark",317
"6360",2020,9,81,179,205,"51.52025302","-0.141327271","Great Titchfield Street, Fitzrovia",384
"6361",2020,9,82,158,155,"51.514274","-0.111257","Chancery Lane, Holborn",313
"6362",2020,9,83,254,265,"51.50963938","-0.131510949","Panton Street, West End",519
"6363",2020,9,84,187,174,"51.51593725","-0.111778348","Breams Buildings, Holborn",361
"6364",2020,9,85,260,260,"51.50064702","-0.078600401","Tanner Street, Bermondsey",520
"6365",2020,9,86,137,129,"51.48947903","-0.115156562","Sancroft Street, Vauxhall",266
"6366",2020,9,87,237,250,"51.51646835","-0.079684557","Devonshire Square, Liverpool Street",487
"6367",2020,9,88,287,296,"51.51858757","-0.132053392","Bayley Street , Bloomsbury",583
"6368",2020,9,89,180,192,"51.5262503","-0.123509611","Tavistock Place, Bloomsbury",372
"6369",2020,9,90,57,59,"51.53301907","-0.139174593","Harrington Square 1, Camden Town",116
"6370",2020,9,91,176,154,"51.49368637","-0.111014912","Walnut Tree Walk, Vauxhall",330
"6371",2020,9,92,150,169,"51.49889832","-0.100440521","Borough Road, Elephant & Castle",319
"6372",2020,9,93,181,85,"51.53440868","-0.109025404","Cloudesley Road, Angel",266
"6373",2020,9,94,239,238,"51.49506109","-0.085814489","Bricklayers Arms, Borough",477
"6374",2020,9,95,371,382,"51.5208417","-0.097340162","Aldersgate Street, Barbican",753
"6375",2020,9,96,175,169,"51.53095071","-0.078505384","Falkirk Street, Hoxton",344
"6376",2020,9,97,196,184,"51.49792478","-0.183834706","Gloucester Road (North), Kensington",380
"6377",2020,9,98,254,204,"51.52554222","-0.138231303","Hampstead Road, Euston",458
"6378",2020,9,99,300,284,"51.51457763","-0.158264483","Old Quebec Street, Marylebone",584
"6379",2020,9,100,144,136,"51.49043573","-0.122806861","Albert Embankment, Vauxhall",280
"6380",2020,9,101,555,588,"51.51155322","-0.0929401","Queen Street 1, Bank",1143
"6381",2020,9,102,294,292,"51.51340693","-0.076793375","Jewry Street, Aldgate",586
"6382",2020,9,103,103,80,"51.50472376","-0.192538767","Vicarage Gate, Kensington",183
"6383",2020,9,104,611,589,"51.51159481","-0.077121322","Crosswall, Tower",1200
"6384",2020,9,105,173,159,"51.51552971","-0.190240716","Westbourne Grove, Bayswater",332
"6385",2020,9,106,116,92,"51.51410514","-0.147301667","Woodstock Street, Mayfair",208
"6386",2020,9,107,459,460,"51.52600832","-0.096317627","Finsbury Leisure Centre, St. Luke's",919
"6387",2020,9,108,304,312,"51.49812559","-0.132102166","Abbey Orchard Street, Westminster",616
"6388",2020,9,109,441,516,"51.51563144","-0.132328837","Soho Square , Soho",957
"6389",2020,9,110,107,91,"51.53304322","-0.172528678","Wellington Road, St. John's Wood",198
"6390",2020,9,111,256,283,"51.5100172","-0.157275636","Park Lane , Hyde Park",539
"6391",2020,9,112,221,186,"51.51580998","-0.105270275","Stonecutter Street, Holborn",407
"6392",2020,9,113,155,157,"51.49646288","-0.183289032","Gloucester Road (Central), South Kensington",312
"6393",2020,9,114,179,184,"51.52451738","-0.158963647","Park Road (Baker Street), The Regent's Park",363
"6394",2020,9,115,337,342,"51.51423368","-0.073537654","Braham Street, Aldgate",679
"6395",2020,9,116,342,358,"51.51449962","-0.141423695","Little Argyll Street, West End",700
"6396",2020,9,117,261,251,"51.49288067","-0.114934001","Lollard Street, Vauxhall",512
"6397",2020,9,118,132,184,"51.49582705","-0.13547809","Rochester Row, Westminster",316
"6398",2020,9,119,347,348,"51.52589324","-0.090847761","Bath Street, St. Luke's",695
"6399",2020,9,120,154,176,"51.51573534","-0.093080779","The Guildhall, Guildhall",330
"6400",2020,9,121,212,236,"51.51891348","-0.156166631","Baker Street, Marylebone",448
"6401",2020,9,122,229,259,"51.52111369","-0.078869751","Norton Folgate, Liverpool Street",488
"6402",2020,9,123,132,110,"51.52836014","-0.104724625","St. John Street, Finsbury",242
"6403",2020,9,124,104,99,"51.49654462","-0.150905245","Eaton Square, Belgravia",203
"6404",2020,9,125,186,180,"51.50069491","-0.094524319","Borough High Street, The Borough",366
"6405",2020,9,126,323,335,"51.51782144","-0.096496865","Museum of London, Barbican",658
"6406",2020,9,127,152,173,"51.51700801","-0.09388536","Wood Street, Guildhall",325
"6407",2020,9,128,141,132,"51.49536226","-0.185296516","Emperor's Gate, South Kensington",273
"6408",2020,9,129,174,203,"51.5118973","-0.137043852","Golden Square, Soho",377
"6409",2020,9,130,309,320,"51.50950627","-0.075459482","Tower Gardens , Tower",629
"6410",2020,9,131,130,109,"51.53300545","-0.136792671","Eversholt Street , Camden Town",239
"6411",2020,9,132,561,606,"51.52364804","-0.074754872","Bethnal Green Road, Shoreditch",1167
"6412",2020,9,133,283,361,NA,NA,NA,644
"6413",2020,9,134,99,104,"51.504904","-0.06797","Wapping High Street, Wapping",203
"6414",2020,9,135,331,343,"51.52326004","-0.104708922","Clerkenwell Green, Clerkenwell",674
"6415",2020,9,136,300,288,"51.51196176","-0.097441687","Queen Victoria Street, St. Paul's",588
"6416",2020,9,138,181,184,"51.51227622","-0.157436972","Green Street, Mayfair",365
"6417",2020,9,139,159,153,"51.49488108","-0.117974901","Lambeth Road, Vauxhall",312
"6418",2020,9,140,322,341,"51.52096262","-0.085634242","Finsbury Square , Moorgate",663
"6419",2020,9,141,225,221,"51.51530805","-0.147203711","Chapel Place, Marylebone",446
"6420",2020,9,142,126,102,"51.49372451","-0.198286569","West Cromwell Road, Earl's Court",228
"6421",2020,9,143,148,160,"51.4968865","-0.161203828","Pont Street, Knightsbridge",308
"6422",2020,9,144,309,289,"51.48894022","-0.111435796","Kennington Cross, Kennington",598
"6423",2020,9,145,38,38,"51.50074359","-0.202759212","Ilchester Place, Kensington",76
"6424",2020,9,146,116,105,"51.48836528","-0.129361842","Vauxhall Bridge , Pimlico",221
"6425",2020,9,148,220,208,"51.49211134","-0.138364847","Tachbrook Street, Victoria",428
"6426",2020,9,149,143,131,"51.48478899","-0.110683213","Kennington Road Post Office, Oval",274
"6427",2020,9,150,128,159,"51.49705603","-0.168917077","Holy Trinity Brompton, Knightsbridge",287
"6428",2020,9,151,148,91,"51.51213691","-0.201554966","Chepstow Villas, Notting Hill",239
"6429",2020,9,152,158,152,"51.49217002","-0.101536865","Hampton Street, Walworth",310
"6430",2020,9,153,345,344,"51.511933","-0.174411","Bayswater Road, Hyde Park",689
"6431",2020,9,154,1452,1430,"51.50379168","-0.11282408","Waterloo Station 3, Waterloo",2882
"6432",2020,9,155,139,142,"51.49586666","-0.191933711","Lexham Gardens, Kensington",281
"6433",2020,9,156,124,144,"51.49443626","-0.092921165","New Kent Road, The Borough",268
"6434",2020,9,157,214,238,"51.50039792","-0.193068385","Wright's Lane, Kensington",452
"6435",2020,9,158,151,142,"51.49085368","-0.196170309","Trebovir Road, Earl's Court",293
"6436",2020,9,159,336,396,"51.51461995","-0.137841333","Great Marlborough Street, Soho",732
"6437",2020,9,160,203,218,"51.50663341","-0.131773845","Waterloo Place, St. James's",421
"6438",2020,9,161,71,59,"51.49234577","-0.141334487","Guildhouse Street, Victoria",130
"6439",2020,9,162,213,226,"51.51760685","-0.121328408","Southampton Place, Holborn",439
"6440",2020,9,163,223,222,"51.4931848","-0.167894973","Sloane Avenue, Knightsbridge",445
"6441",2020,9,164,134,104,"51.515607","-0.183118788","Cleveland Gardens, Bayswater",238
"6442",2020,9,165,65,48,"51.517932","-0.183716959","Orsett Terrace, Bayswater",113
"6443",2020,9,166,143,148,"51.50185512","-0.159237081","Seville Street, Knightsbridge",291
"6444",2020,9,167,366,386,"51.49395092","-0.147624377","Eccleston Place, Victoria",752
"6445",2020,9,168,105,92,"51.50040123","-0.195455928","Argyll Road, Kensington",197
"6446",2020,9,169,243,207,"51.51474612","-0.165164288","Porchester Place, Paddington",450
"6447",2020,9,170,154,123,"51.52784273","-0.108068155","Hardwick Street, Clerkenwell",277
"6448",2020,9,171,107,97,"51.4916156","-0.186753859","Collingham Gardens, Earl's Court",204
"6449",2020,9,172,101,92,"51.49121192","-0.173715911","Sumner Place, South Kensington",193
"6450",2020,9,173,182,182,"51.50486","-0.113001","Waterloo Road, South Bank",364
"6451",2020,9,174,236,279,"51.512529","-0.115163","Strand, Strand",515
"6452",2020,9,175,288,312,"51.521668","-0.079608554","Worship Street, Shoreditch",600
"6453",2020,9,176,153,134,"51.51791921","-0.188098863","Gloucester Terrace, Bayswater",287
"6454",2020,9,177,321,388,"51.49616092","-0.140947636","Ashley Place, Victoria",709
"6455",2020,9,178,174,153,"51.48985626","-0.141923621","Warwick Square, Pimlico",327
"6456",2020,9,180,165,179,"51.5129118","-0.153645496","North Audley Street, Mayfair",344
"6457",2020,9,181,112,100,"51.49941247","-0.152317537","Belgrave Square, Belgravia",212
"6458",2020,9,182,188,170,"51.52202903","-0.165842551","Bell Street , Marylebone",358
"6459",2020,9,183,210,209,"51.482362","-0.13612398","Riverlight North, Nine Elms",419
"6460",2020,9,184,152,150,"51.52071513","-0.14521173","Portland Place, Marylebone",302
"6461",2020,9,185,235,237,"51.48805753","-0.140741432","Alderney Street, Pimlico",472
"6462",2020,9,186,519,508,"51.51733558","-0.175810943","South Wharf Road, Paddington",1027
"6463",2020,9,187,141,139,"51.49247977","-0.178433004","Queen's Gate (South), South Kensington",280
"6464",2020,9,188,97,88,"51.5165179","-0.164393768","Nutford Place, Marylebone",185
"6465",2020,9,189,125,54,"51.53166681","-0.109914711","Claremont Square, Angel",179
"6466",2020,9,190,210,208,"51.48997562","-0.132845681","Rampayne Street, Pimlico",418
"6467",2020,9,191,591,598,"51.50311799","-0.153520935","Hyde Park Corner, Hyde Park",1189
"6468",2020,9,192,306,323,"51.51251523","-0.133201961","Wardour Street, Soho",629
"6469",2020,9,193,324,366,"51.50581776","-0.100186337","Bankside Mix, Bankside",690
"6470",2020,9,194,584,890,"51.50462759","-0.091773776","Hop Exchange, The Borough",1474
"6471",2020,9,195,213,227,"51.50724437","-0.106237501","Milroy Walk, South Bank",440
"6472",2020,9,196,219,186,"51.50368837","-0.098497684","Union Street, The Borough",405
"6473",2020,9,197,251,338,"51.50556905","-0.111606696","Stamford Street, South Bank",589
"6474",2020,9,199,409,495,"51.51048489","-0.082989638","Great Tower Street, Monument",904
"6475",2020,9,200,250,225,"51.51492456","-0.066078037","LMU Commercial Road, Whitechapel",475
"6476",2020,9,201,247,247,"51.5225965","-0.161113413","Dorset Square, Marylebone",494
"6477",2020,9,202,362,353,"51.51236389","-0.06954201","Leman Street, Aldgate",715
"6478",2020,9,203,307,313,"51.51821864","-0.100791005","West Smithfield Rotunda, Farringdon",620
"6479",2020,9,204,160,150,"51.52659961","-0.112432615","Margery Street, Clerkenwell",310
"6480",2020,9,206,216,217,"51.518154","-0.062697","New Road 1 , Whitechapel",433
"6481",2020,9,207,77,69,"51.50135267","-0.153194766","Grosvenor Crescent, Belgravia",146
"6482",2020,9,208,58,41,"51.52505151","-0.166304359","Mallory Street, Marylebone",99
"6483",2020,9,209,95,92,"51.49358391","-0.165101392","Denyer Street, Knightsbridge",187
"6484",2020,9,210,295,326,"51.51681444","-0.151926305","Hinde Street, Marylebone",621
"6485",2020,9,211,113,150,"51.49464523","-0.158105512","Cadogan Place, Knightsbridge",263
"6486",2020,9,212,95,53,"51.50658458","-0.199004026","Campden Hill Road, Notting Hill",148
"6487",2020,9,213,495,455,"51.50274025","-0.149569201","Wellington Arch, Hyde Park",950
"6488",2020,9,214,400,421,"51.52683806","-0.130504336","Endsleigh Gardens, Euston",821
"6489",2020,9,215,423,491,"51.51906932","-0.088285377","Moorfields, Moorgate",914
"6490",2020,9,216,161,181,"51.49094565","-0.181190899","Old Brompton Road, South Kensington",342
"6491",2020,9,217,774,792,"51.51615461","-0.082422399","Wormwood Street, Liverpool Street",1566
"6492",2020,9,218,152,154,"51.48971651","-0.170194408","St. Luke's Church, Chelsea",306
"6493",2020,9,219,200,192,"51.49016361","-0.19039362","Bramham Gardens, Earl's Court",392
"6494",2020,9,220,97,104,"51.49066456","-0.166485083","Chelsea Green, Chelsea",201
"6495",2020,9,221,206,236,"51.49481649","-0.13045856","Horseferry Road, Westminster",442
"6496",2020,9,222,69,51,"51.50275704","-0.155349725","Knightsbridge, Hyde Park",120
"6497",2020,9,223,151,138,"51.49148474","-0.090220911","Rodney Road , Walworth",289
"6498",2020,9,224,196,175,"51.51031","-0.18740235","Queensway, Kensington Gardens",371
"6499",2020,9,225,344,293,"51.50935342","-0.196422","Notting Hill Gate Station, Notting Hill",637
"6500",2020,9,227,184,169,"51.52891573","-0.115480888","Great Percy Street, Clerkenwell",353
"6501",2020,9,228,464,558,"51.50742485","-0.134621209","St. James's Square, St. James's",1022
"6502",2020,9,229,409,434,"51.50654321","-0.123179697","Whitehall Place, Strand",843
"6503",2020,9,230,122,186,"51.50669284","-0.103137426","Poured Lines, Bankside",308
"6504",2020,9,231,180,182,"51.49396755","-0.17873226","Queen's Gate (Central), South Kensington",362
"6505",2020,9,232,94,99,"51.51501025","-0.112753217","Carey Street, Holborn",193
"6506",2020,9,233,296,361,"51.50777049","-0.130699733","Pall Mall East, West End",657
"6507",2020,9,234,260,260,"51.53450449","-0.106992706","Liverpool Road (N1 Centre), Angel",520
"6508",2020,9,235,129,115,"51.49571828","-0.110889274","Kennington Road  , Vauxhall",244
"6509",2020,9,236,102,137,"51.51838043","-0.073438925","Fashion Street, Whitechapel",239
"6510",2020,9,237,213,216,"51.5097860151","-0.0681619805156","Dock Street, Wapping",429
"6511",2020,9,238,96,54,"51.5233534","-0.175116099","Frampton Street, Paddington",150
"6512",2020,9,239,335,328,"51.52443845","-0.138019439","Warren Street Station, Euston",663
"6513",2020,9,240,87,89,"51.50545935","-0.10569204","Colombo Street, Southwark",176
"6514",2020,9,242,162,165,"51.52200801","-0.151359288","Beaumont Street, Marylebone",327
"6515",2020,9,243,186,170,"51.49096258","-0.139625122","Gloucester Street, Pimlico",356
"6516",2020,9,244,204,212,"51.51611887","-0.128585022","Earnshaw Street , Covent Garden",416
"6517",2020,9,245,81,80,"51.4853572","-0.142207481","Grosvenor Road, Pimlico",161
"6518",2020,9,246,315,332,"51.52285301","-0.099994052","Berry Street, Clerkenwell",647
"6519",2020,9,247,79,62,"51.530529","-0.167515","St. John's Wood Church, The Regent's Park",141
"6520",2020,9,248,241,222,"51.50645179","-0.170279555","Triangle Car Park, Hyde Park",463
"6521",2020,9,249,105,106,"51.49859784","-0.096191134","Harper Road, The Borough",211
"6522",2020,9,250,84,84,"51.489932","-0.162727","Royal Avenue 1, Chelsea",168
"6523",2020,9,251,556,582,"51.518908","-0.079249","Brushfield Street, Liverpool Street",1138
"6524",2020,9,252,362,365,"51.5046364","-0.116542278","Jubilee Gardens, South Bank",727
"6525",2020,9,253,267,212,"51.53404294","-0.086379717","Shoreditch Park, Hoxton",479
"6526",2020,9,254,223,188,"51.53051587","-0.106408455","Chadwell Street, Angel",411
"6527",2020,9,255,147,146,"51.52557531","-0.179592915","Clifton Road, Maida Vale",293
"6528",2020,9,256,114,108,"51.51362054","-0.116764211","Houghton Street, Strand",222
"6529",2020,9,257,129,140,"51.52248185","-0.154907218","Westminster University, Marylebone",269
"6530",2020,9,259,126,128,"51.490959","-0.1532331","Bourne Street, Belgravia",254
"6531",2020,9,260,206,207,"51.5136846","-0.135580879","Broadwick Street, Soho",413
"6532",2020,9,261,106,76,"51.5134891","-0.191351186","Princes Square, Bayswater",182
"6533",2020,9,262,131,104,"51.49874469","-0.103132904","LSBU (Borough Road), Elephant & Castle",235
"6534",2020,9,263,186,207,"51.51422502","-0.080660083","St. Mary Axe, Aldgate",393
"6535",2020,9,264,263,259,"51.52644342","-0.109256828","Tysoe Street, Clerkenwell",522
"6536",2020,9,265,151,128,"51.51595344","-0.169249375","Southwick Street, Paddington",279
"6537",2020,9,266,288,289,"51.50102668","-0.180246101","Queen's Gate (North), Kensington",577
"6538",2020,9,267,206,176,"51.49206037","-0.132224622","Regency Street, Westminster",382
"6539",2020,9,268,281,266,"51.49320445","-0.144132875","Belgrave Road, Victoria",547
"6540",2020,9,269,183,199,"51.50082346","-0.089740764","Empire Square, The Borough",382
"6541",2020,9,270,472,489,"51.4863434","-0.122492418","Kennington Lane Rail Bridge, Vauxhall",961
"6542",2020,9,271,83,57,"51.53583617","-0.156285395","London Zoo,  The Regent's Park",140
"6543",2020,9,272,453,462,"51.50144456","-0.110699309","Baylis Road, Waterloo",915
"6544",2020,9,273,298,339,"51.50613324","-0.114686385","Belvedere Road 1, South Bank",637
"6545",2020,9,274,140,126,"51.49671237","-0.20528437","Warwick Road, Olympia",266
"6546",2020,9,275,207,227,"51.52004497","-0.092176447","Barbican Centre, Barbican",434
"6547",2020,9,276,122,140,"51.50930161","-0.084985356","Lower Thames Street, Monument",262
"6548",2020,9,277,200,207,"51.50315739","-0.191496313","Kensington Church Street, Kensington",407
"6549",2020,9,278,540,547,"51.5034938","-0.07962099","Tooley Street, Bermondsey",1087
"6550",2020,9,279,256,243,"51.51862243","-0.176645823","North Wharf Road, Paddington",499
"6551",2020,9,280,168,177,"51.490083","-0.162418","Royal Avenue 2, Chelsea",345
"6552",2020,9,281,184,187,"51.49580589","-0.127575233","Smith Square, Westminster",371
"6553",2020,9,282,404,416,"51.51906446","-0.059642081","Royal London Hospital, Whitechapel",820
"6554",2020,9,283,64,64,"51.51440928","-0.118478757","Kingsway, Covent Garden",128
"6555",2020,9,284,178,176,"51.49914063","-0.112031483","Lambeth North Station, Waterloo",354
"6556",2020,9,286,135,91,"51.5272947","-0.174653609","St. John's Wood Road, St. John's Wood",226
"6557",2020,9,287,134,139,"51.52367314","-0.128377673","Bedford Way, Bloomsbury",273
"6558",2020,9,288,268,277,"51.49236962","-0.147478734","Elizabeth Bridge, Victoria",545
"6559",2020,9,289,67,68,"51.50923022","-0.151296092","South Audley Street, Mayfair",135
"6560",2020,9,290,190,149,"51.518268","-0.17110323","St Mary's Hospital, Paddington",339
"6561",2020,9,291,177,163,"51.48483991","-0.138089062","Claverton Street, Pimlico",340
"6562",2020,9,292,187,186,"51.49888404","-0.165471605","Montpelier Street, Knightsbridge",373
"6563",2020,9,293,124,115,"51.49815779","-0.209494128","Kensington Olympia Station, Olympia",239
"6564",2020,9,294,230,207,"51.488226","-0.135635511","St. George's Square, Pimlico",437
"6565",2020,9,295,177,183,"51.50029631","-0.092762704","Swan Street, The Borough",360
"6566",2020,9,296,143,134,"51.49363156","-0.190603326","Knaresborough Place, Earl's Court",277
"6567",2020,9,297,68,52,"51.49612799","-0.106000855","Geraldine Street, Elephant & Castle",120
"6568",2020,9,298,336,343,"51.50227992","-0.074189225","Curlew Street, Shad Thames",679
"6569",2020,9,299,77,78,"51.49398524","-0.136928582","Vincent Square, Westminster",155
"6570",2020,9,300,288,286,"51.505014","-0.17306032","Serpentine Car Park, Hyde Park",574
"6571",2020,9,301,226,224,"51.51475963","-0.148105415","Marylebone Lane, Marylebone",450
"6572",2020,9,302,122,122,"51.466907","-0.216573","Putney Pier, Wandsworth",244
"6573",2020,9,303,435,430,"51.50295379","-0.158456089","Albert Gate, Hyde Park",865
"6574",2020,9,306,184,181,"51.51816295","-0.135025698","Rathbone Street, Fitzrovia",365
"6575",2020,9,307,427,423,"51.50990837","-0.187842717","Black Lion Gate, Kensington Gardens",850
"6576",2020,9,308,166,159,"51.49907558","-0.085666316","Long Lane , Bermondsey",325
"6577",2020,9,309,102,88,"51.50963123","-0.119047563","Embankment (Savoy), Strand",190
"6578",2020,9,310,225,230,"51.4908679","-0.116911864","Black Prince Road, Vauxhall",455
"6579",2020,9,311,209,228,"51.51918144","-0.140485596","Foley Street, Fitzrovia",437
"6580",2020,9,312,139,116,"51.53088935","-0.176770502","Grove End Road, St. John's Wood",255
"6581",2020,9,313,245,242,"51.51734403","-0.138072691","Wells Street, Fitzrovia",487
"6582",2020,9,314,153,172,"51.50088934","-0.083159352","Tyers Gate, Bermondsey",325
"6583",2020,9,315,88,91,"51.52536703","-0.153463612","The Tennis Courts, The Regent's Park",179
"6584",2020,9,316,191,236,NA,NA,NA,427
"6585",2020,9,317,60,50,"51.49679128","-0.093913472","Dickens Square, Borough",110
"6586",2020,9,318,210,194,"51.51004801","-0.138846453","Sackville Street, Mayfair",404
"6587",2020,9,319,197,211,"51.52702563","-0.088542771","Baldwin Street, St. Luke's",408
"6588",2020,9,320,266,278,"51.49357351","-0.139956043","Queen Mother Sports Centre, Victoria",544
"6589",2020,9,321,328,276,"51.49785559","-0.081608045","Bermondsey Street, Bermondsey",604
"6590",2020,9,322,124,108,"51.526293","-0.073955","Palissy Street, Shoreditch",232
"6591",2020,9,323,140,157,"51.523196","-0.083067","Clifton Street, Shoreditch",297
"6592",2020,9,324,226,219,"51.49652013","-0.101384068","Ontario Street, Elephant & Castle",445
"6593",2020,9,325,136,138,"51.50908747","-0.129697889","St. Martin's Street, West End",274
"6594",2020,9,326,307,288,"51.53266186","-0.099981142","Graham Street, Angel",595
"6595",2020,9,327,70,47,"51.53095","-0.085603","New North Road 1, Hoxton",117
"6596",2020,9,328,63,52,"51.53114","-0.086016","New North Road 2, Hoxton",115
"6597",2020,9,329,128,102,"51.53589283","-0.160854428","Prince Albert Road, The Regent's Park",230
"6598",2020,9,330,285,248,"51.51641749","-0.179135079","Eastbourne Mews, Paddington",533
"6599",2020,9,331,326,355,"51.52085887","-0.089887855","Bunhill Row, Moorgate",681
"6600",2020,9,332,101,79,"51.49334336","-0.194757949","Nevern Place, Earl's Court",180
"6601",2020,9,333,152,122,"51.50860544","-0.193764092","Palace Gardens Terrace, Notting Hill",274
"6602",2020,9,334,149,148,"51.505044","-0.115851","Concert Hall Approach 1, South Bank",297
"6603",2020,9,335,188,245,"51.51196803","-0.120718759","Tavistock Street, Covent Garden",433
"6604",2020,9,336,139,180,"51.504942","-0.115533","Concert Hall Approach 2, South Bank",319
"6605",2020,9,337,87,67,"51.51108452","-0.197524944","Pembridge Villas, Notting Hill",154
"6606",2020,9,338,321,373,"51.51175646","-0.119643424","Wellington Street , Strand",694
"6607",2020,9,339,113,58,"51.5333196","-0.1117812","Risinghill Street, Angel",171
"6608",2020,9,340,386,427,"51.51444134","-0.087587447","Bank of England Museum, Bank",813
"6609",2020,9,341,482,481,"51.50810309","-0.12602103","Craven Street, Strand",963
"6610",2020,9,343,102,98,"51.53692216","-0.150181444","London Zoo Car Park, The Regent's Park",200
"6611",2020,9,344,136,112,"51.528246","-0.10102611","Goswell Road (City Uni), Finsbury",248
"6612",2020,9,345,326,325,"51.48802358","-0.166878535","Flood Street, Chelsea",651
"6613",2020,9,347,170,200,"51.50013942","-0.113936001","Lower Marsh, Waterloo",370
"6614",2020,9,348,146,167,"51.51217033","-0.150481272","Grosvenor Square, Mayfair",313
"6615",2020,9,349,173,191,"51.51196","-0.142783033","St. George Street, Mayfair",364
"6616",2020,9,350,242,252,"51.5017154373867","-0.1798541843891","Queen's Gate, Kensington Gardens",494
"6617",2020,9,351,216,158,"51.529423","-0.097122","Macclesfield Rd, St Lukes",374
"6618",2020,9,352,176,167,"51.486965","-0.116625","Vauxhall Street, Vauxhall",343
"6619",2020,9,353,91,78,"51.49459148","-0.134234258","Greycoat Street , Westminster",169
"6620",2020,9,354,265,331,"51.506767","-0.123702","Northumberland Avenue, Strand",596
"6621",2020,9,356,429,432,"51.494412","-0.173881","South Kensington Station, South Kensington",861
"6622",2020,9,357,300,313,"51.520994","-0.139016","Howland Street, Fitzrovia",613
"6623",2020,9,358,228,226,"51.516226","-0.124826","High Holborn , Covent Garden",454
"6624",2020,9,359,133,133,"51.49782999","-0.135440826","Butler Place, Westminster",266
"6625",2020,9,360,320,344,"51.49675303","-0.138733562","Howick Place, Westminster",664
"6626",2020,9,361,568,450,"51.50391973","-0.11342629","Waterloo Station 2, Waterloo",1018
"6627",2020,9,362,167,144,"51.536264","-0.133952","Royal College Street, Camden Town",311
"6628",2020,9,363,60,40,"51.5291212008901","-0.171185284853","Lord's, St. John's Wood",100
"6629",2020,9,364,252,271,"51.519656","-0.132339","Alfred Place, Bloomsbury",523
"6630",2020,9,365,199,158,"51.530344","-0.100168","City Road, Angel",357
"6631",2020,9,366,96,97,"51.5109192966489","-0.1511263847351","Millennium Hotel, Mayfair",193
"6632",2020,9,367,115,102,"51.5173721","-0.1642075","Harrowby Street, Marylebone",217
"6633",2020,9,368,142,155,"51.50024195","-0.15934065","Harriet Street, Knightsbridge",297
"6634",2020,9,370,50,29,"51.520205","-0.174593","Paddington Green, Paddington",79
"6635",2020,9,371,109,99,"51.49775","-0.10988","King Edward Walk, Waterloo",208
"6636",2020,9,372,176,172,"51.515208","-0.117863","Sardinia Street, Holborn",348
"6637",2020,9,373,157,192,"51.49980661","-0.176415994","Prince Consort Road, Knightsbridge",349
"6638",2020,9,374,1063,1246,"51.50402794","-0.11386436","Waterloo Station 1, Waterloo",2309
"6639",2020,9,375,97,81,"51.50194596","-0.194392952","Kensington Town Hall, Kensington",178
"6640",2020,9,376,211,208,"51.49188409","-0.125674815","Millbank Tower, Pimlico",419
"6641",2020,9,377,127,127,"51.50535447","-0.113656543","Waterloo Bridge, South Bank",254
"6642",2020,9,378,120,162,"51.49559291","-0.179077626","Natural History Museum, South Kensington",282
"6643",2020,9,379,155,141,"51.51431171","-0.200838199","Turquoise Island, Notting Hill",296
"6644",2020,9,380,109,116,"51.50686435","-0.150666888","Stanhope Gate, Mayfair",225
"6645",2020,9,381,191,178,"51.51953043","-0.13577731","Charlotte Street, Fitzrovia",369
"6646",2020,9,382,110,99,"51.50935171","-0.14744969","Farm Street, Mayfair",209
"6647",2020,9,383,218,210,"51.51310333","-0.13121385","Frith Street, Soho",428
"6648",2020,9,384,114,114,"51.496481","-0.192404","Marloes Road, Kensington",228
"6649",2020,9,386,333,334,"51.51352755","-0.130110822","Moor Street, Soho",667
"6650",2020,9,387,229,190,"51.49369988","-0.121394101","Fire Brigade Pier, Vauxhall",419
"6651",2020,9,388,218,228,"51.51070161","-0.121723604","Southampton Street, Strand",446
"6652",2020,9,389,50,55,"51.51013066","-0.155757901","Upper Grosvenor Street, Mayfair",105
"6653",2020,9,390,122,121,"51.521776","-0.068856","Buxton Street 1, Shoreditch",243
"6654",2020,9,392,328,350,"51.49942855","-0.179702476","Imperial College, Knightsbridge",678
"6655",2020,9,393,308,324,"51.51733427","-0.103604248","Snow Hill, Farringdon",632
"6656",2020,9,394,133,84,"51.524826","-0.176268","Aberdeen Place, St. John's Wood",217
"6657",2020,9,395,219,230,"51.492462","-0.159919","Cadogan Gardens, Chelsea",449
"6658",2020,9,396,138,129,"51.51809","-0.163609","Shouldham Street, Marylebone",267
"6659",2020,9,397,192,181,"51.51348","-0.17977","Devonshire Terrace, Bayswater",373
"6660",2020,9,398,86,64,"51.502319","-0.200742","Holland Park, Kensington",150
"6661",2020,9,399,130,147,"51.52261762","-0.071653961","Brick Lane Market, Shoreditch",277
"6662",2020,9,400,109,121,"51.517703","-0.154106","George Street, Marylebone",230
"6663",2020,9,401,168,174,"51.528187","-0.075375","Columbia Road, Shoreditch",342
"6664",2020,9,402,110,93,"51.52289229","-0.171681991","Penfold Street, Marylebone",203
"6665",2020,9,403,132,135,"51.51689296","-0.158249929","George Place Mews, Marylebone",267
"6666",2020,9,404,218,224,"51.50204238","-0.184400221","Palace Gate, Kensington Gardens",442
"6667",2020,9,405,370,356,"51.49418566","-0.18267094","Gloucester Road Station, South Kensington",726
"6668",2020,9,408,51,35,NA,NA,NA,86
"6669",2020,9,409,202,207,"51.493146","-0.099828","Strata, Elephant & Castle",409
"6670",2020,9,410,141,117,"51.519968","-0.169774","Edgware Road Station, Marylebone",258
"6671",2020,9,411,226,262,"51.49337264","-0.09968067","Walworth Road, Elephant & Castle",488
"6672",2020,9,412,95,80,"51.488105","-0.110121","Cleaver Street, Kennington",175
"6673",2020,9,419,141,113,"51.485821","-0.149004","Chelsea Bridge, Pimlico",254
"6674",2020,9,420,122,131,"51.504043","-0.105312","Southwark Station 1, Southwark",253
"6675",2020,9,421,245,285,"51.504044","-0.104778","Southwark Station 2, Southwark",530
"6676",2020,9,423,87,79,"51.49456127","-0.15393398","Eaton Square (South), Belgravia",166
"6677",2020,9,424,151,131,"51.490491","-0.149186","Ebury Bridge, Pimlico",282
"6678",2020,9,425,157,166,"51.533379","-0.139159","Harrington Square 2, Camden Town",323
"6679",2020,9,426,170,164,"51.493072","-0.129925","Vincent Street, Pimlico",334
"6680",2020,9,427,538,592,"51.51397065","-0.09294031","Cheapside, Bank",1130
"6681",2020,9,428,419,489,"51.499917","-0.174554","Exhibition Road, Knightsbridge",908
"6682",2020,9,430,102,104,"51.48902","-0.17524","South Parade, Chelsea",206
"6683",2020,9,431,97,90,"51.534474","-0.122203","Crinan Street, King's Cross",187
"6684",2020,9,432,288,298,"51.496957","-0.173894","Exhibition Road Museums, South Kensington",586
"6685",2020,9,433,291,274,"51.524564","-0.116279","Wren Street, Holborn",565
"6686",2020,9,435,139,147,"51.488852","-0.105593","Kennington Station, Kennington",286
"6687",2020,9,436,366,359,"51.51824","-0.11655","Red Lion Street, Holborn",725
"6688",2020,9,437,143,141,"51.488124","-0.120903","Vauxhall Walk, Vauxhall",284
"6689",2020,9,439,82,51,"51.5338","-0.118677","Killick Street, King's Cross",133
"6690",2020,9,440,151,156,"51.483145","-0.113134","Kennington Oval, Oval",307
"6691",2020,9,441,168,159,"51.495656","-0.114605","Sail Street, Vauxhall",327
"6692",2020,9,442,80,61,"51.510101","-0.211358","Walmer Road, Avondale",141
"6693",2020,9,443,191,178,"51.515256","-0.058641","Philpot Street, Whitechapel",369
"6694",2020,9,444,174,157,"51.52568","-0.055312","Bethnal Green Garden, Bethnal Green",331
"6695",2020,9,445,135,125,"51.52388","-0.065076","Cheshire Street, Bethnal Green",260
"6696",2020,9,446,220,216,"51.528936","-0.055894","York Hall, Bethnal Green",436
"6697",2020,9,447,43,47,"51.493381","-0.007542","Jubilee Crescent, Cubitt Town",90
"6698",2020,9,448,112,100,"51.50623","-0.02296","Fisherman's Walk West, Canary Wharf",212
"6699",2020,9,449,219,223,"51.511088","-0.057159","Shadwell Station, Shadwell",442
"6700",2020,9,450,159,132,"51.515975","-0.053177","Jubilee Street, Stepney",291
"6701",2020,9,451,146,117,"51.504719","-0.063531","Hermitage Court, Wapping",263
"6702",2020,9,452,140,151,"51.505697","-0.070542","St. Katharine's Way, Tower",291
"6703",2020,9,453,158,150,"51.508447","-0.055167","Garnet Street, Shadwell",308
"6704",2020,9,454,42,53,"51.487679","-0.021582","Napier Avenue, Millwall",95
"6705",2020,9,455,41,38,"51.49447","-0.014409","East Ferry Road, Cubitt Town",79
"6706",2020,9,456,96,103,"51.538071","-0.144664","Parkway, Camden Town",199
"6707",2020,9,457,177,181,"51.542138","-0.145393","Castlehaven Road, Camden Town",358
"6708",2020,9,458,156,154,"51.504749","-0.057544","Wapping Lane, Wapping",310
"6709",2020,9,459,183,167,"51.535179","-0.03338","Gunmakers Lane, Old Ford",350
"6710",2020,9,460,158,159,"51.516196","-0.029138","Burdett Road, Mile End",317
"6711",2020,9,461,90,92,"51.516","-0.038775","Aston Street, Stepney",182
"6712",2020,9,462,221,202,"51.541603","-0.138853","Bonny Street, Camden Town",423
"6713",2020,9,463,123,87,"51.534776","-0.071881","Thurtle Road, Haggerston",210
"6714",2020,9,464,48,52,"51.51417","-0.052099","St. Mary & St. Michael Church, Stepney",100
"6715",2020,9,465,275,235,"51.53558","-0.08249","Pitfield Street North,Hoxton",510
"6716",2020,9,466,153,127,"51.534464","-0.076341","Whiston Road, Haggerston",280
"6717",2020,9,467,83,58,"51.523538","-0.030556","Southern Grove, Bow",141
"6718",2020,9,468,42,48,"51.521564","-0.022694","Cantrell Road, Bow",90
"6719",2020,9,469,116,117,"51.513757","-0.020467","Lindfield Street, Poplar",233
"6720",2020,9,470,123,144,"51.530535","-0.025492","Mostyn Grove, Bow",267
"6721",2020,9,471,156,165,"51.533283","-0.028155","Hewison Street, Old Ford",321
"6722",2020,9,472,15,16,"51.529452","-0.027616","Malmesbury Road, Bow",31
"6723",2020,9,473,30,36,"51.496137","-0.019355","Millharbour, Millwall",66
"6724",2020,9,475,58,44,"51.499041","-0.020157","Lightermans Road, Millwall",102
"6725",2020,9,476,20,32,"51.489096","-0.009205","Stebondale Street, Cubitt Town",52
"6726",2020,9,477,47,54,"51.49109","-0.018716","Spindrift Avenue, Millwall",101
"6727",2020,9,478,263,269,"51.521889","-0.04667","Stepney Green Station, Stepney",532
"6728",2020,9,479,208,202,"51.527152","-0.058005","Pott Street, Bethnal Green",410
"6729",2020,9,480,290,281,"51.5128711","-0.0389866","Flamborough Street, Limehouse",571
"6730",2020,9,481,93,102,"51.487129","-0.009001","Saunders Ness Road, Cubitt Town",195
"6731",2020,9,483,140,129,"51.51328","-0.047784","Albert Gardens, Stepney",269
"6732",2020,9,484,70,68,"51.528828","-0.013258","Bromley High Street, Bow",138
"6733",2020,9,485,136,126,"51.531127","-0.048017","Old Ford Road, Bethnal Green",262
"6734",2020,9,486,272,248,"51.525645","-0.069543","Granby Street, Shoreditch",520
"6735",2020,9,488,209,211,"51.506946","-0.058681","Reardon Street, Wapping",420
"6736",2020,9,489,213,194,"51.513074","-0.064094","Christian Street, Whitechapel",407
"6737",2020,9,490,90,89,"51.508622","-0.065006","Pennington Street, Wapping",179
"6738",2020,9,491,280,288,"51.522507","-0.041378","Queen Mary's, Mile End",568
"6739",2020,9,492,244,238,"51.525501","-0.032267204","Maplin Street, Mile End",482
"6740",2020,9,494,4,8,"51.50196","-0.016251","South Quay East, Canary Wharf",12
"6741",2020,9,495,140,135,"51.528169","-0.018703","Bow Church Station, Bow",275
"6742",2020,9,496,76,69,"51.52512","-0.015578","Devons Road, Bow",145
"6743",2020,9,497,74,68,"51.526149","-0.027396845","Merchant Street, Bow",142
"6744",2020,9,498,145,133,"51.527058","-0.025296","Bow Road Station, Bow",278
"6745",2020,9,499,192,169,"51.519265","-0.021345","Furze Green, Bow",361
"6746",2020,9,500,229,227,"51.519806","-0.055731","Ansell House, Stepney",456
"6747",2020,9,501,132,116,"51.522561","-0.054883","Cephas Street, Bethnal Green",248
"6748",2020,9,502,192,193,"51.53341","-0.049591815","Bonner Gate, Victoria Park",385
"6749",2020,9,503,347,378,"51.520893","-0.051394","Cleveland Way, Stepney",725
"6750",2020,9,504,27,24,"51.496454","-0.009506","St. John's Park, Cubitt Town",51
"6751",2020,9,505,124,119,"51.520398","-0.026768","Ackroyd Drive, Bow",243
"6752",2020,9,506,169,207,"51.517475","-0.075855","Bell Lane, Liverpool Street",376
"6753",2020,9,507,91,74,"51.528692","-0.059091","Clarkson Street, Bethnal Green",165
"6754",2020,9,508,259,268,"51.519362","-0.074431","Fournier Street, Whitechapel",527
"6755",2020,9,509,183,173,"51.517842","-0.090075","Fore Street, Guildhall",356
"6756",2020,9,510,207,265,"51.509303","-0.025996","Westferry DLR, Limehouse",472
"6757",2020,9,511,221,230,"51.511066","-0.053558","Sutton Street, Shadwell",451
"6758",2020,9,512,312,293,"51.532091","-0.06142","Pritchard's Road, Bethnal Green",605
"6759",2020,9,513,142,126,"51.5142228","-0.055656","Watney Market, Stepney",268
"6760",2020,9,514,162,163,"51.516204","-0.155525","Portman Square, Marylebone",325
"6761",2020,9,515,85,85,"51.500088","-0.211316","Russell Gardens, Olympia",170
"6762",2020,9,516,71,77,"51.5112","-0.014438","Chrisp Street Market, Poplar",148
"6763",2020,9,518,152,136,"51.528224","-0.037471","Antill Road, Mile End",288
"6764",2020,9,519,10,9,"51.518811","-0.011662","Teviot Street, Poplar",19
"6765",2020,9,520,160,144,"51.526041","-0.047218","Bancroft Road, Bethnal Green",304
"6766",2020,9,521,164,142,"51.534137","-0.037366","Driffield Road, Old Ford",306
"6767",2020,9,522,197,220,"51.525941","-0.036017","Clinton Road, Mile End",417
"6768",2020,9,523,28,30,"51.51549","-0.013475","Langdon Park, Poplar",58
"6769",2020,9,524,164,135,"51.511654","-0.179668","Lancaster Gate , Bayswater",299
"6770",2020,9,526,42,46,"51.503143","-0.008428","Lancaster Drive, Blackwall",88
"6771",2020,9,527,116,107,"51.503802","-0.215808","Hansard Mews, Holland Park",223
"6772",2020,9,528,95,98,"51.507326","-0.145827","Clarges Street, Mayfair",193
"6773",2020,9,529,133,137,"51.486892","-0.170983","Manresa Road, Chelsea",270
"6774",2020,9,530,41,50,"51.508896","-0.012413","Newby Place, Poplar",91
"6775",2020,9,531,221,169,"51.530326","-0.042744","Twig Folly Bridge, Mile End",390
"6776",2020,9,532,104,140,"51.50357","-0.020068","Jubilee Plaza, Canary Wharf",244
"6777",2020,9,533,183,165,"51.528222","-0.069743","Wellington Row, Bethnal Green",348
"6778",2020,9,534,223,212,"51.531864","-0.066035","Goldsmith's Row, Haggerston",435
"6779",2020,9,535,179,143,"51.537349","-0.147154","Gloucester Avenue, Camden Town",322
"6780",2020,9,536,103,83,"51.53385","-0.06992","Queensbridge Road, Haggerston",186
"6781",2020,9,537,231,207,"51.51793","-0.067937","Old Montague Street, Whitechapel",438
"6782",2020,9,538,53,54,"51.508981","-0.00699","Naval Row, Blackwall",107
"6783",2020,9,540,152,133,"51.528302","-0.144466","Albany Street, The Regent's Park",285
"6784",2020,9,541,379,381,"51.506613","-0.142844","Green Park Station, Mayfair",760
"6785",2020,9,542,138,155,"51.514115","-0.033828","Salmon Lane, Limehouse",293
"6786",2020,9,543,48,25,"51.509591","-0.204666","Lansdowne Walk, Ladbroke Grove",73
"6787",2020,9,544,185,187,"51.526153","-0.102208","Percival Street, Finsbury",372
"6788",2020,9,545,107,123,"51.539957","-0.145246","Arlington Road, Camden Town",230
"6789",2020,9,546,315,256,"51.517428","-0.107987","New Fetter Lane, Holborn",571
"6790",2020,9,547,56,51,"51.509474","-0.002275","East India DLR, Blackwall",107
"6791",2020,9,548,89,77,"51.498386","-0.107913","Westminster Bridge Road, Elephant & Castle",166
"6792",2020,9,549,123,93,"51.49605","-0.104193","Gaywood  Street, Elephant & Castle",216
"6793",2020,9,550,113,100,"51.521564","-0.039264","Harford Street, Mile End",213
"6794",2020,9,551,109,81,"51.505772","-0.016460175","Import Dock, Canary Wharf",190
"6795",2020,9,552,213,210,"51.511542","-0.056667","Watney Street, Shadwell",423
"6796",2020,9,553,456,412,"51.535678","-0.062546","Regent's Row , Haggerston",868
"6797",2020,9,554,27,26,"51.513548","-0.005659","Aberfeldy Street, Poplar",53
"6798",2020,9,556,67,67,"51.502661","-0.021596","Heron Quays DLR, Canary Wharf",134
"6799",2020,9,557,121,141,"51.51601","-0.0985","King Edward Street, St Pauls",262
"6800",2020,9,558,259,287,"51.493978","-0.127554","Page Street, Westminster",546
"6801",2020,9,559,53,46,"51.501391","-0.205991","Abbotsbury Road, Holland Park",99
"6802",2020,9,560,41,22,"51.511624","-0.205921","Ladbroke Grove Central, Ladbroke Grove",63
"6803",2020,9,561,115,100,"51.518369","-0.043371","Rectory Square, Stepney",215
"6804",2020,9,562,180,192,"51.51746","-0.12335","Bury Place, Holborn",372
"6805",2020,9,563,33,35,"51.499286","-0.009152","Preston's Road, Cubitt Town",68
"6806",2020,9,564,323,399,"51.509943","-0.117619","Somerset House, Strand",722
"6807",2020,9,565,91,86,"51.521905","-0.063386","Selby Street, Whitechapel",177
"6808",2020,9,566,115,119,"51.509158","-0.224103","Westfield Ariel Way, White City",234
"6809",2020,9,568,206,178,"51.51616","-0.18697","Bishop's Bridge Road West, Bayswater",384
"6810",2020,9,569,187,149,"51.53213","-0.08299","Pitfield Street Central, Hoxton",336
"6811",2020,9,570,176,171,"51.503083","-0.017676","Upper Bank Street, Canary Wharf",347
"6812",2020,9,571,83,108,"51.506256","-0.218337","Westfield Southern Terrace ,Shepherd's Bush",191
"6813",2020,9,572,195,244,"51.539099","-0.141728","Greenland Road, Camden Town",439
"6814",2020,9,573,387,388,"51.485587","-0.18119","Limerston Street, West Chelsea",775
"6815",2020,9,574,436,386,"51.53356","-0.09315","Eagle Wharf Road, Hoxton",822
"6816",2020,9,576,43,44,"51.497304","-0.022793","Alpha Grove, Millwall",87
"6817",2020,9,577,181,180,"51.528869","-0.047548","Globe Town Market, Bethnal Green",361
"6818",2020,9,578,67,99,"51.527607","-0.057133","Hollybush Gardens, Bethnal Green",166
"6819",2020,9,579,356,523,"51.511246","-0.093051","Queen Street 2, Bank",879
"6820",2020,9,580,146,157,"51.48692917","-0.102996299","Doddington Grove, Kennington",303
"6821",2020,9,581,253,252,"51.519167","-0.147983","New Cavendish Street, Marylebone",505
"6822",2020,9,583,239,261,"51.497622","-0.125978","Abingdon Green, Westminster",500
"6823",2020,9,584,160,159,"51.51244","-0.19096","Ilchester Gardens, Bayswater",319
"6824",2020,9,586,39,38,"51.490645","-0.014582","Mudchute DLR, Cubitt Town",77
"6825",2020,9,587,352,385,"51.50964","-0.08497","Monument Street, Monument",737
"6826",2020,9,588,107,99,"51.52959","-0.0801","Hoxton Street, Hoxton",206
"6827",2020,9,589,246,239,"51.487196","-0.179369","Drayton Gardens, West Chelsea",485
"6828",2020,9,590,66,45,"51.53256","-0.16862","Greenberry Street, St.John's Wood",111
"6829",2020,9,592,87,79,"51.5171","-0.18377","Bishop's Bridge Road East, Bayswater",166
"6830",2020,9,593,150,127,"51.531066","-0.11934","Northdown Street, King's Cross",277
"6831",2020,9,594,164,171,"51.513875","-0.117774","Kingsway Southbound, Strand",335
"6832",2020,9,595,221,224,"51.493267","-0.21985","Hammersmith Road, Hammersmith",445
"6833",2020,9,596,209,191,"51.472817","-0.199783","Parson's Green , Parson's Green",400
"6834",2020,9,597,149,138,"51.473471","-0.20782","Fulham Park Road, Fulham",287
"6835",2020,9,598,126,120,"51.494499","-0.228188","Southerton Road, Hammersmith",246
"6836",2020,9,599,90,82,"51.485743","-0.223616","Manbre Road, Hammersmith",172
"6837",2020,9,600,201,199,"51.481747","-0.124642","South Lambeth Road, Vauxhall",400
"6838",2020,9,601,127,123,"51.514767","-0.225787","BBC White City, White City",250
"6839",2020,9,602,187,163,"51.472993","-0.133972","Union Grove, Wandsworth Road",350
"6840",2020,9,603,115,150,"51.477839","-0.116493","Caldwell Street, Stockwell",265
"6841",2020,9,604,74,55,"51.538792","-0.138535","St Martins Close, Camden Town",129
"6842",2020,9,605,132,154,"51.520331","-0.163667","Seymour Place, Marylebone",286
"6843",2020,9,606,78,67,"51.504199","-0.210941","Addison Road, Holland Park",145
"6844",2020,9,607,126,134,"51.468814","-0.210279","Putney Bridge Station, Fulham",260
"6845",2020,9,608,9,15,"51.491093","-0.216493","Colet Gardens, Hammersmith",24
"6846",2020,9,609,66,54,"51.46512358","-0.157788279","Sugden Road, Clapham",120
"6847",2020,9,610,130,120,"51.48256792","-0.172078187","Danvers Street, West Chelsea",250
"6848",2020,9,611,76,69,"51.50646524","-0.208486599","Princedale Road , Holland Park",145
"6849",2020,9,612,150,140,"51.46925984","-0.141812513","Wandsworth Rd, Isley Court, Wandsworth Road",290
"6850",2020,9,613,247,263,"51.50403821","-0.217400093","Woodstock Grove, Shepherd's Bush",510
"6851",2020,9,614,80,79,"51.47817208","-0.144690541","Bradmead, Battersea Park",159
"6852",2020,9,615,146,140,"51.4768851","-0.215895601","Finlay Street, Fulham",286
"6853",2020,9,616,201,175,"51.48102131","-0.209973497","Aintree Street, Fulham",376
"6854",2020,9,617,73,66,"51.47107905","-0.207842908","Elysium Place, Fulham",139
"6855",2020,9,618,125,111,"51.47625965","-0.193254007","Eel Brook Common, Walham Green",236
"6856",2020,9,619,120,110,"51.4737636","-0.197010096","Irene Road, Parsons Green",230
"6857",2020,9,620,148,141,"51.47518024","-0.167160736","Surrey Lane, Battersea",289
"6858",2020,9,621,198,185,"51.46086446","-0.187427294","Wandsworth Town Station, Wandsworth",383
"6859",2020,9,622,168,154,"51.50748124","-0.205535908","Lansdowne Road, Ladbroke Grove",322
"6860",2020,9,623,58,53,"51.46193072","-0.180791784","Nantes Close, Wandsworth",111
"6861",2020,9,624,109,90,"51.4729184","-0.132102704","Courland Grove, Wandsworth Road",199
"6862",2020,9,625,220,215,"51.47761941","-0.149551631","Queen's Circus, Battersea Park",435
"6863",2020,9,626,195,198,"51.48438657","-0.20481514","Normand Park, West Kensington",393
"6864",2020,9,627,75,75,"51.4687905","-0.158230901","Holden Street, Battersea",150
"6865",2020,9,628,81,87,"51.46881971","-0.184318843","William Morris Way, Sands End",168
"6866",2020,9,629,33,26,"51.45995384","-0.190184054","Morie Street, Wandsworth",59
"6867",2020,9,630,96,74,"51.47073264","-0.126994068","Clarence Walk, Stockwell",170
"6868",2020,9,631,151,135,"51.4795017","-0.141770709","Battersea Park Road, Nine Elms",286
"6869",2020,9,632,95,101,"51.47053858","-0.163041605","Sheepcote Lane, Battersea",196
"6870",2020,9,633,122,113,"51.48959104","-0.209378594","Vereker Road, West Kensington",235
"6871",2020,9,634,85,92,"51.49434708","-0.215804559","Brook Green South, Brook Green",177
"6872",2020,9,635,176,163,"51.48606206","-0.214428378","Greyhound Road, Hammersmith",339
"6873",2020,9,636,184,176,"51.46706414","-0.193502076","South Park, Sands End",360
"6874",2020,9,637,52,18,"51.45787019","-0.174691623","Spencer Park, Wandsworth Common",70
"6875",2020,9,638,371,361,"51.46663393","-0.169821175","Falcon Road, Clapham Junction",732
"6876",2020,9,639,200,194,"51.48357068","-0.202038682","Coomer Place, West Kensington",394
"6877",2020,9,640,141,132,"51.47286577","-0.148059277","Silverthorne Road, Battersea",273
"6878",2020,9,641,104,97,"51.49824168","-0.117495865","Archbishop's Park, Waterloo",201
"6879",2020,9,642,79,72,"51.46916161","-0.174485792","Fawcett Close, Battersea",151
"6880",2020,9,643,78,77,"51.5190427","-0.204764421","All Saints' Road, Portobello",155
"6881",2020,9,644,185,172,"51.48373225","-0.223852256","Rainville Road, Hammersmith",357
"6882",2020,9,645,228,206,"51.50173215","-0.100292412","Great Suffolk Street, The Borough",434
"6883",2020,9,646,211,275,"51.49886563","-0.137424571","Buckingham Gate, Westminster",486
"6884",2020,9,647,93,86,"51.50035306","-0.217515071","Richmond Way, Shepherd's Bush",179
"6885",2020,9,648,72,71,"51.46904022","-0.19627483","Peterborough Road, Sands End",143
"6886",2020,9,649,132,130,"51.48180515","-0.18027465","World's End Place, West Chelsea",262
"6887",2020,9,650,97,95,"51.51687069","-0.213872396","St. Mark's Road, North Kensington",192
"6888",2020,9,651,107,105,"51.48089844","-0.183853573","Thorndike Close, West Chelsea",212
"6889",2020,9,652,53,61,"51.51148696","-0.218190203","Evesham Street, Avondale",114
"6890",2020,9,653,186,199,"51.47084722","-0.17070367","Simpson Street, Clapham Junction",385
"6891",2020,9,654,153,141,"51.48267821","-0.117661574","Ashmole Estate, Oval",294
"6892",2020,9,655,84,78,"51.48294452","-0.219346128","Crabtree Lane, Fulham",162
"6893",2020,9,656,86,75,"51.46841875","-0.199135704","Broomhouse Lane, Parsons Green",161
"6894",2020,9,657,74,64,"51.4996806","-0.221791552","Blythe Road West, Shepherd's Bush",138
"6895",2020,9,658,275,273,"51.47729232","-0.16478637","Ethelburga Estate, Battersea Park",548
"6896",2020,9,659,293,294,"51.511934","-0.10307894","Blackfriars Station, St. Paul's",587
"6897",2020,9,660,94,89,"51.49087074","-0.206029743","West Kensington Station, West Kensington",183
"6898",2020,9,661,204,229,"51.51632095","-0.202608612","All Saints Church, Portobello",433
"6899",2020,9,662,177,162,"51.48498496","-0.167919869","Phene Street, Chelsea",339
"6900",2020,9,663,74,89,"51.51323001","-0.211593602","Clarendon Road, Avondale",163
"6901",2020,9,664,161,150,"51.474376","-0.155442787","Austin Road, Battersea Park",311
"6902",2020,9,665,72,78,"51.46108367","-0.191722864","Smugglers Way, Wandsworth",150
"6903",2020,9,666,113,126,"51.49610093","-0.208158259","Olympia Way, Olympia",239
"6904",2020,9,667,113,112,"51.5015946","-0.222293381","Shepherd's Bush Road North, Shepherd's Bush",225
"6905",2020,9,668,173,173,"51.49422354","-0.236769936","Ravenscourt Park Station, Hammersmith",346
"6906",2020,9,669,81,72,"51.47614939","-0.1232585","Teversham Lane, Stockwell",153
"6907",2020,9,670,154,134,"51.46718562","-0.152248582","Ashley Crescent, Battersea",288
"6908",2020,9,671,307,317,"51.475089","-0.201968","Parsons Green Station, Parsons Green",624
"6909",2020,9,673,160,172,"51.46517078","-0.18038939","Hibbert Street, Battersea",332
"6910",2020,9,674,105,75,"51.53546778","-0.11619105","Carnegie Street, King's Cross",180
"6911",2020,9,675,97,97,"51.46348914","-0.182126248","Usk Road, Clapham Junction",194
"6912",2020,9,676,180,184,"51.47787084","-0.126874471","Hartington Road, Stockwell",364
"6913",2020,9,677,70,55,"51.46866929","-0.146544642","Heath Road, Battersea",125
"6914",2020,9,678,52,38,"51.46231278","-0.211468596","Esmond Street, Putney",90
"6915",2020,9,679,145,127,"51.47453545","-0.170210533","Orbel Street, Battersea",272
"6916",2020,9,680,269,275,"51.47768469","-0.170329317","Westbridge Road, Battersea",544
"6917",2020,9,681,126,134,"51.47303687","-0.214749808","Bishop's Avenue, Fulham",260
"6918",2020,9,682,185,188,"51.48810829","-0.22660621","Crisp Road, Hammersmith",373
"6919",2020,9,683,88,92,"51.46506424","-0.163750945","Dorothy Road, Clapham Junction",180
"6920",2020,9,684,71,72,"51.45475251","-0.195197203","Neville Gill Close, Wandsworth",143
"6921",2020,9,685,137,139,"51.46067005","-0.198735357","Osiers Road, Wandsworth",276
"6922",2020,9,686,126,132,"51.48814438","-0.222456468","Beryl Road, Hammersmith",258
"6923",2020,9,687,174,156,"51.49760804","-0.21145598","Maclise Road, Olympia",330
"6924",2020,9,688,51,49,"51.46095151","-0.20066766","Northfields, Wandsworth",100
"6925",2020,9,689,42,28,"51.45922541","-0.180884959","Spanish Road, Clapham Junction",70
"6926",2020,9,690,95,91,"51.47047503","-0.152130083","Stanley Grove, Battersea",186
"6927",2020,9,691,202,194,"51.47946386","-0.195777222","Erin Close, Walham Green",396
"6928",2020,9,692,171,149,"51.54211855","-0.028941601","Cadogan Close, Victoria Park",320
"6929",2020,9,693,72,79,"51.464786","-0.215618902","Felsham Road, Putney",151
"6930",2020,9,694,42,40,"51.46071722","-0.216526155","Putney Rail Station, Putney",82
"6931",2020,9,695,339,354,"51.53638435","-0.102757578","Islington Green, Angel",693
"6932",2020,9,696,186,190,"51.48728535","-0.217995921","Charing Cross Hospital, Hammersmith",376
"6933",2020,9,697,121,89,"51.53639219","-0.112721065","Charlotte Terrace, Angel",210
"6934",2020,9,698,153,116,"51.53908372","-0.070329419","Shoreditch Court, Haggerston",269
"6935",2020,9,699,93,58,"51.5366541","-0.07023031","Belford House, Haggerston",151
"6936",2020,9,700,137,123,"51.47696496","-0.174347066","Battersea Church Road, Battersea",260
"6937",2020,9,701,230,211,"51.47287627","-0.176267008","Vicarage Crescent, Battersea",441
"6938",2020,9,702,174,152,"51.52868155","-0.065550321","Durant Street, Bethnal Green",326
"6939",2020,9,703,302,404,"51.51505991","-0.10534448","St. Bride Street, Holborn",706
"6940",2020,9,704,51,42,"51.45682071","-0.202802098","Mexfield Road, East Putney",93
"6941",2020,9,705,43,42,NA,NA,NA,85
"6942",2020,9,706,213,223,"51.50215353","-0.083632928","Snowsfields, London Bridge",436
"6943",2020,9,707,273,302,"51.49021762","-0.215087092","Barons Court Station, West Kensington",575
"6944",2020,9,708,76,72,"51.46161068","-0.21614583","Disraeli Road, Putney",148
"6945",2020,9,709,35,44,"51.46321128","-0.215550761","Montserrat Road , Putney",79
"6946",2020,9,710,183,169,"51.47439218","-0.163347594","Albert Bridge Road, Battersea Park",352
"6947",2020,9,711,101,93,"51.48335692","-0.216305546","Everington Street, Fulham",194
"6948",2020,9,712,153,144,"51.51854104","-0.034903714","Mile End Stadium, Mile End",297
"6949",2020,9,713,78,84,"51.54100708","-0.14326094","Hawley Crescent, Camden Town",162
"6950",2020,9,714,69,71,"51.47311696","-0.137235175","Stewart's Road, Wandsworth Road",140
"6951",2020,9,715,97,78,"51.51563007","-0.049067243","Aylward Street, Stepney",175
"6952",2020,9,716,71,57,"51.51542791","-0.02356501","Stainsby Road , Poplar",128
"6953",2020,9,717,295,309,"51.53658514","-0.075885686","Dunston Road , Haggerston",604
"6954",2020,9,718,198,187,"51.53571683","-0.060291813","Ada Street, Hackney Central",385
"6955",2020,9,719,261,249,"51.53642464","-0.054162264","Victoria Park Road, Hackney Central",510
"6956",2020,9,720,121,116,"51.48724429","-0.205279052","Star Road, West Kensington",237
"6957",2020,9,721,93,89,"51.53603947","-0.026262677","Wendon Street, Old Ford",182
"6958",2020,9,722,150,140,"51.52458353","-0.058631453","Finnis Street, Bethnal Green",290
"6959",2020,9,723,242,245,"51.46822047","-0.190346493","Stephendale Road, Sands End",487
"6960",2020,9,724,61,49,"51.45799126","-0.184806157","Alma Road, Wandsworth",110
"6961",2020,9,725,191,184,"51.491327","-0.096518684","Walworth Square, Walworth",375
"6962",2020,9,726,174,144,"51.47505096","-0.150908371","Alfreda Street, Battersea Park",318
"6963",2020,9,727,152,148,"51.47569809","-0.20587627","Chesilton Road, Fulham",300
"6964",2020,9,728,53,58,"51.46199911","-0.206240805","Putney Bridge Road, East Putney",111
"6965",2020,9,729,219,212,"51.47893931","-0.208485293","St. Peter's Terrace, Fulham",431
"6966",2020,9,730,162,163,"51.49208492","-0.229116862","Bridge Avenue, Hammersmith",325
"6967",2020,9,731,129,129,"51.47727637","-0.189210466","Michael Road, Walham Green",258
"6968",2020,9,732,630,674,"51.50630441","-0.087262995","Duke Street Hill, London Bridge",1304
"6969",2020,9,733,101,107,"51.50542628","-0.150817316","Park Lane, Mayfair",208
"6970",2020,9,734,70,57,"51.46230566","-0.175407201","Plough Terrace, Clapham Junction",127
"6971",2020,9,735,238,247,"51.46489445","-0.17302926","Grant Road East, Clapham Junction",485
"6972",2020,9,736,47,40,"51.50659035","-0.216104479","Queensdale Road, Shepherd's Bush",87
"6973",2020,9,737,426,422,"51.47993289","-0.19411695","Fulham Broadway, Walham Green",848
"6974",2020,9,738,111,123,"51.47514228","-0.187278987","Imperial Road, Sands End",234
"6975",2020,9,739,130,139,"51.48176572","-0.185273723","Hortensia Road, West Brompton",269
"6976",2020,9,740,31,36,"51.51092871","-0.214594781","Sirdar Road, Avondale",67
"6977",2020,9,741,58,61,"51.5129814","-0.219486603","Freston Road, Avondale",119
"6978",2020,9,742,111,115,"51.51510818","-0.208565479","Blenheim Crescent, Ladbroke Grove",226
"6979",2020,9,743,46,31,"51.46079243","-0.212607684","Oxford Road, Putney",77
"6980",2020,9,744,35,52,"51.46745485","-0.172293499","Ingrave Street, Clapham Junction",87
"6981",2020,9,745,87,83,"51.47816972","-0.18243547","Upcerne Road, West Chelsea",170
"6982",2020,9,746,144,126,"51.4795738","-0.17903854","Lots Road, West Chelsea",270
"6983",2020,9,747,110,106,"51.48796408","-0.161765173","Ormonde Gate, Chelsea",216
"6984",2020,9,748,260,225,"51.53727795","-0.079201849","Hertford Road, De Beauvoir Town",485
"6985",2020,9,749,190,184,"51.53932857","-0.074284675","Haggerston Road, Haggerston",374
"6986",2020,9,750,48,50,"51.4710956","-0.157850096","Culvert Road, Battersea",98
"6987",2020,9,751,135,140,"51.51612862","-0.120909408","Newton Street, Covent Garden",275
"6988",2020,9,754,73,77,"51.5129006","-0.214762686","Grenfell Road, Avondale",150
"6989",2020,9,755,201,185,"51.48512191","-0.174971902","The Vale, Chelsea",386
"6990",2020,9,756,139,134,"51.47515398","-0.159169801","Prince of Wales Drive, Battersea Park",273
"6991",2020,9,757,188,174,"51.48795853","-0.187404506","Harcourt Terrace, West Brompton",362
"6992",2020,9,758,120,93,"51.51787005","-0.201005397","Westbourne Park Road, Portobello",213
"6993",2020,9,759,81,62,"51.52456169","-0.165668686","Broadley Terrace, Marylebone",143
"6994",2020,9,760,105,77,"51.52526975","-0.163795009","Rossmore Road, Marylebone",182
"6995",2020,9,761,166,151,"51.48321729","-0.211860644","Humbolt Road, Fulham",317
"6996",2020,9,762,106,119,"51.50070305","-0.129698963","Storey's Gate, Westminster",225
"6997",2020,9,763,131,120,"51.52059714","-0.032566533","Mile End Park Leisure Centre, Mile End",251
"6998",2020,9,764,125,166,"51.46239255","-0.16829214","St. John's Road, Clapham Junction",291
"6999",2020,9,765,59,53,"51.46760141","-0.20682737","Ranelagh Gardens, Fulham",112
"7000",2020,9,766,156,159,"51.45752945","-0.192165613","Ram Street, Wandsworth",315
"7001",2020,9,767,18,20,"51.45705988","-0.200806304","Santos Road, Wandsworth",38
"7002",2020,9,768,144,135,"51.46134382","-0.159322467","Clapham Common North Side, Clapham Common",279
"7003",2020,9,769,162,139,"51.473611","-0.191803","Sandilands Road, Walham Green",301
"7004",2020,9,770,89,81,"51.491026","-0.209121","Gwendwr Road, West Kensington",170
"7005",2020,9,771,54,48,"51.509224","-0.216016","Rifle Place, Avondale",102
"7006",2020,9,772,263,300,"51.47250956","-0.122831913","Binfield Road, Stockwell",563
"7007",2020,9,773,273,322,"51.511891","-0.107349","Tallis Street, Temple",595
"7008",2020,9,774,42,42,"51.470131","-0.20464","Hurlingham Park, Parsons Green",84
"7009",2020,9,775,99,109,"51.496664","-0.223868","Little Brook Green, Brook Green",208
"7010",2020,9,776,90,78,"51.460333","-0.167029","Abyssinia Close, Clapham Junction",168
"7011",2020,9,777,36,28,"51.4619230679","-0.165297856693","Limburg Road, Clapham Junction",64
"7012",2020,9,779,196,230,"51.514449","-0.077178979","Houndsditch, Aldgate",426
"7013",2020,9,780,275,273,"51.474665","-0.18316517","Imperial Wharf Station, Sands End",548
"7014",2020,9,781,186,189,"51.495898","-0.173009","Victoria & Albert Museum, South Kensington",375
"7015",2020,9,782,140,146,"51.483911","-0.19760944","Halford Road, West Kensington",286
"7016",2020,9,783,189,194,"51.5403115","-0.021630359","Monier Road, Hackney Wick",383
"7017",2020,9,784,121,111,"51.546326","-0.00993526","East Village, Queen Elizabeth Olympic Park",232
"7018",2020,9,785,344,315,"51.54094","-0.010510565","Aquatic Centre, Queen Elizabeth Olympic Park",659
"7019",2020,9,786,95,109,"51.549369","-0.015717614","Lee Valley VeloPark, Queen Elizabeth Olympic Park",204
"7020",2020,9,787,82,91,"51.546805","-0.01469126","Timber Lodge, Queen Elizabeth Olympic Park",173
"7021",2020,9,789,64,94,"51.538718","-0.011889482","Podium, Queen Elizabeth Olympic Park",158
"7022",2020,9,790,138,159,"51.541793","-0.00481","Stratford Station, Stratford",297
"7023",2020,9,792,203,223,"51.505461","-0.10454093","Blackfriars Road, Southwark",426
"7024",2020,9,793,86,91,"51.528279","-0.11955857","Cromer Street, Bloomsbury",177
"7025",2020,9,795,143,153,"51.527068","-0.13186102","Euston Square Gardens, Euston",296
"7026",2020,9,796,149,112,"51.524","-0.12640984","Coram Street, Bloomsbury",261
"7027",2020,9,797,214,206,"51.5293","-0.12827903","Ossulston Street, Somers Town",420
"7028",2020,9,798,223,256,"51.5301998755","-0.122299440803","Birkenhead Street, King's Cross",479
"7029",2020,9,799,143,169,"51.4976984561","-0.137598896295","Kings Gate House, Westminster",312
"7030",2020,9,800,206,193,"51.4811219398","-0.149035374873","Sopwith Way, Battersea Park",399
"7031",2020,9,801,247,235,"51.5052241745","-0.0980318118664","Lavington Street, Bankside",482
"7032",2020,9,802,160,153,"51.4765900593","-0.118256789081","Albert Square, Stockwell",313
"7033",2020,9,803,157,152,"51.5054099403","-0.0983410884509","Southwark Street, Bankside",309
"7034",2020,9,804,277,292,"51.5346677396","-0.125078652873","Good's Way, King's Cross",569
"7035",2020,9,806,138,144,"51.5372405623","-0.124807385707","Handyside Street, King's Cross",282
"7036",2020,9,807,178,171,"51.5212","-0.20888818","Bevington Road West, North Kensington",349
"7037",2020,9,809,150,177,"51.5162778834","-0.118272991635","Lincoln's Inn Fields, Holborn",327
"7038",2020,9,810,245,285,"51.5067252868","-0.0988072461627","Tate Modern, Bankside",530
"7039",2020,9,811,181,214,"51.5057030357","-0.0277727426235","Westferry Circus, Canary Wharf",395
"7040",2020,9,812,39,57,"51.5487311915","-0.0226065549321","Here East North, Queen Elizabeth Olympic Park",96
"7041",2020,9,813,158,194,"51.4878074485","-0.122759625866","New Spring Gardens Walk, Vauxhall",352
"7042",2020,9,814,114,87,"51.4714330677","-0.123670735702","Clapham Road, Lingham Street, Stockwell",201
"7043",2020,9,815,306,297,"51.5000891978","-0.116628700672","Lambeth Palace Road, Waterloo",603
"7044",2020,9,816,41,51,"51.5465327935","-0.0205975904647","Here East South, Queen Elizabeth Olympic Park",92
"7045",2020,9,817,207,197,"51.4813354746","-0.138212295869","Riverlight South, Nine Elms",404
"7046",2020,9,818,390,436,"51.501513","-0.12382322","Westminster Pier, Westminster",826
"7047",2020,9,819,136,160,"51.50621","-0.114842","Belvedere Road 2, South Bank",296
"7048",2020,9,820,137,96,"51.492807","-0.091938","Victory Place, Walworth",233
"7049",2020,9,821,360,339,"51.4835074867","-0.147714557371","Battersea Power Station, Battersea Park",699
"7050",2020,9,826,373,383,"51.496863","-0.1429434","Allington Street, Victoria",756
"7051",2020,9,827,169,184,"51.479601","-0.11147178","Cranmer Road, Stockwell",353
"7052",2020,9,828,125,107,"51.473874","-0.11258096","Normandy Road, Stockwell",232
"7053",2020,9,829,59,49,"51.469217","-0.11268674","Wynne Road, Stockwell",108
"7054",2020,9,830,109,89,"51.469202","-0.11902256","Sidney Road, Stockwell",198
"7055",2020,9,831,75,98,"51.466232","-0.11317995","St John's Crescent, Brixton",173
"7056",2020,9,832,142,119,"51.464019","-0.11578197","Ferndale Road, Brixton",261
"7057",2020,9,833,83,102,"51.460232","-0.11537509","Saltoun Road, Brixton",185
"7058",2020,9,834,189,186,"51.477966","-0.14785703","Gas Holders, Battersea Park",375
"7059",2020,9,835,177,178,"51.516785","-0.10494775","Farringdon Street, Holborn",355
"7060",2020,9,836,152,117,"51.541596","-0.12544145","York Way, Kings Cross",269
"7061",2020,9,838,155,167,"51.518093","-0.0914017","Fore Street Avenue, Guildhall",322
"7062",2020,9,839,312,312,"51.508033","-0.10682363","Sea Containers, South Bank",624
"7063",2020,10,1,177,116,"51.52916347","-0.109970527","River Street , Clerkenwell",293
"7064",2020,10,2,200,217,"51.49960695","-0.197574246","Phillimore Gardens, Kensington",417
"7065",2020,10,3,196,235,"51.52128377","-0.084605692","Christopher Street, Liverpool Street",431
"7066",2020,10,4,100,155,"51.53005939","-0.120973687","St. Chad's Street, King's Cross",255
"7067",2020,10,5,287,345,"51.49313","-0.156876","Sedding Street, Sloane Square",632
"7068",2020,10,6,229,235,"51.51811784","-0.144228881","Broadcasting House, Marylebone",464
"7069",2020,10,7,107,97,"51.53430039","-0.1680743","Charlbert Street, St. John's Wood",204
"7070",2020,10,8,146,130,"51.529857","-0.18348604","Maida Vale, Maida Vale",276
"7071",2020,10,9,201,222,"51.5073853","-0.096440751","New Globe Walk, Bankside",423
"7072",2020,10,10,97,98,"51.50597426","-0.092754157","Park Street, Bankside",195
"7073",2020,10,11,200,199,"51.52395143","-0.122502346","Brunswick Square, Bloomsbury",399
"7074",2020,10,12,453,472,"51.52168078","-0.130431727","Malet Street, Bloomsbury",925
"7075",2020,10,13,132,173,"51.51991453","-0.136039674","Scala Street, Fitzrovia",305
"7076",2020,10,14,1544,1454,"51.52994371","-0.123616824","Belgrove Street , King's Cross",2998
"7077",2020,10,15,220,234,"51.51772703","-0.127854211","Great Russell Street, Bloomsbury",454
"7078",2020,10,16,282,246,"51.52635795","-0.125979294","Cartwright Gardens , Bloomsbury",528
"7079",2020,10,17,387,394,"51.5216612","-0.109006325","Hatton Wall, Holborn",781
"7080",2020,10,18,340,389,"51.51477076","-0.12221963","Drury Lane, Covent Garden",729
"7081",2020,10,19,312,320,"51.52505093","-0.131161087","Taviton Street, Bloomsbury",632
"7082",2020,10,20,182,145,"51.527326","-0.13605286","Drummond Street , Euston",327
"7083",2020,10,21,84,69,"51.53007835","-0.13884627","Hampstead Road (Cartmel), Euston",153
"7084",2020,10,22,293,275,"51.5222641","-0.114079481","Northington Street , Holborn",568
"7085",2020,10,23,140,155,"51.51943538","-0.119123345","Red Lion Square, Holborn",295
"7086",2020,10,24,329,371,"51.51908011","-0.124678402","British Museum, Bloomsbury",700
"7087",2020,10,25,404,319,"51.5288338","-0.132250369","Doric Way , Somers Town",723
"7088",2020,10,26,176,146,"51.52728093","-0.11829517","Ampton Street , Clerkenwell",322
"7089",2020,10,27,246,307,"51.51382102","-0.107927706","Bouverie Street, Temple",553
"7090",2020,10,28,241,236,"51.52351808","-0.143613641","Bolsover Street, Fitzrovia",477
"7091",2020,10,29,171,142,"51.513735","-0.193487","Hereford Road, Bayswater",313
"7092",2020,10,30,232,209,"51.52915444","-0.093421615","Windsor Terrace, Hoxton",441
"7093",2020,10,31,250,220,"51.52953709","-0.083353323","Fanshaw Street, Hoxton",470
"7094",2020,10,32,373,454,"51.52469624","-0.084439283","Leonard Circus , Shoreditch",827
"7095",2020,10,33,108,117,"51.5156","-0.070056","Central House, Aldgate",225
"7096",2020,10,34,131,130,"51.5341235","-0.129386874","Pancras Road, King's Cross",261
"7097",2020,10,36,196,168,"51.50173726","-0.184980612","De Vere Gardens, Kensington",364
"7098",2020,10,37,206,174,"51.49159394","-0.192369256","Penywern Road, Earl's Court",380
"7099",2020,10,38,101,100,"51.4973875","-0.197245586","Abingdon Villas, Kensington",201
"7100",2020,10,39,429,454,"51.5263778","-0.078130921","Shoreditch High Street, Shoreditch",883
"7101",2020,10,40,140,152,"51.52127071","-0.0755789","Commercial Street, Shoreditch",292
"7102",2020,10,41,322,403,"51.520955","-0.083493552","Pindar Street, Liverpool Street",725
"7103",2020,10,42,260,197,"51.53099181","-0.093903825","Wenlock Road , Hoxton",457
"7104",2020,10,43,218,225,"51.52026","-0.157183945","Crawford Street, Marylebone",443
"7105",2020,10,44,134,142,"51.51073687","-0.144165239","Bruton Street, Mayfair",276
"7106",2020,10,45,348,349,"51.522511","-0.162298","Boston Place, Marylebone",697
"7107",2020,10,46,376,380,"51.507131","-0.06691","Nesham Street, Wapping",756
"7108",2020,10,47,200,190,"51.52334476","-0.183846408","Warwick Avenue Station, Maida Vale",390
"7109",2020,10,48,288,314,"51.51248445","-0.099141408","Godliman Street, St. Paul's",602
"7110",2020,10,49,141,171,"51.50706909","-0.145904427","Curzon Street, Mayfair",312
"7111",2020,10,50,196,212,"51.52867339","-0.087459376","East Road, Hoxton",408
"7112",2020,10,51,143,155,"51.52671796","-0.104298194","Finsbury Library , Finsbury",298
"7113",2020,10,52,199,201,"51.52295439","-0.094934859","Roscoe Street, St. Luke's",400
"7114",2020,10,53,123,172,"51.5099923","-0.143495266","Grafton Street, Mayfair",295
"7115",2020,10,54,179,247,"51.52174785","-0.094475072","Golden Lane, Barbican",426
"7116",2020,10,55,517,617,"51.51707521","-0.086685542","Finsbury Circus, Liverpool Street",1134
"7117",2020,10,56,181,191,"51.52058381","-0.154701411","Paddington Street, Marylebone",372
"7118",2020,10,57,266,278,"51.52334672","-0.120202614","Guilford Street , Bloomsbury",544
"7119",2020,10,58,310,327,"51.52452699","-0.079248081","New Inn Yard, Shoreditch",637
"7120",2020,10,60,87,70,"51.52644828","-0.172190727","Lisson Grove, St. John's Wood",157
"7121",2020,10,61,211,192,"51.49738251","-0.089446947","Great Dover Street, The Borough",403
"7122",2020,10,62,107,100,"51.4907579","-0.106323685","Cotton Garden Estate, Kennington",207
"7123",2020,10,63,142,120,"51.53089041","-0.089782579","Murray Grove , Hoxton",262
"7124",2020,10,64,367,492,"51.50946212","-0.124749274","William IV Street, Strand",859
"7125",2020,10,65,192,192,NA,NA,NA,384
"7126",2020,10,66,525,964,"51.51795029","-0.108657431","Holborn Circus, Holborn",1489
"7127",2020,10,67,265,237,"51.51882555","-0.108028472","Hatton Garden, Holborn",502
"7128",2020,10,68,312,308,"51.52059681","-0.116688468","Theobald's Road , Holborn",620
"7129",2020,10,69,208,197,"51.5262363","-0.134407652","Euston Road, Euston",405
"7130",2020,10,70,85,71,"51.53136059","-0.117069978","Calshot Street , King's Cross",156
"7131",2020,10,71,492,570,"51.5154186","-0.098850915","Newgate Street , St. Paul's",1062
"7132",2020,10,72,172,173,"51.52352001","-0.108340165","Farringdon Lane, Clerkenwell",345
"7133",2020,10,73,436,463,"51.52572618","-0.088486188","Old Street Station, St. Luke's",899
"7134",2020,10,74,433,431,"51.48591714","-0.124469948","Vauxhall Cross, Vauxhall",864
"7135",2020,10,75,224,225,"51.53219984","-0.105480698","Torrens Street, Angel",449
"7136",2020,10,76,119,85,"51.52559505","-0.144083893","Longford Street, The Regent's Park",204
"7137",2020,10,77,243,246,"51.52341837","-0.124121774","Russell Square Station, Bloomsbury",489
"7138",2020,10,78,246,234,"51.52486887","-0.099489485","Sadlers Sports Centre, Finsbury",480
"7139",2020,10,79,131,174,"51.511726","-0.11385596","Arundel Street, Temple",305
"7140",2020,10,80,196,152,"51.50069361","-0.102091246","Webber Street , Southwark",348
"7141",2020,10,81,230,236,"51.52025302","-0.141327271","Great Titchfield Street, Fitzrovia",466
"7142",2020,10,82,152,152,"51.514274","-0.111257","Chancery Lane, Holborn",304
"7143",2020,10,83,270,302,"51.50963938","-0.131510949","Panton Street, West End",572
"7144",2020,10,84,201,206,"51.51593725","-0.111778348","Breams Buildings, Holborn",407
"7145",2020,10,85,275,276,"51.50064702","-0.078600401","Tanner Street, Bermondsey",551
"7146",2020,10,86,163,125,"51.48947903","-0.115156562","Sancroft Street, Vauxhall",288
"7147",2020,10,87,262,286,"51.51646835","-0.079684557","Devonshire Square, Liverpool Street",548
"7148",2020,10,88,296,326,"51.51858757","-0.132053392","Bayley Street , Bloomsbury",622
"7149",2020,10,89,177,174,"51.5262503","-0.123509611","Tavistock Place, Bloomsbury",351
"7150",2020,10,90,56,54,"51.53301907","-0.139174593","Harrington Square 1, Camden Town",110
"7151",2020,10,91,175,149,"51.49368637","-0.111014912","Walnut Tree Walk, Vauxhall",324
"7152",2020,10,92,171,162,"51.49889832","-0.100440521","Borough Road, Elephant & Castle",333
"7153",2020,10,93,204,98,"51.53440868","-0.109025404","Cloudesley Road, Angel",302
"7154",2020,10,94,231,221,"51.49506109","-0.085814489","Bricklayers Arms, Borough",452
"7155",2020,10,95,415,433,"51.5208417","-0.097340162","Aldersgate Street, Barbican",848
"7156",2020,10,96,180,179,"51.53095071","-0.078505384","Falkirk Street, Hoxton",359
"7157",2020,10,97,202,209,"51.49792478","-0.183834706","Gloucester Road (North), Kensington",411
"7158",2020,10,98,261,208,"51.52554222","-0.138231303","Hampstead Road, Euston",469
"7159",2020,10,99,287,310,"51.51457763","-0.158264483","Old Quebec Street, Marylebone",597
"7160",2020,10,100,140,131,"51.49043573","-0.122806861","Albert Embankment, Vauxhall",271
"7161",2020,10,101,630,687,"51.51155322","-0.0929401","Queen Street 1, Bank",1317
"7162",2020,10,102,276,307,"51.51340693","-0.076793375","Jewry Street, Aldgate",583
"7163",2020,10,103,76,66,"51.50472376","-0.192538767","Vicarage Gate, Kensington",142
"7164",2020,10,104,631,702,"51.51159481","-0.077121322","Crosswall, Tower",1333
"7165",2020,10,105,196,165,"51.51552971","-0.190240716","Westbourne Grove, Bayswater",361
"7166",2020,10,106,119,128,"51.51410514","-0.147301667","Woodstock Street, Mayfair",247
"7167",2020,10,107,441,463,"51.52600832","-0.096317627","Finsbury Leisure Centre, St. Luke's",904
"7168",2020,10,108,213,308,"51.49812559","-0.132102166","Abbey Orchard Street, Westminster",521
"7169",2020,10,109,438,551,"51.51563144","-0.132328837","Soho Square , Soho",989
"7170",2020,10,110,128,90,"51.53304322","-0.172528678","Wellington Road, St. John's Wood",218
"7171",2020,10,111,334,343,"51.5100172","-0.157275636","Park Lane , Hyde Park",677
"7172",2020,10,112,175,216,"51.51580998","-0.105270275","Stonecutter Street, Holborn",391
"7173",2020,10,113,143,145,"51.49646288","-0.183289032","Gloucester Road (Central), South Kensington",288
"7174",2020,10,114,235,227,"51.52451738","-0.158963647","Park Road (Baker Street), The Regent's Park",462
"7175",2020,10,115,368,417,"51.51423368","-0.073537654","Braham Street, Aldgate",785
"7176",2020,10,116,341,399,"51.51449962","-0.141423695","Little Argyll Street, West End",740
"7177",2020,10,117,247,214,"51.49288067","-0.114934001","Lollard Street, Vauxhall",461
"7178",2020,10,118,108,151,"51.49582705","-0.13547809","Rochester Row, Westminster",259
"7179",2020,10,119,343,364,"51.52589324","-0.090847761","Bath Street, St. Luke's",707
"7180",2020,10,120,187,191,"51.51573534","-0.093080779","The Guildhall, Guildhall",378
"7181",2020,10,121,235,260,"51.51891348","-0.156166631","Baker Street, Marylebone",495
"7182",2020,10,122,202,234,"51.52111369","-0.078869751","Norton Folgate, Liverpool Street",436
"7183",2020,10,123,149,129,"51.52836014","-0.104724625","St. John Street, Finsbury",278
"7184",2020,10,124,86,87,"51.49654462","-0.150905245","Eaton Square, Belgravia",173
"7185",2020,10,125,207,210,"51.50069491","-0.094524319","Borough High Street, The Borough",417
"7186",2020,10,126,335,326,"51.51782144","-0.096496865","Museum of London, Barbican",661
"7187",2020,10,127,168,196,"51.51700801","-0.09388536","Wood Street, Guildhall",364
"7188",2020,10,128,150,157,"51.49536226","-0.185296516","Emperor's Gate, South Kensington",307
"7189",2020,10,129,210,245,"51.5118973","-0.137043852","Golden Square, Soho",455
"7190",2020,10,130,323,373,"51.50950627","-0.075459482","Tower Gardens , Tower",696
"7191",2020,10,131,155,133,"51.53300545","-0.136792671","Eversholt Street , Camden Town",288
"7192",2020,10,132,616,657,"51.52364804","-0.074754872","Bethnal Green Road, Shoreditch",1273
"7193",2020,10,133,363,386,NA,NA,NA,749
"7194",2020,10,134,132,115,"51.504904","-0.06797","Wapping High Street, Wapping",247
"7195",2020,10,135,331,343,"51.52326004","-0.104708922","Clerkenwell Green, Clerkenwell",674
"7196",2020,10,136,295,311,"51.51196176","-0.097441687","Queen Victoria Street, St. Paul's",606
"7197",2020,10,138,221,221,"51.51227622","-0.157436972","Green Street, Mayfair",442
"7198",2020,10,139,168,157,"51.49488108","-0.117974901","Lambeth Road, Vauxhall",325
"7199",2020,10,140,324,384,"51.52096262","-0.085634242","Finsbury Square , Moorgate",708
"7200",2020,10,141,212,248,"51.51530805","-0.147203711","Chapel Place, Marylebone",460
"7201",2020,10,142,134,112,"51.49372451","-0.198286569","West Cromwell Road, Earl's Court",246
"7202",2020,10,143,181,214,"51.4968865","-0.161203828","Pont Street, Knightsbridge",395
"7203",2020,10,144,333,263,"51.48894022","-0.111435796","Kennington Cross, Kennington",596
"7204",2020,10,145,41,28,"51.50074359","-0.202759212","Ilchester Place, Kensington",69
"7205",2020,10,146,106,106,"51.48836528","-0.129361842","Vauxhall Bridge , Pimlico",212
"7206",2020,10,148,187,197,"51.49211134","-0.138364847","Tachbrook Street, Victoria",384
"7207",2020,10,149,136,131,"51.48478899","-0.110683213","Kennington Road Post Office, Oval",267
"7208",2020,10,150,140,185,"51.49705603","-0.168917077","Holy Trinity Brompton, Knightsbridge",325
"7209",2020,10,151,143,96,"51.51213691","-0.201554966","Chepstow Villas, Notting Hill",239
"7210",2020,10,152,184,161,"51.49217002","-0.101536865","Hampton Street, Walworth",345
"7211",2020,10,153,400,399,"51.511933","-0.174411","Bayswater Road, Hyde Park",799
"7212",2020,10,154,1454,1358,"51.50379168","-0.11282408","Waterloo Station 3, Waterloo",2812
"7213",2020,10,155,143,150,"51.49586666","-0.191933711","Lexham Gardens, Kensington",293
"7214",2020,10,156,139,140,"51.49443626","-0.092921165","New Kent Road, The Borough",279
"7215",2020,10,157,189,215,"51.50039792","-0.193068385","Wright's Lane, Kensington",404
"7216",2020,10,158,155,143,"51.49085368","-0.196170309","Trebovir Road, Earl's Court",298
"7217",2020,10,159,384,457,"51.51461995","-0.137841333","Great Marlborough Street, Soho",841
"7218",2020,10,160,207,251,"51.50663341","-0.131773845","Waterloo Place, St. James's",458
"7219",2020,10,161,127,117,"51.49234577","-0.141334487","Guildhouse Street, Victoria",244
"7220",2020,10,162,195,238,"51.51760685","-0.121328408","Southampton Place, Holborn",433
"7221",2020,10,163,265,285,"51.4931848","-0.167894973","Sloane Avenue, Knightsbridge",550
"7222",2020,10,164,166,124,"51.515607","-0.183118788","Cleveland Gardens, Bayswater",290
"7223",2020,10,165,81,49,"51.517932","-0.183716959","Orsett Terrace, Bayswater",130
"7224",2020,10,166,164,163,"51.50185512","-0.159237081","Seville Street, Knightsbridge",327
"7225",2020,10,167,399,417,"51.49395092","-0.147624377","Eccleston Place, Victoria",816
"7226",2020,10,168,115,119,"51.50040123","-0.195455928","Argyll Road, Kensington",234
"7227",2020,10,169,264,240,"51.51474612","-0.165164288","Porchester Place, Paddington",504
"7228",2020,10,170,125,121,"51.52784273","-0.108068155","Hardwick Street, Clerkenwell",246
"7229",2020,10,171,145,129,"51.4916156","-0.186753859","Collingham Gardens, Earl's Court",274
"7230",2020,10,172,112,112,"51.49121192","-0.173715911","Sumner Place, South Kensington",224
"7231",2020,10,173,222,195,"51.50486","-0.113001","Waterloo Road, South Bank",417
"7232",2020,10,174,205,267,"51.512529","-0.115163","Strand, Strand",472
"7233",2020,10,175,264,326,"51.521668","-0.079608554","Worship Street, Shoreditch",590
"7234",2020,10,176,178,148,"51.51791921","-0.188098863","Gloucester Terrace, Bayswater",326
"7235",2020,10,177,358,395,"51.49616092","-0.140947636","Ashley Place, Victoria",753
"7236",2020,10,178,233,191,"51.48985626","-0.141923621","Warwick Square, Pimlico",424
"7237",2020,10,180,169,179,"51.5129118","-0.153645496","North Audley Street, Mayfair",348
"7238",2020,10,181,128,122,"51.49941247","-0.152317537","Belgrave Square, Belgravia",250
"7239",2020,10,182,189,167,"51.52202903","-0.165842551","Bell Street , Marylebone",356
"7240",2020,10,183,232,220,"51.482362","-0.13612398","Riverlight North, Nine Elms",452
"7241",2020,10,184,175,196,"51.52071513","-0.14521173","Portland Place, Marylebone",371
"7242",2020,10,185,244,220,"51.48805753","-0.140741432","Alderney Street, Pimlico",464
"7243",2020,10,186,578,529,"51.51733558","-0.175810943","South Wharf Road, Paddington",1107
"7244",2020,10,187,166,169,"51.49247977","-0.178433004","Queen's Gate (South), South Kensington",335
"7245",2020,10,188,119,98,"51.5165179","-0.164393768","Nutford Place, Marylebone",217
"7246",2020,10,189,136,72,"51.53166681","-0.109914711","Claremont Square, Angel",208
"7247",2020,10,190,221,223,"51.48997562","-0.132845681","Rampayne Street, Pimlico",444
"7248",2020,10,191,807,812,"51.50311799","-0.153520935","Hyde Park Corner, Hyde Park",1619
"7249",2020,10,192,334,379,"51.51251523","-0.133201961","Wardour Street, Soho",713
"7250",2020,10,193,289,374,"51.50581776","-0.100186337","Bankside Mix, Bankside",663
"7251",2020,10,194,661,1019,"51.50462759","-0.091773776","Hop Exchange, The Borough",1680
"7252",2020,10,195,256,276,"51.50724437","-0.106237501","Milroy Walk, South Bank",532
"7253",2020,10,196,225,227,"51.50368837","-0.098497684","Union Street, The Borough",452
"7254",2020,10,197,269,324,"51.50556905","-0.111606696","Stamford Street, South Bank",593
"7255",2020,10,199,510,619,"51.51048489","-0.082989638","Great Tower Street, Monument",1129
"7256",2020,10,200,271,272,"51.51492456","-0.066078037","LMU Commercial Road, Whitechapel",543
"7257",2020,10,201,275,277,"51.5225965","-0.161113413","Dorset Square, Marylebone",552
"7258",2020,10,202,399,416,"51.51236389","-0.06954201","Leman Street, Aldgate",815
"7259",2020,10,203,299,311,"51.51821864","-0.100791005","West Smithfield Rotunda, Farringdon",610
"7260",2020,10,204,144,143,"51.52659961","-0.112432615","Margery Street, Clerkenwell",287
"7261",2020,10,206,261,264,"51.518154","-0.062697","New Road 1 , Whitechapel",525
"7262",2020,10,207,82,85,"51.50135267","-0.153194766","Grosvenor Crescent, Belgravia",167
"7263",2020,10,208,64,50,"51.52505151","-0.166304359","Mallory Street, Marylebone",114
"7264",2020,10,209,102,107,"51.49358391","-0.165101392","Denyer Street, Knightsbridge",209
"7265",2020,10,210,287,295,"51.51681444","-0.151926305","Hinde Street, Marylebone",582
"7266",2020,10,211,125,186,"51.49464523","-0.158105512","Cadogan Place, Knightsbridge",311
"7267",2020,10,212,108,80,"51.50658458","-0.199004026","Campden Hill Road, Notting Hill",188
"7268",2020,10,213,584,584,"51.50274025","-0.149569201","Wellington Arch, Hyde Park",1168
"7269",2020,10,214,395,398,"51.52683806","-0.130504336","Endsleigh Gardens, Euston",793
"7270",2020,10,215,415,529,"51.51906932","-0.088285377","Moorfields, Moorgate",944
"7271",2020,10,216,172,189,"51.49094565","-0.181190899","Old Brompton Road, South Kensington",361
"7272",2020,10,217,765,803,"51.51615461","-0.082422399","Wormwood Street, Liverpool Street",1568
"7273",2020,10,218,160,160,"51.48971651","-0.170194408","St. Luke's Church, Chelsea",320
"7274",2020,10,219,251,220,"51.49016361","-0.19039362","Bramham Gardens, Earl's Court",471
"7275",2020,10,220,119,111,"51.49066456","-0.166485083","Chelsea Green, Chelsea",230
"7276",2020,10,221,229,268,"51.49481649","-0.13045856","Horseferry Road, Westminster",497
"7277",2020,10,222,93,49,"51.50275704","-0.155349725","Knightsbridge, Hyde Park",142
"7278",2020,10,223,143,111,"51.49148474","-0.090220911","Rodney Road , Walworth",254
"7279",2020,10,224,263,274,"51.51031","-0.18740235","Queensway, Kensington Gardens",537
"7280",2020,10,225,304,265,"51.50935342","-0.196422","Notting Hill Gate Station, Notting Hill",569
"7281",2020,10,226,190,218,"51.50844614","-0.131961389","Charles II Street, West End",408
"7282",2020,10,227,221,187,"51.52891573","-0.115480888","Great Percy Street, Clerkenwell",408
"7283",2020,10,228,381,593,"51.50742485","-0.134621209","St. James's Square, St. James's",974
"7284",2020,10,229,441,524,"51.50654321","-0.123179697","Whitehall Place, Strand",965
"7285",2020,10,230,132,145,"51.50669284","-0.103137426","Poured Lines, Bankside",277
"7286",2020,10,231,207,215,"51.49396755","-0.17873226","Queen's Gate (Central), South Kensington",422
"7287",2020,10,232,101,105,"51.51501025","-0.112753217","Carey Street, Holborn",206
"7288",2020,10,233,244,357,"51.50777049","-0.130699733","Pall Mall East, West End",601
"7289",2020,10,234,263,262,"51.53450449","-0.106992706","Liverpool Road (N1 Centre), Angel",525
"7290",2020,10,235,178,130,"51.49571828","-0.110889274","Kennington Road  , Vauxhall",308
"7291",2020,10,236,117,146,"51.51838043","-0.073438925","Fashion Street, Whitechapel",263
"7292",2020,10,237,206,198,"51.5097860151","-0.0681619805156","Dock Street, Wapping",404
"7293",2020,10,238,98,50,"51.5233534","-0.175116099","Frampton Street, Paddington",148
"7294",2020,10,239,337,331,"51.52443845","-0.138019439","Warren Street Station, Euston",668
"7295",2020,10,240,101,104,"51.50545935","-0.10569204","Colombo Street, Southwark",205
"7296",2020,10,242,169,177,"51.52200801","-0.151359288","Beaumont Street, Marylebone",346
"7297",2020,10,243,222,190,"51.49096258","-0.139625122","Gloucester Street, Pimlico",412
"7298",2020,10,244,251,266,"51.51611887","-0.128585022","Earnshaw Street , Covent Garden",517
"7299",2020,10,245,111,82,"51.4853572","-0.142207481","Grosvenor Road, Pimlico",193
"7300",2020,10,246,341,407,"51.52285301","-0.099994052","Berry Street, Clerkenwell",748
"7301",2020,10,247,100,62,"51.530529","-0.167515","St. John's Wood Church, The Regent's Park",162
"7302",2020,10,248,360,361,"51.50645179","-0.170279555","Triangle Car Park, Hyde Park",721
"7303",2020,10,249,132,135,"51.49859784","-0.096191134","Harper Road, The Borough",267
"7304",2020,10,250,88,100,"51.489932","-0.162727","Royal Avenue 1, Chelsea",188
"7305",2020,10,251,565,669,"51.518908","-0.079249","Brushfield Street, Liverpool Street",1234
"7306",2020,10,252,360,359,"51.5046364","-0.116542278","Jubilee Gardens, South Bank",719
"7307",2020,10,253,253,188,"51.53404294","-0.086379717","Shoreditch Park, Hoxton",441
"7308",2020,10,254,234,184,"51.53051587","-0.106408455","Chadwell Street, Angel",418
"7309",2020,10,255,171,153,"51.52557531","-0.179592915","Clifton Road, Maida Vale",324
"7310",2020,10,256,163,174,"51.51362054","-0.116764211","Houghton Street, Strand",337
"7311",2020,10,257,127,126,"51.52248185","-0.154907218","Westminster University, Marylebone",253
"7312",2020,10,259,152,150,"51.490959","-0.1532331","Bourne Street, Belgravia",302
"7313",2020,10,260,212,235,"51.5136846","-0.135580879","Broadwick Street, Soho",447
"7314",2020,10,261,105,75,"51.5134891","-0.191351186","Princes Square, Bayswater",180
"7315",2020,10,262,126,106,"51.49874469","-0.103132904","LSBU (Borough Road), Elephant & Castle",232
"7316",2020,10,263,225,243,"51.51422502","-0.080660083","St. Mary Axe, Aldgate",468
"7317",2020,10,264,285,292,"51.52644342","-0.109256828","Tysoe Street, Clerkenwell",577
"7318",2020,10,265,176,140,"51.51595344","-0.169249375","Southwick Street, Paddington",316
"7319",2020,10,266,295,308,"51.50102668","-0.180246101","Queen's Gate (North), Kensington",603
"7320",2020,10,267,186,168,"51.49206037","-0.132224622","Regency Street, Westminster",354
"7321",2020,10,268,279,303,"51.49320445","-0.144132875","Belgrave Road, Victoria",582
"7322",2020,10,269,214,182,"51.50082346","-0.089740764","Empire Square, The Borough",396
"7323",2020,10,270,521,516,"51.4863434","-0.122492418","Kennington Lane Rail Bridge, Vauxhall",1037
"7324",2020,10,271,101,78,"51.53583617","-0.156285395","London Zoo,  The Regent's Park",179
"7325",2020,10,272,402,457,"51.50144456","-0.110699309","Baylis Road, Waterloo",859
"7326",2020,10,273,288,323,"51.50613324","-0.114686385","Belvedere Road 1, South Bank",611
"7327",2020,10,274,148,152,"51.49671237","-0.20528437","Warwick Road, Olympia",300
"7328",2020,10,275,184,199,"51.52004497","-0.092176447","Barbican Centre, Barbican",383
"7329",2020,10,276,136,125,"51.50930161","-0.084985356","Lower Thames Street, Monument",261
"7330",2020,10,277,211,204,"51.50315739","-0.191496313","Kensington Church Street, Kensington",415
"7331",2020,10,278,649,650,"51.5034938","-0.07962099","Tooley Street, Bermondsey",1299
"7332",2020,10,279,311,270,"51.51862243","-0.176645823","North Wharf Road, Paddington",581
"7333",2020,10,280,170,177,"51.490083","-0.162418","Royal Avenue 2, Chelsea",347
"7334",2020,10,281,206,202,"51.49580589","-0.127575233","Smith Square, Westminster",408
"7335",2020,10,282,408,424,"51.51906446","-0.059642081","Royal London Hospital, Whitechapel",832
"7336",2020,10,283,73,87,"51.51440928","-0.118478757","Kingsway, Covent Garden",160
"7337",2020,10,284,156,155,"51.49914063","-0.112031483","Lambeth North Station, Waterloo",311
"7338",2020,10,286,168,110,"51.5272947","-0.174653609","St. John's Wood Road, St. John's Wood",278
"7339",2020,10,287,155,157,"51.52367314","-0.128377673","Bedford Way, Bloomsbury",312
"7340",2020,10,288,309,352,"51.49236962","-0.147478734","Elizabeth Bridge, Victoria",661
"7341",2020,10,289,68,84,"51.50923022","-0.151296092","South Audley Street, Mayfair",152
"7342",2020,10,290,219,186,"51.518268","-0.17110323","St Mary's Hospital, Paddington",405
"7343",2020,10,291,208,180,"51.48483991","-0.138089062","Claverton Street, Pimlico",388
"7344",2020,10,292,178,175,"51.49888404","-0.165471605","Montpelier Street, Knightsbridge",353
"7345",2020,10,293,123,106,"51.49815779","-0.209494128","Kensington Olympia Station, Olympia",229
"7346",2020,10,294,248,222,"51.488226","-0.135635511","St. George's Square, Pimlico",470
"7347",2020,10,295,160,160,"51.50029631","-0.092762704","Swan Street, The Borough",320
"7348",2020,10,296,144,127,"51.49363156","-0.190603326","Knaresborough Place, Earl's Court",271
"7349",2020,10,297,60,44,"51.49612799","-0.106000855","Geraldine Street, Elephant & Castle",104
"7350",2020,10,298,349,359,"51.50227992","-0.074189225","Curlew Street, Shad Thames",708
"7351",2020,10,299,86,96,"51.49398524","-0.136928582","Vincent Square, Westminster",182
"7352",2020,10,300,391,388,"51.505014","-0.17306032","Serpentine Car Park, Hyde Park",779
"7353",2020,10,301,267,262,"51.51475963","-0.148105415","Marylebone Lane, Marylebone",529
"7354",2020,10,302,122,132,"51.466907","-0.216573","Putney Pier, Wandsworth",254
"7355",2020,10,303,531,531,"51.50295379","-0.158456089","Albert Gate, Hyde Park",1062
"7356",2020,10,306,210,190,"51.51816295","-0.135025698","Rathbone Street, Fitzrovia",400
"7357",2020,10,307,302,315,"51.50990837","-0.187842717","Black Lion Gate, Kensington Gardens",617
"7358",2020,10,308,206,178,"51.49907558","-0.085666316","Long Lane , Bermondsey",384
"7359",2020,10,309,140,154,"51.50963123","-0.119047563","Embankment (Savoy), Strand",294
"7360",2020,10,310,227,215,"51.4908679","-0.116911864","Black Prince Road, Vauxhall",442
"7361",2020,10,311,205,215,"51.51918144","-0.140485596","Foley Street, Fitzrovia",420
"7362",2020,10,312,147,135,"51.53088935","-0.176770502","Grove End Road, St. John's Wood",282
"7363",2020,10,313,267,290,"51.51734403","-0.138072691","Wells Street, Fitzrovia",557
"7364",2020,10,314,198,198,"51.50088934","-0.083159352","Tyers Gate, Bermondsey",396
"7365",2020,10,315,136,137,"51.52536703","-0.153463612","The Tennis Courts, The Regent's Park",273
"7366",2020,10,316,228,252,NA,NA,NA,480
"7367",2020,10,317,62,52,"51.49679128","-0.093913472","Dickens Square, Borough",114
"7368",2020,10,318,235,245,"51.51004801","-0.138846453","Sackville Street, Mayfair",480
"7369",2020,10,319,258,252,"51.52702563","-0.088542771","Baldwin Street, St. Luke's",510
"7370",2020,10,320,336,352,"51.49357351","-0.139956043","Queen Mother Sports Centre, Victoria",688
"7371",2020,10,321,321,323,"51.49785559","-0.081608045","Bermondsey Street, Bermondsey",644
"7372",2020,10,322,130,139,"51.526293","-0.073955","Palissy Street, Shoreditch",269
"7373",2020,10,323,131,148,"51.523196","-0.083067","Clifton Street, Shoreditch",279
"7374",2020,10,324,203,211,"51.49652013","-0.101384068","Ontario Street, Elephant & Castle",414
"7375",2020,10,325,133,169,"51.50908747","-0.129697889","St. Martin's Street, West End",302
"7376",2020,10,326,318,250,"51.53266186","-0.099981142","Graham Street, Angel",568
"7377",2020,10,327,68,34,"51.53095","-0.085603","New North Road 1, Hoxton",102
"7378",2020,10,328,89,59,"51.53114","-0.086016","New North Road 2, Hoxton",148
"7379",2020,10,329,143,123,"51.53589283","-0.160854428","Prince Albert Road, The Regent's Park",266
"7380",2020,10,330,294,242,"51.51641749","-0.179135079","Eastbourne Mews, Paddington",536
"7381",2020,10,331,361,399,"51.52085887","-0.089887855","Bunhill Row, Moorgate",760
"7382",2020,10,332,107,88,"51.49334336","-0.194757949","Nevern Place, Earl's Court",195
"7383",2020,10,333,188,151,"51.50860544","-0.193764092","Palace Gardens Terrace, Notting Hill",339
"7384",2020,10,334,152,156,"51.505044","-0.115851","Concert Hall Approach 1, South Bank",308
"7385",2020,10,335,209,308,"51.51196803","-0.120718759","Tavistock Street, Covent Garden",517
"7386",2020,10,336,175,177,"51.504942","-0.115533","Concert Hall Approach 2, South Bank",352
"7387",2020,10,337,129,109,"51.51108452","-0.197524944","Pembridge Villas, Notting Hill",238
"7388",2020,10,338,301,328,"51.51175646","-0.119643424","Wellington Street , Strand",629
"7389",2020,10,339,102,63,"51.5333196","-0.1117812","Risinghill Street, Angel",165
"7390",2020,10,340,395,481,"51.51444134","-0.087587447","Bank of England Museum, Bank",876
"7391",2020,10,341,576,595,"51.50810309","-0.12602103","Craven Street, Strand",1171
"7392",2020,10,343,142,117,"51.53692216","-0.150181444","London Zoo Car Park, The Regent's Park",259
"7393",2020,10,344,154,128,"51.528246","-0.10102611","Goswell Road (City Uni), Finsbury",282
"7394",2020,10,345,349,368,"51.48802358","-0.166878535","Flood Street, Chelsea",717
"7395",2020,10,347,209,225,"51.50013942","-0.113936001","Lower Marsh, Waterloo",434
"7396",2020,10,348,163,196,"51.51217033","-0.150481272","Grosvenor Square, Mayfair",359
"7397",2020,10,349,156,197,"51.51196","-0.142783033","St. George Street, Mayfair",353
"7398",2020,10,350,304,314,"51.5017154373867","-0.1798541843891","Queen's Gate, Kensington Gardens",618
"7399",2020,10,351,205,173,"51.529423","-0.097122","Macclesfield Rd, St Lukes",378
"7400",2020,10,352,164,156,"51.486965","-0.116625","Vauxhall Street, Vauxhall",320
"7401",2020,10,353,99,112,"51.49459148","-0.134234258","Greycoat Street , Westminster",211
"7402",2020,10,354,268,416,"51.506767","-0.123702","Northumberland Avenue, Strand",684
"7403",2020,10,356,454,455,"51.494412","-0.173881","South Kensington Station, South Kensington",909
"7404",2020,10,357,281,302,"51.520994","-0.139016","Howland Street, Fitzrovia",583
"7405",2020,10,358,255,274,"51.516226","-0.124826","High Holborn , Covent Garden",529
"7406",2020,10,359,130,142,"51.49782999","-0.135440826","Butler Place, Westminster",272
"7407",2020,10,360,268,341,"51.49675303","-0.138733562","Howick Place, Westminster",609
"7408",2020,10,361,678,453,"51.50391973","-0.11342629","Waterloo Station 2, Waterloo",1131
"7409",2020,10,362,188,148,"51.536264","-0.133952","Royal College Street, Camden Town",336
"7410",2020,10,363,62,42,"51.5291212008901","-0.171185284853","Lord's, St. John's Wood",104
"7411",2020,10,364,290,294,"51.519656","-0.132339","Alfred Place, Bloomsbury",584
"7412",2020,10,365,202,183,"51.530344","-0.100168","City Road, Angel",385
"7413",2020,10,366,98,161,"51.5109192966489","-0.1511263847351","Millennium Hotel, Mayfair",259
"7414",2020,10,367,131,113,"51.5173721","-0.1642075","Harrowby Street, Marylebone",244
"7415",2020,10,368,165,200,"51.50024195","-0.15934065","Harriet Street, Knightsbridge",365
"7416",2020,10,370,56,34,"51.520205","-0.174593","Paddington Green, Paddington",90
"7417",2020,10,371,118,99,"51.49775","-0.10988","King Edward Walk, Waterloo",217
"7418",2020,10,372,181,213,"51.515208","-0.117863","Sardinia Street, Holborn",394
"7419",2020,10,373,181,196,"51.49980661","-0.176415994","Prince Consort Road, Knightsbridge",377
"7420",2020,10,374,1329,1059,"51.50402794","-0.11386436","Waterloo Station 1, Waterloo",2388
"7421",2020,10,375,95,99,"51.50194596","-0.194392952","Kensington Town Hall, Kensington",194
"7422",2020,10,376,252,260,"51.49188409","-0.125674815","Millbank Tower, Pimlico",512
"7423",2020,10,377,140,137,"51.50535447","-0.113656543","Waterloo Bridge, South Bank",277
"7424",2020,10,378,189,185,"51.49559291","-0.179077626","Natural History Museum, South Kensington",374
"7425",2020,10,379,178,168,"51.51431171","-0.200838199","Turquoise Island, Notting Hill",346
"7426",2020,10,380,110,111,"51.50686435","-0.150666888","Stanhope Gate, Mayfair",221
"7427",2020,10,381,178,185,"51.51953043","-0.13577731","Charlotte Street, Fitzrovia",363
"7428",2020,10,382,97,110,"51.50935171","-0.14744969","Farm Street, Mayfair",207
"7429",2020,10,383,227,255,"51.51310333","-0.13121385","Frith Street, Soho",482
"7430",2020,10,384,106,93,"51.496481","-0.192404","Marloes Road, Kensington",199
"7431",2020,10,386,326,350,"51.51352755","-0.130110822","Moor Street, Soho",676
"7432",2020,10,387,264,237,"51.49369988","-0.121394101","Fire Brigade Pier, Vauxhall",501
"7433",2020,10,388,234,275,"51.51070161","-0.121723604","Southampton Street, Strand",509
"7434",2020,10,389,39,43,"51.51013066","-0.155757901","Upper Grosvenor Street, Mayfair",82
"7435",2020,10,390,66,112,"51.521776","-0.068856","Buxton Street 1, Shoreditch",178
"7436",2020,10,392,346,384,"51.49942855","-0.179702476","Imperial College, Knightsbridge",730
"7437",2020,10,393,304,301,"51.51733427","-0.103604248","Snow Hill, Farringdon",605
"7438",2020,10,394,101,67,"51.524826","-0.176268","Aberdeen Place, St. John's Wood",168
"7439",2020,10,395,249,268,"51.492462","-0.159919","Cadogan Gardens, Chelsea",517
"7440",2020,10,396,143,140,"51.51809","-0.163609","Shouldham Street, Marylebone",283
"7441",2020,10,397,247,221,"51.51348","-0.17977","Devonshire Terrace, Bayswater",468
"7442",2020,10,398,84,48,"51.502319","-0.200742","Holland Park, Kensington",132
"7443",2020,10,399,116,157,"51.52261762","-0.071653961","Brick Lane Market, Shoreditch",273
"7444",2020,10,400,165,241,"51.517703","-0.154106","George Street, Marylebone",406
"7445",2020,10,401,229,209,"51.528187","-0.075375","Columbia Road, Shoreditch",438
"7446",2020,10,402,137,107,"51.52289229","-0.171681991","Penfold Street, Marylebone",244
"7447",2020,10,403,175,175,"51.51689296","-0.158249929","George Place Mews, Marylebone",350
"7448",2020,10,404,337,333,"51.50204238","-0.184400221","Palace Gate, Kensington Gardens",670
"7449",2020,10,405,378,389,"51.49418566","-0.18267094","Gloucester Road Station, South Kensington",767
"7450",2020,10,408,53,47,NA,NA,NA,100
"7451",2020,10,409,195,202,"51.493146","-0.099828","Strata, Elephant & Castle",397
"7452",2020,10,410,156,117,"51.519968","-0.169774","Edgware Road Station, Marylebone",273
"7453",2020,10,411,251,267,"51.49337264","-0.09968067","Walworth Road, Elephant & Castle",518
"7454",2020,10,412,109,97,"51.488105","-0.110121","Cleaver Street, Kennington",206
"7455",2020,10,419,153,122,"51.485821","-0.149004","Chelsea Bridge, Pimlico",275
"7456",2020,10,420,128,157,"51.504043","-0.105312","Southwark Station 1, Southwark",285
"7457",2020,10,421,261,283,"51.504044","-0.104778","Southwark Station 2, Southwark",544
"7458",2020,10,423,95,105,"51.49456127","-0.15393398","Eaton Square (South), Belgravia",200
"7459",2020,10,424,171,165,"51.490491","-0.149186","Ebury Bridge, Pimlico",336
"7460",2020,10,425,177,177,"51.533379","-0.139159","Harrington Square 2, Camden Town",354
"7461",2020,10,426,131,140,"51.493072","-0.129925","Vincent Street, Pimlico",271
"7462",2020,10,427,438,600,"51.51397065","-0.09294031","Cheapside, Bank",1038
"7463",2020,10,428,419,508,"51.499917","-0.174554","Exhibition Road, Knightsbridge",927
"7464",2020,10,430,112,108,"51.48902","-0.17524","South Parade, Chelsea",220
"7465",2020,10,431,118,111,"51.534474","-0.122203","Crinan Street, King's Cross",229
"7466",2020,10,432,316,382,"51.496957","-0.173894","Exhibition Road Museums, South Kensington",698
"7467",2020,10,433,296,284,"51.524564","-0.116279","Wren Street, Holborn",580
"7468",2020,10,435,166,146,"51.488852","-0.105593","Kennington Station, Kennington",312
"7469",2020,10,436,379,381,"51.51824","-0.11655","Red Lion Street, Holborn",760
"7470",2020,10,437,148,129,"51.488124","-0.120903","Vauxhall Walk, Vauxhall",277
"7471",2020,10,439,70,77,"51.5338","-0.118677","Killick Street, King's Cross",147
"7472",2020,10,440,166,126,"51.483145","-0.113134","Kennington Oval, Oval",292
"7473",2020,10,441,177,136,"51.495656","-0.114605","Sail Street, Vauxhall",313
"7474",2020,10,442,70,63,"51.510101","-0.211358","Walmer Road, Avondale",133
"7475",2020,10,443,175,179,"51.515256","-0.058641","Philpot Street, Whitechapel",354
"7476",2020,10,444,165,152,"51.52568","-0.055312","Bethnal Green Garden, Bethnal Green",317
"7477",2020,10,445,137,126,"51.52388","-0.065076","Cheshire Street, Bethnal Green",263
"7478",2020,10,446,228,227,"51.528936","-0.055894","York Hall, Bethnal Green",455
"7479",2020,10,447,67,41,"51.493381","-0.007542","Jubilee Crescent, Cubitt Town",108
"7480",2020,10,448,148,142,"51.50623","-0.02296","Fisherman's Walk West, Canary Wharf",290
"7481",2020,10,449,229,226,"51.511088","-0.057159","Shadwell Station, Shadwell",455
"7482",2020,10,450,161,113,"51.515975","-0.053177","Jubilee Street, Stepney",274
"7483",2020,10,451,150,139,"51.504719","-0.063531","Hermitage Court, Wapping",289
"7484",2020,10,452,150,141,"51.505697","-0.070542","St. Katharine's Way, Tower",291
"7485",2020,10,453,150,139,"51.508447","-0.055167","Garnet Street, Shadwell",289
"7486",2020,10,454,64,59,"51.487679","-0.021582","Napier Avenue, Millwall",123
"7487",2020,10,455,54,56,"51.49447","-0.014409","East Ferry Road, Cubitt Town",110
"7488",2020,10,456,133,159,"51.538071","-0.144664","Parkway, Camden Town",292
"7489",2020,10,457,238,199,"51.542138","-0.145393","Castlehaven Road, Camden Town",437
"7490",2020,10,458,179,174,"51.504749","-0.057544","Wapping Lane, Wapping",353
"7491",2020,10,459,186,158,"51.535179","-0.03338","Gunmakers Lane, Old Ford",344
"7492",2020,10,460,152,148,"51.516196","-0.029138","Burdett Road, Mile End",300
"7493",2020,10,461,122,106,"51.516","-0.038775","Aston Street, Stepney",228
"7494",2020,10,462,270,223,"51.541603","-0.138853","Bonny Street, Camden Town",493
"7495",2020,10,463,101,75,"51.534776","-0.071881","Thurtle Road, Haggerston",176
"7496",2020,10,464,59,48,"51.51417","-0.052099","St. Mary & St. Michael Church, Stepney",107
"7497",2020,10,465,294,224,"51.53558","-0.08249","Pitfield Street North,Hoxton",518
"7498",2020,10,466,147,105,"51.534464","-0.076341","Whiston Road, Haggerston",252
"7499",2020,10,467,99,68,"51.523538","-0.030556","Southern Grove, Bow",167
"7500",2020,10,468,63,50,"51.521564","-0.022694","Cantrell Road, Bow",113
"7501",2020,10,469,118,100,"51.513757","-0.020467","Lindfield Street, Poplar",218
"7502",2020,10,470,163,126,"51.530535","-0.025492","Mostyn Grove, Bow",289
"7503",2020,10,471,165,154,"51.533283","-0.028155","Hewison Street, Old Ford",319
"7504",2020,10,472,30,28,"51.529452","-0.027616","Malmesbury Road, Bow",58
"7505",2020,10,473,41,27,"51.496137","-0.019355","Millharbour, Millwall",68
"7506",2020,10,475,59,56,"51.499041","-0.020157","Lightermans Road, Millwall",115
"7507",2020,10,476,25,21,"51.489096","-0.009205","Stebondale Street, Cubitt Town",46
"7508",2020,10,477,85,80,"51.49109","-0.018716","Spindrift Avenue, Millwall",165
"7509",2020,10,478,277,273,"51.521889","-0.04667","Stepney Green Station, Stepney",550
"7510",2020,10,479,229,218,"51.527152","-0.058005","Pott Street, Bethnal Green",447
"7511",2020,10,480,338,317,"51.5128711","-0.0389866","Flamborough Street, Limehouse",655
"7512",2020,10,481,130,154,"51.487129","-0.009001","Saunders Ness Road, Cubitt Town",284
"7513",2020,10,483,156,139,"51.51328","-0.047784","Albert Gardens, Stepney",295
"7514",2020,10,484,90,100,"51.528828","-0.013258","Bromley High Street, Bow",190
"7515",2020,10,485,140,117,"51.531127","-0.048017","Old Ford Road, Bethnal Green",257
"7516",2020,10,486,293,244,"51.525645","-0.069543","Granby Street, Shoreditch",537
"7517",2020,10,487,13,17,"51.511811","-0.025626","Canton Street, Poplar",30
"7518",2020,10,488,195,170,"51.506946","-0.058681","Reardon Street, Wapping",365
"7519",2020,10,489,228,191,"51.513074","-0.064094","Christian Street, Whitechapel",419
"7520",2020,10,490,89,82,"51.508622","-0.065006","Pennington Street, Wapping",171
"7521",2020,10,491,254,245,"51.522507","-0.041378","Queen Mary's, Mile End",499
"7522",2020,10,492,235,225,"51.525501","-0.032267204","Maplin Street, Mile End",460
"7523",2020,10,494,9,20,"51.50196","-0.016251","South Quay East, Canary Wharf",29
"7524",2020,10,495,152,131,"51.528169","-0.018703","Bow Church Station, Bow",283
"7525",2020,10,496,87,81,"51.52512","-0.015578","Devons Road, Bow",168
"7526",2020,10,497,87,67,"51.526149","-0.027396845","Merchant Street, Bow",154
"7527",2020,10,498,139,132,"51.527058","-0.025296","Bow Road Station, Bow",271
"7528",2020,10,499,208,194,"51.519265","-0.021345","Furze Green, Bow",402
"7529",2020,10,500,278,205,"51.519806","-0.055731","Ansell House, Stepney",483
"7530",2020,10,501,121,106,"51.522561","-0.054883","Cephas Street, Bethnal Green",227
"7531",2020,10,502,209,179,"51.53341","-0.049591815","Bonner Gate, Victoria Park",388
"7532",2020,10,503,312,319,"51.520893","-0.051394","Cleveland Way, Stepney",631
"7533",2020,10,504,18,13,"51.496454","-0.009506","St. John's Park, Cubitt Town",31
"7534",2020,10,505,145,126,"51.520398","-0.026768","Ackroyd Drive, Bow",271
"7535",2020,10,506,192,219,"51.517475","-0.075855","Bell Lane, Liverpool Street",411
"7536",2020,10,507,105,87,"51.528692","-0.059091","Clarkson Street, Bethnal Green",192
"7537",2020,10,508,295,301,"51.519362","-0.074431","Fournier Street, Whitechapel",596
"7538",2020,10,509,196,200,"51.517842","-0.090075","Fore Street, Guildhall",396
"7539",2020,10,510,238,290,"51.509303","-0.025996","Westferry DLR, Limehouse",528
"7540",2020,10,511,261,222,"51.511066","-0.053558","Sutton Street, Shadwell",483
"7541",2020,10,512,348,306,"51.532091","-0.06142","Pritchard's Road, Bethnal Green",654
"7542",2020,10,513,143,119,"51.5142228","-0.055656","Watney Market, Stepney",262
"7543",2020,10,514,167,187,"51.516204","-0.155525","Portman Square, Marylebone",354
"7544",2020,10,515,80,62,"51.500088","-0.211316","Russell Gardens, Olympia",142
"7545",2020,10,516,80,79,"51.5112","-0.014438","Chrisp Street Market, Poplar",159
"7546",2020,10,518,133,115,"51.528224","-0.037471","Antill Road, Mile End",248
"7547",2020,10,519,16,10,"51.518811","-0.011662","Teviot Street, Poplar",26
"7548",2020,10,520,188,158,"51.526041","-0.047218","Bancroft Road, Bethnal Green",346
"7549",2020,10,521,166,146,"51.534137","-0.037366","Driffield Road, Old Ford",312
"7550",2020,10,522,206,175,"51.525941","-0.036017","Clinton Road, Mile End",381
"7551",2020,10,523,19,29,"51.51549","-0.013475","Langdon Park, Poplar",48
"7552",2020,10,524,199,124,"51.511654","-0.179668","Lancaster Gate , Bayswater",323
"7553",2020,10,526,49,47,"51.503143","-0.008428","Lancaster Drive, Blackwall",96
"7554",2020,10,527,88,95,"51.503802","-0.215808","Hansard Mews, Holland Park",183
"7555",2020,10,528,96,112,"51.507326","-0.145827","Clarges Street, Mayfair",208
"7556",2020,10,529,159,156,"51.486892","-0.170983","Manresa Road, Chelsea",315
"7557",2020,10,530,63,59,"51.508896","-0.012413","Newby Place, Poplar",122
"7558",2020,10,531,213,171,"51.530326","-0.042744","Twig Folly Bridge, Mile End",384
"7559",2020,10,532,102,164,"51.50357","-0.020068","Jubilee Plaza, Canary Wharf",266
"7560",2020,10,533,176,154,"51.528222","-0.069743","Wellington Row, Bethnal Green",330
"7561",2020,10,534,225,192,"51.531864","-0.066035","Goldsmith's Row, Haggerston",417
"7562",2020,10,535,176,168,"51.537349","-0.147154","Gloucester Avenue, Camden Town",344
"7563",2020,10,536,95,76,"51.53385","-0.06992","Queensbridge Road, Haggerston",171
"7564",2020,10,537,246,250,"51.51793","-0.067937","Old Montague Street, Whitechapel",496
"7565",2020,10,538,72,68,"51.508981","-0.00699","Naval Row, Blackwall",140
"7566",2020,10,540,163,113,"51.528302","-0.144466","Albany Street, The Regent's Park",276
"7567",2020,10,541,391,387,"51.506613","-0.142844","Green Park Station, Mayfair",778
"7568",2020,10,542,173,141,"51.514115","-0.033828","Salmon Lane, Limehouse",314
"7569",2020,10,543,60,41,"51.509591","-0.204666","Lansdowne Walk, Ladbroke Grove",101
"7570",2020,10,544,173,155,"51.526153","-0.102208","Percival Street, Finsbury",328
"7571",2020,10,545,130,127,"51.539957","-0.145246","Arlington Road, Camden Town",257
"7572",2020,10,546,311,315,"51.517428","-0.107987","New Fetter Lane, Holborn",626
"7573",2020,10,547,65,82,"51.509474","-0.002275","East India DLR, Blackwall",147
"7574",2020,10,548,74,67,"51.498386","-0.107913","Westminster Bridge Road, Elephant & Castle",141
"7575",2020,10,549,141,129,"51.49605","-0.104193","Gaywood  Street, Elephant & Castle",270
"7576",2020,10,550,124,111,"51.521564","-0.039264","Harford Street, Mile End",235
"7577",2020,10,551,92,104,"51.505772","-0.016460175","Import Dock, Canary Wharf",196
"7578",2020,10,552,236,227,"51.511542","-0.056667","Watney Street, Shadwell",463
"7579",2020,10,553,543,517,"51.535678","-0.062546","Regent's Row , Haggerston",1060
"7580",2020,10,554,27,21,"51.513548","-0.005659","Aberfeldy Street, Poplar",48
"7581",2020,10,556,64,78,"51.502661","-0.021596","Heron Quays DLR, Canary Wharf",142
"7582",2020,10,557,138,159,"51.51601","-0.0985","King Edward Street, St Pauls",297
"7583",2020,10,558,283,306,"51.493978","-0.127554","Page Street, Westminster",589
"7584",2020,10,559,54,40,"51.501391","-0.205991","Abbotsbury Road, Holland Park",94
"7585",2020,10,560,71,30,"51.511624","-0.205921","Ladbroke Grove Central, Ladbroke Grove",101
"7586",2020,10,561,121,88,"51.518369","-0.043371","Rectory Square, Stepney",209
"7587",2020,10,562,194,210,"51.51746","-0.12335","Bury Place, Holborn",404
"7588",2020,10,563,41,37,"51.499286","-0.009152","Preston's Road, Cubitt Town",78
"7589",2020,10,564,341,461,"51.509943","-0.117619","Somerset House, Strand",802
"7590",2020,10,565,77,82,"51.521905","-0.063386","Selby Street, Whitechapel",159
"7591",2020,10,566,128,142,"51.509158","-0.224103","Westfield Ariel Way, White City",270
"7592",2020,10,568,252,233,"51.51616","-0.18697","Bishop's Bridge Road West, Bayswater",485
"7593",2020,10,569,190,141,"51.53213","-0.08299","Pitfield Street Central, Hoxton",331
"7594",2020,10,570,197,211,"51.503083","-0.017676","Upper Bank Street, Canary Wharf",408
"7595",2020,10,571,84,98,"51.506256","-0.218337","Westfield Southern Terrace ,Shepherd's Bush",182
"7596",2020,10,572,250,248,"51.539099","-0.141728","Greenland Road, Camden Town",498
"7597",2020,10,573,399,394,"51.485587","-0.18119","Limerston Street, West Chelsea",793
"7598",2020,10,574,480,391,"51.53356","-0.09315","Eagle Wharf Road, Hoxton",871
"7599",2020,10,576,35,30,"51.497304","-0.022793","Alpha Grove, Millwall",65
"7600",2020,10,577,217,182,"51.528869","-0.047548","Globe Town Market, Bethnal Green",399
"7601",2020,10,578,107,107,"51.527607","-0.057133","Hollybush Gardens, Bethnal Green",214
"7602",2020,10,579,376,592,"51.511246","-0.093051","Queen Street 2, Bank",968
"7603",2020,10,580,184,143,"51.48692917","-0.102996299","Doddington Grove, Kennington",327
"7604",2020,10,581,243,252,"51.519167","-0.147983","New Cavendish Street, Marylebone",495
"7605",2020,10,583,266,375,"51.497622","-0.125978","Abingdon Green, Westminster",641
"7606",2020,10,584,194,168,"51.51244","-0.19096","Ilchester Gardens, Bayswater",362
"7607",2020,10,586,29,29,"51.490645","-0.014582","Mudchute DLR, Cubitt Town",58
"7608",2020,10,587,335,386,"51.50964","-0.08497","Monument Street, Monument",721
"7609",2020,10,588,105,88,"51.52959","-0.0801","Hoxton Street, Hoxton",193
"7610",2020,10,589,267,278,"51.487196","-0.179369","Drayton Gardens, West Chelsea",545
"7611",2020,10,590,69,36,"51.53256","-0.16862","Greenberry Street, St.John's Wood",105
"7612",2020,10,592,138,90,"51.5171","-0.18377","Bishop's Bridge Road East, Bayswater",228
"7613",2020,10,593,167,122,"51.531066","-0.11934","Northdown Street, King's Cross",289
"7614",2020,10,594,184,249,"51.513875","-0.117774","Kingsway Southbound, Strand",433
"7615",2020,10,595,215,230,"51.493267","-0.21985","Hammersmith Road, Hammersmith",445
"7616",2020,10,596,237,242,"51.472817","-0.199783","Parson's Green , Parson's Green",479
"7617",2020,10,597,128,126,"51.473471","-0.20782","Fulham Park Road, Fulham",254
"7618",2020,10,598,150,150,"51.494499","-0.228188","Southerton Road, Hammersmith",300
"7619",2020,10,599,91,85,"51.485743","-0.223616","Manbre Road, Hammersmith",176
"7620",2020,10,600,246,250,"51.481747","-0.124642","South Lambeth Road, Vauxhall",496
"7621",2020,10,601,144,155,"51.514767","-0.225787","BBC White City, White City",299
"7622",2020,10,602,193,165,"51.472993","-0.133972","Union Grove, Wandsworth Road",358
"7623",2020,10,603,152,158,"51.477839","-0.116493","Caldwell Street, Stockwell",310
"7624",2020,10,604,85,81,"51.538792","-0.138535","St Martins Close, Camden Town",166
"7625",2020,10,605,198,182,"51.520331","-0.163667","Seymour Place, Marylebone",380
"7626",2020,10,606,89,90,"51.504199","-0.210941","Addison Road, Holland Park",179
"7627",2020,10,607,129,123,"51.468814","-0.210279","Putney Bridge Station, Fulham",252
"7628",2020,10,608,16,21,"51.491093","-0.216493","Colet Gardens, Hammersmith",37
"7629",2020,10,609,82,74,"51.46512358","-0.157788279","Sugden Road, Clapham",156
"7630",2020,10,610,166,154,"51.48256792","-0.172078187","Danvers Street, West Chelsea",320
"7631",2020,10,611,99,86,"51.50646524","-0.208486599","Princedale Road , Holland Park",185
"7632",2020,10,612,156,153,"51.46925984","-0.141812513","Wandsworth Rd, Isley Court, Wandsworth Road",309
"7633",2020,10,613,281,279,"51.50403821","-0.217400093","Woodstock Grove, Shepherd's Bush",560
"7634",2020,10,614,91,74,"51.47817208","-0.144690541","Bradmead, Battersea Park",165
"7635",2020,10,615,155,106,"51.4768851","-0.215895601","Finlay Street, Fulham",261
"7636",2020,10,616,206,188,"51.48102131","-0.209973497","Aintree Street, Fulham",394
"7637",2020,10,617,99,88,"51.47107905","-0.207842908","Elysium Place, Fulham",187
"7638",2020,10,618,146,111,"51.47625965","-0.193254007","Eel Brook Common, Walham Green",257
"7639",2020,10,619,143,103,"51.4737636","-0.197010096","Irene Road, Parsons Green",246
"7640",2020,10,620,169,120,"51.47518024","-0.167160736","Surrey Lane, Battersea",289
"7641",2020,10,621,211,198,"51.46086446","-0.187427294","Wandsworth Town Station, Wandsworth",409
"7642",2020,10,622,210,196,"51.50748124","-0.205535908","Lansdowne Road, Ladbroke Grove",406
"7643",2020,10,623,58,44,"51.46193072","-0.180791784","Nantes Close, Wandsworth",102
"7644",2020,10,624,121,104,"51.4729184","-0.132102704","Courland Grove, Wandsworth Road",225
"7645",2020,10,625,260,220,"51.47761941","-0.149551631","Queen's Circus, Battersea Park",480
"7646",2020,10,626,242,238,"51.48438657","-0.20481514","Normand Park, West Kensington",480
"7647",2020,10,627,72,54,"51.4687905","-0.158230901","Holden Street, Battersea",126
"7648",2020,10,628,188,194,"51.46881971","-0.184318843","William Morris Way, Sands End",382
"7649",2020,10,629,49,51,"51.45995384","-0.190184054","Morie Street, Wandsworth",100
"7650",2020,10,630,88,85,"51.47073264","-0.126994068","Clarence Walk, Stockwell",173
"7651",2020,10,631,175,137,"51.4795017","-0.141770709","Battersea Park Road, Nine Elms",312
"7652",2020,10,632,117,99,"51.47053858","-0.163041605","Sheepcote Lane, Battersea",216
"7653",2020,10,633,177,176,"51.48959104","-0.209378594","Vereker Road, West Kensington",353
"7654",2020,10,634,81,114,"51.49434708","-0.215804559","Brook Green South, Brook Green",195
"7655",2020,10,635,155,147,"51.48606206","-0.214428378","Greyhound Road, Hammersmith",302
"7656",2020,10,636,190,162,"51.46706414","-0.193502076","South Park, Sands End",352
"7657",2020,10,637,45,34,"51.45787019","-0.174691623","Spencer Park, Wandsworth Common",79
"7658",2020,10,638,390,400,"51.46663393","-0.169821175","Falcon Road, Clapham Junction",790
"7659",2020,10,639,192,189,"51.48357068","-0.202038682","Coomer Place, West Kensington",381
"7660",2020,10,640,142,151,"51.47286577","-0.148059277","Silverthorne Road, Battersea",293
"7661",2020,10,641,101,111,"51.49824168","-0.117495865","Archbishop's Park, Waterloo",212
"7662",2020,10,642,72,52,"51.46916161","-0.174485792","Fawcett Close, Battersea",124
"7663",2020,10,643,122,86,"51.5190427","-0.204764421","All Saints' Road, Portobello",208
"7664",2020,10,644,163,158,"51.48373225","-0.223852256","Rainville Road, Hammersmith",321
"7665",2020,10,645,234,220,"51.50173215","-0.100292412","Great Suffolk Street, The Borough",454
"7666",2020,10,646,208,251,"51.49886563","-0.137424571","Buckingham Gate, Westminster",459
"7667",2020,10,647,109,105,"51.50035306","-0.217515071","Richmond Way, Shepherd's Bush",214
"7668",2020,10,648,63,62,"51.46904022","-0.19627483","Peterborough Road, Sands End",125
"7669",2020,10,649,157,166,"51.48180515","-0.18027465","World's End Place, West Chelsea",323
"7670",2020,10,650,110,117,"51.51687069","-0.213872396","St. Mark's Road, North Kensington",227
"7671",2020,10,651,135,121,"51.48089844","-0.183853573","Thorndike Close, West Chelsea",256
"7672",2020,10,652,48,54,"51.51148696","-0.218190203","Evesham Street, Avondale",102
"7673",2020,10,653,218,202,"51.47084722","-0.17070367","Simpson Street, Clapham Junction",420
"7674",2020,10,654,196,164,"51.48267821","-0.117661574","Ashmole Estate, Oval",360
"7675",2020,10,655,119,109,"51.48294452","-0.219346128","Crabtree Lane, Fulham",228
"7676",2020,10,656,69,72,"51.46841875","-0.199135704","Broomhouse Lane, Parsons Green",141
"7677",2020,10,657,88,75,"51.4996806","-0.221791552","Blythe Road West, Shepherd's Bush",163
"7678",2020,10,658,305,290,"51.47729232","-0.16478637","Ethelburga Estate, Battersea Park",595
"7679",2020,10,659,282,285,"51.511934","-0.10307894","Blackfriars Station, St. Paul's",567
"7680",2020,10,660,97,95,"51.49087074","-0.206029743","West Kensington Station, West Kensington",192
"7681",2020,10,661,269,258,"51.51632095","-0.202608612","All Saints Church, Portobello",527
"7682",2020,10,662,167,165,"51.48498496","-0.167919869","Phene Street, Chelsea",332
"7683",2020,10,663,102,85,"51.51323001","-0.211593602","Clarendon Road, Avondale",187
"7684",2020,10,664,185,156,"51.474376","-0.155442787","Austin Road, Battersea Park",341
"7685",2020,10,665,107,95,"51.46108367","-0.191722864","Smugglers Way, Wandsworth",202
"7686",2020,10,666,140,105,"51.49610093","-0.208158259","Olympia Way, Olympia",245
"7687",2020,10,667,130,121,"51.5015946","-0.222293381","Shepherd's Bush Road North, Shepherd's Bush",251
"7688",2020,10,668,220,234,"51.49422354","-0.236769936","Ravenscourt Park Station, Hammersmith",454
"7689",2020,10,669,79,58,"51.47614939","-0.1232585","Teversham Lane, Stockwell",137
"7690",2020,10,670,156,124,"51.46718562","-0.152248582","Ashley Crescent, Battersea",280
"7691",2020,10,671,276,305,"51.475089","-0.201968","Parsons Green Station, Parsons Green",581
"7692",2020,10,673,146,144,"51.46517078","-0.18038939","Hibbert Street, Battersea",290
"7693",2020,10,674,162,96,"51.53546778","-0.11619105","Carnegie Street, King's Cross",258
"7694",2020,10,675,108,90,"51.46348914","-0.182126248","Usk Road, Clapham Junction",198
"7695",2020,10,676,196,186,"51.47787084","-0.126874471","Hartington Road, Stockwell",382
"7696",2020,10,677,74,62,"51.46866929","-0.146544642","Heath Road, Battersea",136
"7697",2020,10,678,40,45,"51.46231278","-0.211468596","Esmond Street, Putney",85
"7698",2020,10,679,163,143,"51.47453545","-0.170210533","Orbel Street, Battersea",306
"7699",2020,10,680,313,314,"51.47768469","-0.170329317","Westbridge Road, Battersea",627
"7700",2020,10,681,167,159,"51.47303687","-0.214749808","Bishop's Avenue, Fulham",326
"7701",2020,10,682,223,228,"51.48810829","-0.22660621","Crisp Road, Hammersmith",451
"7702",2020,10,683,99,82,"51.46506424","-0.163750945","Dorothy Road, Clapham Junction",181
"7703",2020,10,684,87,98,"51.45475251","-0.195197203","Neville Gill Close, Wandsworth",185
"7704",2020,10,685,153,137,"51.46067005","-0.198735357","Osiers Road, Wandsworth",290
"7705",2020,10,686,139,135,"51.48814438","-0.222456468","Beryl Road, Hammersmith",274
"7706",2020,10,687,183,167,"51.49760804","-0.21145598","Maclise Road, Olympia",350
"7707",2020,10,688,73,60,"51.46095151","-0.20066766","Northfields, Wandsworth",133
"7708",2020,10,689,46,30,"51.45922541","-0.180884959","Spanish Road, Clapham Junction",76
"7709",2020,10,690,101,75,"51.47047503","-0.152130083","Stanley Grove, Battersea",176
"7710",2020,10,691,259,253,"51.47946386","-0.195777222","Erin Close, Walham Green",512
"7711",2020,10,692,206,190,"51.54211855","-0.028941601","Cadogan Close, Victoria Park",396
"7712",2020,10,693,76,83,"51.464786","-0.215618902","Felsham Road, Putney",159
"7713",2020,10,694,58,50,"51.46071722","-0.216526155","Putney Rail Station, Putney",108
"7714",2020,10,695,406,396,"51.53638435","-0.102757578","Islington Green, Angel",802
"7715",2020,10,696,216,204,"51.48728535","-0.217995921","Charing Cross Hospital, Hammersmith",420
"7716",2020,10,697,124,92,"51.53639219","-0.112721065","Charlotte Terrace, Angel",216
"7717",2020,10,698,165,105,"51.53908372","-0.070329419","Shoreditch Court, Haggerston",270
"7718",2020,10,699,117,59,"51.5366541","-0.07023031","Belford House, Haggerston",176
"7719",2020,10,700,150,103,"51.47696496","-0.174347066","Battersea Church Road, Battersea",253
"7720",2020,10,701,197,201,"51.47287627","-0.176267008","Vicarage Crescent, Battersea",398
"7721",2020,10,702,209,149,"51.52868155","-0.065550321","Durant Street, Bethnal Green",358
"7722",2020,10,703,284,422,"51.51505991","-0.10534448","St. Bride Street, Holborn",706
"7723",2020,10,704,41,33,"51.45682071","-0.202802098","Mexfield Road, East Putney",74
"7724",2020,10,705,58,46,NA,NA,NA,104
"7725",2020,10,706,214,220,"51.50215353","-0.083632928","Snowsfields, London Bridge",434
"7726",2020,10,707,282,270,"51.49021762","-0.215087092","Barons Court Station, West Kensington",552
"7727",2020,10,708,86,84,"51.46161068","-0.21614583","Disraeli Road, Putney",170
"7728",2020,10,709,53,47,"51.46321128","-0.215550761","Montserrat Road , Putney",100
"7729",2020,10,710,190,169,"51.47439218","-0.163347594","Albert Bridge Road, Battersea Park",359
"7730",2020,10,711,117,108,"51.48335692","-0.216305546","Everington Street, Fulham",225
"7731",2020,10,712,178,151,"51.51854104","-0.034903714","Mile End Stadium, Mile End",329
"7732",2020,10,713,62,72,"51.54100708","-0.14326094","Hawley Crescent, Camden Town",134
"7733",2020,10,714,83,64,"51.47311696","-0.137235175","Stewart's Road, Wandsworth Road",147
"7734",2020,10,715,92,75,"51.51563007","-0.049067243","Aylward Street, Stepney",167
"7735",2020,10,716,87,71,"51.51542791","-0.02356501","Stainsby Road , Poplar",158
"7736",2020,10,717,409,349,"51.53658514","-0.075885686","Dunston Road , Haggerston",758
"7737",2020,10,718,235,216,"51.53571683","-0.060291813","Ada Street, Hackney Central",451
"7738",2020,10,719,268,231,"51.53642464","-0.054162264","Victoria Park Road, Hackney Central",499
"7739",2020,10,720,135,121,"51.48724429","-0.205279052","Star Road, West Kensington",256
"7740",2020,10,721,102,98,"51.53603947","-0.026262677","Wendon Street, Old Ford",200
"7741",2020,10,722,167,144,"51.52458353","-0.058631453","Finnis Street, Bethnal Green",311
"7742",2020,10,723,256,224,"51.46822047","-0.190346493","Stephendale Road, Sands End",480
"7743",2020,10,724,65,44,"51.45799126","-0.184806157","Alma Road, Wandsworth",109
"7744",2020,10,725,185,193,"51.491327","-0.096518684","Walworth Square, Walworth",378
"7745",2020,10,726,176,188,"51.47505096","-0.150908371","Alfreda Street, Battersea Park",364
"7746",2020,10,727,164,157,"51.47569809","-0.20587627","Chesilton Road, Fulham",321
"7747",2020,10,728,68,70,"51.46199911","-0.206240805","Putney Bridge Road, East Putney",138
"7748",2020,10,729,259,206,"51.47893931","-0.208485293","St. Peter's Terrace, Fulham",465
"7749",2020,10,730,182,178,"51.49208492","-0.229116862","Bridge Avenue, Hammersmith",360
"7750",2020,10,731,153,151,"51.47727637","-0.189210466","Michael Road, Walham Green",304
"7751",2020,10,732,669,711,"51.50630441","-0.087262995","Duke Street Hill, London Bridge",1380
"7752",2020,10,733,99,108,"51.50542628","-0.150817316","Park Lane, Mayfair",207
"7753",2020,10,734,83,55,"51.46230566","-0.175407201","Plough Terrace, Clapham Junction",138
"7754",2020,10,735,190,190,"51.46489445","-0.17302926","Grant Road East, Clapham Junction",380
"7755",2020,10,736,55,52,"51.50659035","-0.216104479","Queensdale Road, Shepherd's Bush",107
"7756",2020,10,737,499,497,"51.47993289","-0.19411695","Fulham Broadway, Walham Green",996
"7757",2020,10,738,140,140,"51.47514228","-0.187278987","Imperial Road, Sands End",280
"7758",2020,10,739,148,133,"51.48176572","-0.185273723","Hortensia Road, West Brompton",281
"7759",2020,10,740,31,31,"51.51092871","-0.214594781","Sirdar Road, Avondale",62
"7760",2020,10,741,56,55,"51.5129814","-0.219486603","Freston Road, Avondale",111
"7761",2020,10,742,143,129,"51.51510818","-0.208565479","Blenheim Crescent, Ladbroke Grove",272
"7762",2020,10,743,34,38,"51.46079243","-0.212607684","Oxford Road, Putney",72
"7763",2020,10,744,70,34,"51.46745485","-0.172293499","Ingrave Street, Clapham Junction",104
"7764",2020,10,745,95,96,"51.47816972","-0.18243547","Upcerne Road, West Chelsea",191
"7765",2020,10,746,140,132,"51.4795738","-0.17903854","Lots Road, West Chelsea",272
"7766",2020,10,747,133,144,"51.48796408","-0.161765173","Ormonde Gate, Chelsea",277
"7767",2020,10,748,232,198,"51.53727795","-0.079201849","Hertford Road, De Beauvoir Town",430
"7768",2020,10,749,250,233,"51.53932857","-0.074284675","Haggerston Road, Haggerston",483
"7769",2020,10,750,53,44,"51.4710956","-0.157850096","Culvert Road, Battersea",97
"7770",2020,10,751,139,163,"51.51612862","-0.120909408","Newton Street, Covent Garden",302
"7771",2020,10,754,72,78,"51.5129006","-0.214762686","Grenfell Road, Avondale",150
"7772",2020,10,755,206,215,"51.48512191","-0.174971902","The Vale, Chelsea",421
"7773",2020,10,756,166,146,"51.47515398","-0.159169801","Prince of Wales Drive, Battersea Park",312
"7774",2020,10,757,231,199,"51.48795853","-0.187404506","Harcourt Terrace, West Brompton",430
"7775",2020,10,758,153,134,"51.51787005","-0.201005397","Westbourne Park Road, Portobello",287
"7776",2020,10,759,80,67,"51.52456169","-0.165668686","Broadley Terrace, Marylebone",147
"7777",2020,10,760,102,99,"51.52526975","-0.163795009","Rossmore Road, Marylebone",201
"7778",2020,10,761,193,139,"51.48321729","-0.211860644","Humbolt Road, Fulham",332
"7779",2020,10,762,539,614,"51.50070305","-0.129698963","Storey's Gate, Westminster",1153
"7780",2020,10,763,153,121,"51.52059714","-0.032566533","Mile End Park Leisure Centre, Mile End",274
"7781",2020,10,764,152,177,"51.46239255","-0.16829214","St. John's Road, Clapham Junction",329
"7782",2020,10,765,78,67,"51.46760141","-0.20682737","Ranelagh Gardens, Fulham",145
"7783",2020,10,766,171,174,"51.45752945","-0.192165613","Ram Street, Wandsworth",345
"7784",2020,10,767,19,22,"51.45705988","-0.200806304","Santos Road, Wandsworth",41
"7785",2020,10,768,166,133,"51.46134382","-0.159322467","Clapham Common North Side, Clapham Common",299
"7786",2020,10,769,176,162,"51.473611","-0.191803","Sandilands Road, Walham Green",338
"7787",2020,10,770,102,92,"51.491026","-0.209121","Gwendwr Road, West Kensington",194
"7788",2020,10,771,55,49,"51.509224","-0.216016","Rifle Place, Avondale",104
"7789",2020,10,772,324,311,"51.47250956","-0.122831913","Binfield Road, Stockwell",635
"7790",2020,10,773,315,370,"51.511891","-0.107349","Tallis Street, Temple",685
"7791",2020,10,774,45,46,"51.470131","-0.20464","Hurlingham Park, Parsons Green",91
"7792",2020,10,775,101,117,"51.496664","-0.223868","Little Brook Green, Brook Green",218
"7793",2020,10,776,87,87,"51.460333","-0.167029","Abyssinia Close, Clapham Junction",174
"7794",2020,10,777,41,32,"51.4619230679","-0.165297856693","Limburg Road, Clapham Junction",73
"7795",2020,10,779,225,250,"51.514449","-0.077178979","Houndsditch, Aldgate",475
"7796",2020,10,780,274,275,"51.474665","-0.18316517","Imperial Wharf Station, Sands End",549
"7797",2020,10,781,196,186,"51.495898","-0.173009","Victoria & Albert Museum, South Kensington",382
"7798",2020,10,782,171,146,"51.483911","-0.19760944","Halford Road, West Kensington",317
"7799",2020,10,783,257,238,"51.5403115","-0.021630359","Monier Road, Hackney Wick",495
"7800",2020,10,784,142,130,"51.546326","-0.00993526","East Village, Queen Elizabeth Olympic Park",272
"7801",2020,10,785,442,436,"51.54094","-0.010510565","Aquatic Centre, Queen Elizabeth Olympic Park",878
"7802",2020,10,786,148,151,"51.549369","-0.015717614","Lee Valley VeloPark, Queen Elizabeth Olympic Park",299
"7803",2020,10,787,135,119,"51.546805","-0.01469126","Timber Lodge, Queen Elizabeth Olympic Park",254
"7804",2020,10,789,130,155,"51.538718","-0.011889482","Podium, Queen Elizabeth Olympic Park",285
"7805",2020,10,790,166,174,"51.541793","-0.00481","Stratford Station, Stratford",340
"7806",2020,10,792,224,250,"51.505461","-0.10454093","Blackfriars Road, Southwark",474
"7807",2020,10,793,98,89,"51.528279","-0.11955857","Cromer Street, Bloomsbury",187
"7808",2020,10,795,141,141,"51.527068","-0.13186102","Euston Square Gardens, Euston",282
"7809",2020,10,796,150,147,"51.524","-0.12640984","Coram Street, Bloomsbury",297
"7810",2020,10,797,265,260,"51.5293","-0.12827903","Ossulston Street, Somers Town",525
"7811",2020,10,798,259,293,"51.5301998755","-0.122299440803","Birkenhead Street, King's Cross",552
"7812",2020,10,799,172,184,"51.4976984561","-0.137598896295","Kings Gate House, Westminster",356
"7813",2020,10,800,188,193,"51.4811219398","-0.149035374873","Sopwith Way, Battersea Park",381
"7814",2020,10,801,206,242,"51.5052241745","-0.0980318118664","Lavington Street, Bankside",448
"7815",2020,10,802,143,103,"51.4765900593","-0.118256789081","Albert Square, Stockwell",246
"7816",2020,10,803,199,205,"51.5054099403","-0.0983410884509","Southwark Street, Bankside",404
"7817",2020,10,804,302,314,"51.5346677396","-0.125078652873","Good's Way, King's Cross",616
"7818",2020,10,806,192,186,"51.5372405623","-0.124807385707","Handyside Street, King's Cross",378
"7819",2020,10,807,198,189,"51.5212","-0.20888818","Bevington Road West, North Kensington",387
"7820",2020,10,809,155,213,"51.5162778834","-0.118272991635","Lincoln's Inn Fields, Holborn",368
"7821",2020,10,810,305,342,"51.5067252868","-0.0988072461627","Tate Modern, Bankside",647
"7822",2020,10,811,217,254,"51.5057030357","-0.0277727426235","Westferry Circus, Canary Wharf",471
"7823",2020,10,812,50,60,"51.5487311915","-0.0226065549321","Here East North, Queen Elizabeth Olympic Park",110
"7824",2020,10,813,177,186,"51.4878074485","-0.122759625866","New Spring Gardens Walk, Vauxhall",363
"7825",2020,10,814,77,70,"51.4714330677","-0.123670735702","Clapham Road, Lingham Street, Stockwell",147
"7826",2020,10,815,314,346,"51.5000891978","-0.116628700672","Lambeth Palace Road, Waterloo",660
"7827",2020,10,816,72,59,"51.5465327935","-0.0205975904647","Here East South, Queen Elizabeth Olympic Park",131
"7828",2020,10,817,216,195,"51.4813354746","-0.138212295869","Riverlight South, Nine Elms",411
"7829",2020,10,818,388,417,"51.501513","-0.12382322","Westminster Pier, Westminster",805
"7830",2020,10,819,185,151,"51.50621","-0.114842","Belvedere Road 2, South Bank",336
"7831",2020,10,820,152,104,"51.492807","-0.091938","Victory Place, Walworth",256
"7832",2020,10,821,398,374,"51.4835074867","-0.147714557371","Battersea Power Station, Battersea Park",772
"7833",2020,10,826,425,427,"51.496863","-0.1429434","Allington Street, Victoria",852
"7834",2020,10,827,204,201,"51.479601","-0.11147178","Cranmer Road, Stockwell",405
"7835",2020,10,828,107,95,"51.473874","-0.11258096","Normandy Road, Stockwell",202
"7836",2020,10,829,81,60,"51.469217","-0.11268674","Wynne Road, Stockwell",141
"7837",2020,10,830,75,69,"51.469202","-0.11902256","Sidney Road, Stockwell",144
"7838",2020,10,831,90,88,"51.466232","-0.11317995","St John's Crescent, Brixton",178
"7839",2020,10,832,139,153,"51.464019","-0.11578197","Ferndale Road, Brixton",292
"7840",2020,10,833,115,124,"51.460232","-0.11537509","Saltoun Road, Brixton",239
"7841",2020,10,834,196,195,"51.477966","-0.14785703","Gas Holders, Battersea Park",391
"7842",2020,10,835,161,164,"51.516785","-0.10494775","Farringdon Street, Holborn",325
"7843",2020,10,836,181,148,"51.541596","-0.12544145","York Way, Kings Cross",329
"7844",2020,10,838,156,163,"51.518093","-0.0914017","Fore Street Avenue, Guildhall",319
"7845",2020,10,839,323,342,"51.508033","-0.10682363","Sea Containers, South Bank",665
"7846",2020,11,1,171,91,"51.52916347","-0.109970527","River Street , Clerkenwell",262
"7847",2020,11,2,232,254,"51.49960695","-0.197574246","Phillimore Gardens, Kensington",486
"7848",2020,11,3,220,237,"51.52128377","-0.084605692","Christopher Street, Liverpool Street",457
"7849",2020,11,4,110,172,"51.53005939","-0.120973687","St. Chad's Street, King's Cross",282
"7850",2020,11,5,262,314,"51.49313","-0.156876","Sedding Street, Sloane Square",576
"7851",2020,11,6,250,245,"51.51811784","-0.144228881","Broadcasting House, Marylebone",495
"7852",2020,11,7,143,131,"51.53430039","-0.1680743","Charlbert Street, St. John's Wood",274
"7853",2020,11,8,176,182,"51.529857","-0.18348604","Maida Vale, Maida Vale",358
"7854",2020,11,9,196,212,"51.5073853","-0.096440751","New Globe Walk, Bankside",408
"7855",2020,11,10,119,134,"51.50597426","-0.092754157","Park Street, Bankside",253
"7856",2020,11,11,217,227,"51.52395143","-0.122502346","Brunswick Square, Bloomsbury",444
"7857",2020,11,12,436,471,"51.52168078","-0.130431727","Malet Street, Bloomsbury",907
"7858",2020,11,13,150,146,"51.51991453","-0.136039674","Scala Street, Fitzrovia",296
"7859",2020,11,14,1540,1454,"51.52994371","-0.123616824","Belgrove Street , King's Cross",2994
"7860",2020,11,15,224,234,"51.51772703","-0.127854211","Great Russell Street, Bloomsbury",458
"7861",2020,11,16,289,279,"51.52635795","-0.125979294","Cartwright Gardens , Bloomsbury",568
"7862",2020,11,17,397,442,"51.5216612","-0.109006325","Hatton Wall, Holborn",839
"7863",2020,11,18,375,422,"51.51477076","-0.12221963","Drury Lane, Covent Garden",797
"7864",2020,11,19,331,344,"51.52505093","-0.131161087","Taviton Street, Bloomsbury",675
"7865",2020,11,20,176,138,"51.527326","-0.13605286","Drummond Street , Euston",314
"7866",2020,11,21,111,90,"51.53007835","-0.13884627","Hampstead Road (Cartmel), Euston",201
"7867",2020,11,22,297,303,"51.5222641","-0.114079481","Northington Street , Holborn",600
"7868",2020,11,23,173,168,"51.51943538","-0.119123345","Red Lion Square, Holborn",341
"7869",2020,11,24,330,359,"51.51908011","-0.124678402","British Museum, Bloomsbury",689
"7870",2020,11,25,395,334,"51.5288338","-0.132250369","Doric Way , Somers Town",729
"7871",2020,11,26,172,176,"51.52728093","-0.11829517","Ampton Street , Clerkenwell",348
"7872",2020,11,27,272,326,"51.51382102","-0.107927706","Bouverie Street, Temple",598
"7873",2020,11,28,266,269,"51.52351808","-0.143613641","Bolsover Street, Fitzrovia",535
"7874",2020,11,29,199,172,"51.513735","-0.193487","Hereford Road, Bayswater",371
"7875",2020,11,30,230,201,"51.52915444","-0.093421615","Windsor Terrace, Hoxton",431
"7876",2020,11,31,263,250,"51.52953709","-0.083353323","Fanshaw Street, Hoxton",513
"7877",2020,11,32,400,413,"51.52469624","-0.084439283","Leonard Circus , Shoreditch",813
"7878",2020,11,33,119,117,"51.5156","-0.070056","Central House, Aldgate",236
"7879",2020,11,34,118,128,"51.5341235","-0.129386874","Pancras Road, King's Cross",246
"7880",2020,11,36,176,150,"51.50173726","-0.184980612","De Vere Gardens, Kensington",326
"7881",2020,11,37,206,193,"51.49159394","-0.192369256","Penywern Road, Earl's Court",399
"7882",2020,11,38,144,149,"51.4973875","-0.197245586","Abingdon Villas, Kensington",293
"7883",2020,11,39,452,453,"51.5263778","-0.078130921","Shoreditch High Street, Shoreditch",905
"7884",2020,11,40,138,141,"51.52127071","-0.0755789","Commercial Street, Shoreditch",279
"7885",2020,11,41,321,366,"51.520955","-0.083493552","Pindar Street, Liverpool Street",687
"7886",2020,11,42,218,174,"51.53099181","-0.093903825","Wenlock Road , Hoxton",392
"7887",2020,11,43,235,227,"51.52026","-0.157183945","Crawford Street, Marylebone",462
"7888",2020,11,44,184,181,"51.51073687","-0.144165239","Bruton Street, Mayfair",365
"7889",2020,11,45,364,339,"51.522511","-0.162298","Boston Place, Marylebone",703
"7890",2020,11,46,457,428,"51.507131","-0.06691","Nesham Street, Wapping",885
"7891",2020,11,47,251,214,"51.52334476","-0.183846408","Warwick Avenue Station, Maida Vale",465
"7892",2020,11,48,297,364,"51.51248445","-0.099141408","Godliman Street, St. Paul's",661
"7893",2020,11,49,129,158,"51.50706909","-0.145904427","Curzon Street, Mayfair",287
"7894",2020,11,50,198,185,"51.52867339","-0.087459376","East Road, Hoxton",383
"7895",2020,11,51,144,125,"51.52671796","-0.104298194","Finsbury Library , Finsbury",269
"7896",2020,11,52,179,213,"51.52295439","-0.094934859","Roscoe Street, St. Luke's",392
"7897",2020,11,53,119,147,"51.5099923","-0.143495266","Grafton Street, Mayfair",266
"7898",2020,11,54,186,245,"51.52174785","-0.094475072","Golden Lane, Barbican",431
"7899",2020,11,55,521,673,"51.51707521","-0.086685542","Finsbury Circus, Liverpool Street",1194
"7900",2020,11,56,192,214,"51.52058381","-0.154701411","Paddington Street, Marylebone",406
"7901",2020,11,57,236,218,"51.52334672","-0.120202614","Guilford Street , Bloomsbury",454
"7902",2020,11,58,296,298,"51.52452699","-0.079248081","New Inn Yard, Shoreditch",594
"7903",2020,11,60,99,75,"51.52644828","-0.172190727","Lisson Grove, St. John's Wood",174
"7904",2020,11,61,240,218,"51.49738251","-0.089446947","Great Dover Street, The Borough",458
"7905",2020,11,62,116,101,"51.4907579","-0.106323685","Cotton Garden Estate, Kennington",217
"7906",2020,11,63,134,102,"51.53089041","-0.089782579","Murray Grove , Hoxton",236
"7907",2020,11,64,388,512,"51.50946212","-0.124749274","William IV Street, Strand",900
"7908",2020,11,65,198,186,NA,NA,NA,384
"7909",2020,11,66,554,1028,"51.51795029","-0.108657431","Holborn Circus, Holborn",1582
"7910",2020,11,67,366,320,"51.51882555","-0.108028472","Hatton Garden, Holborn",686
"7911",2020,11,68,298,327,"51.52059681","-0.116688468","Theobald's Road , Holborn",625
"7912",2020,11,69,187,177,"51.5262363","-0.134407652","Euston Road, Euston",364
"7913",2020,11,70,77,65,"51.53136059","-0.117069978","Calshot Street , King's Cross",142
"7914",2020,11,71,446,511,"51.5154186","-0.098850915","Newgate Street , St. Paul's",957
"7915",2020,11,72,186,210,"51.52352001","-0.108340165","Farringdon Lane, Clerkenwell",396
"7916",2020,11,73,418,425,"51.52572618","-0.088486188","Old Street Station, St. Luke's",843
"7917",2020,11,74,436,457,"51.48591714","-0.124469948","Vauxhall Cross, Vauxhall",893
"7918",2020,11,75,218,224,"51.53219984","-0.105480698","Torrens Street, Angel",442
"7919",2020,11,76,128,110,"51.52559505","-0.144083893","Longford Street, The Regent's Park",238
"7920",2020,11,77,235,252,"51.52341837","-0.124121774","Russell Square Station, Bloomsbury",487
"7921",2020,11,78,237,238,"51.52486887","-0.099489485","Sadlers Sports Centre, Finsbury",475
"7922",2020,11,79,143,149,"51.511726","-0.11385596","Arundel Street, Temple",292
"7923",2020,11,80,182,158,"51.50069361","-0.102091246","Webber Street , Southwark",340
"7924",2020,11,81,220,236,"51.52025302","-0.141327271","Great Titchfield Street, Fitzrovia",456
"7925",2020,11,82,155,157,"51.514274","-0.111257","Chancery Lane, Holborn",312
"7926",2020,11,83,233,274,"51.50963938","-0.131510949","Panton Street, West End",507
"7927",2020,11,84,184,170,"51.51593725","-0.111778348","Breams Buildings, Holborn",354
"7928",2020,11,85,281,252,"51.50064702","-0.078600401","Tanner Street, Bermondsey",533
"7929",2020,11,86,170,147,"51.48947903","-0.115156562","Sancroft Street, Vauxhall",317
"7930",2020,11,87,253,265,"51.51646835","-0.079684557","Devonshire Square, Liverpool Street",518
"7931",2020,11,88,340,392,"51.51858757","-0.132053392","Bayley Street , Bloomsbury",732
"7932",2020,11,89,189,173,"51.5262503","-0.123509611","Tavistock Place, Bloomsbury",362
"7933",2020,11,90,68,77,"51.53301907","-0.139174593","Harrington Square 1, Camden Town",145
"7934",2020,11,91,201,173,"51.49368637","-0.111014912","Walnut Tree Walk, Vauxhall",374
"7935",2020,11,92,190,214,"51.49889832","-0.100440521","Borough Road, Elephant & Castle",404
"7936",2020,11,93,221,105,"51.53440868","-0.109025404","Cloudesley Road, Angel",326
"7937",2020,11,94,277,245,"51.49506109","-0.085814489","Bricklayers Arms, Borough",522
"7938",2020,11,95,448,482,"51.5208417","-0.097340162","Aldersgate Street, Barbican",930
"7939",2020,11,96,214,203,"51.53095071","-0.078505384","Falkirk Street, Hoxton",417
"7940",2020,11,97,230,234,"51.49792478","-0.183834706","Gloucester Road (North), Kensington",464
"7941",2020,11,98,278,232,"51.52554222","-0.138231303","Hampstead Road, Euston",510
"7942",2020,11,99,327,323,"51.51457763","-0.158264483","Old Quebec Street, Marylebone",650
"7943",2020,11,100,149,125,"51.49043573","-0.122806861","Albert Embankment, Vauxhall",274
"7944",2020,11,101,614,672,"51.51155322","-0.0929401","Queen Street 1, Bank",1286
"7945",2020,11,102,263,286,"51.51340693","-0.076793375","Jewry Street, Aldgate",549
"7946",2020,11,103,87,74,"51.50472376","-0.192538767","Vicarage Gate, Kensington",161
"7947",2020,11,104,649,706,"51.51159481","-0.077121322","Crosswall, Tower",1355
"7948",2020,11,105,165,170,"51.51552971","-0.190240716","Westbourne Grove, Bayswater",335
"7949",2020,11,106,125,135,"51.51410514","-0.147301667","Woodstock Street, Mayfair",260
"7950",2020,11,107,414,410,"51.52600832","-0.096317627","Finsbury Leisure Centre, St. Luke's",824
"7951",2020,11,108,240,296,"51.49812559","-0.132102166","Abbey Orchard Street, Westminster",536
"7952",2020,11,109,487,555,"51.51563144","-0.132328837","Soho Square , Soho",1042
"7953",2020,11,110,162,122,"51.53304322","-0.172528678","Wellington Road, St. John's Wood",284
"7954",2020,11,111,300,307,"51.5100172","-0.157275636","Park Lane , Hyde Park",607
"7955",2020,11,112,178,165,"51.51580998","-0.105270275","Stonecutter Street, Holborn",343
"7956",2020,11,113,169,169,"51.49646288","-0.183289032","Gloucester Road (Central), South Kensington",338
"7957",2020,11,114,279,273,"51.52451738","-0.158963647","Park Road (Baker Street), The Regent's Park",552
"7958",2020,11,115,368,379,"51.51423368","-0.073537654","Braham Street, Aldgate",747
"7959",2020,11,116,365,381,"51.51449962","-0.141423695","Little Argyll Street, West End",746
"7960",2020,11,117,256,255,"51.49288067","-0.114934001","Lollard Street, Vauxhall",511
"7961",2020,11,118,131,164,"51.49582705","-0.13547809","Rochester Row, Westminster",295
"7962",2020,11,119,357,361,"51.52589324","-0.090847761","Bath Street, St. Luke's",718
"7963",2020,11,120,195,189,"51.51573534","-0.093080779","The Guildhall, Guildhall",384
"7964",2020,11,121,237,247,"51.51891348","-0.156166631","Baker Street, Marylebone",484
"7965",2020,11,122,218,239,"51.52111369","-0.078869751","Norton Folgate, Liverpool Street",457
"7966",2020,11,123,124,129,"51.52836014","-0.104724625","St. John Street, Finsbury",253
"7967",2020,11,124,106,111,"51.49654462","-0.150905245","Eaton Square, Belgravia",217
"7968",2020,11,125,237,234,"51.50069491","-0.094524319","Borough High Street, The Borough",471
"7969",2020,11,126,337,348,"51.51782144","-0.096496865","Museum of London, Barbican",685
"7970",2020,11,127,195,218,"51.51700801","-0.09388536","Wood Street, Guildhall",413
"7971",2020,11,128,164,160,"51.49536226","-0.185296516","Emperor's Gate, South Kensington",324
"7972",2020,11,129,229,254,"51.5118973","-0.137043852","Golden Square, Soho",483
"7973",2020,11,130,366,432,"51.50950627","-0.075459482","Tower Gardens , Tower",798
"7974",2020,11,131,162,132,"51.53300545","-0.136792671","Eversholt Street , Camden Town",294
"7975",2020,11,132,547,585,"51.52364804","-0.074754872","Bethnal Green Road, Shoreditch",1132
"7976",2020,11,133,440,448,NA,NA,NA,888
"7977",2020,11,134,116,101,"51.504904","-0.06797","Wapping High Street, Wapping",217
"7978",2020,11,135,317,318,"51.52326004","-0.104708922","Clerkenwell Green, Clerkenwell",635
"7979",2020,11,136,284,320,"51.51196176","-0.097441687","Queen Victoria Street, St. Paul's",604
"7980",2020,11,138,250,257,"51.51227622","-0.157436972","Green Street, Mayfair",507
"7981",2020,11,139,181,151,"51.49488108","-0.117974901","Lambeth Road, Vauxhall",332
"7982",2020,11,140,323,393,"51.52096262","-0.085634242","Finsbury Square , Moorgate",716
"7983",2020,11,141,238,284,"51.51530805","-0.147203711","Chapel Place, Marylebone",522
"7984",2020,11,142,130,122,"51.49372451","-0.198286569","West Cromwell Road, Earl's Court",252
"7985",2020,11,143,186,196,"51.4968865","-0.161203828","Pont Street, Knightsbridge",382
"7986",2020,11,144,369,291,"51.48894022","-0.111435796","Kennington Cross, Kennington",660
"7987",2020,11,145,40,37,"51.50074359","-0.202759212","Ilchester Place, Kensington",77
"7988",2020,11,146,136,136,"51.48836528","-0.129361842","Vauxhall Bridge , Pimlico",272
"7989",2020,11,148,290,274,"51.49211134","-0.138364847","Tachbrook Street, Victoria",564
"7990",2020,11,149,180,167,"51.48478899","-0.110683213","Kennington Road Post Office, Oval",347
"7991",2020,11,150,184,224,"51.49705603","-0.168917077","Holy Trinity Brompton, Knightsbridge",408
"7992",2020,11,151,128,107,"51.51213691","-0.201554966","Chepstow Villas, Notting Hill",235
"7993",2020,11,152,192,191,"51.49217002","-0.101536865","Hampton Street, Walworth",383
"7994",2020,11,153,401,417,"51.511933","-0.174411","Bayswater Road, Hyde Park",818
"7995",2020,11,154,1448,1348,"51.50379168","-0.11282408","Waterloo Station 3, Waterloo",2796
"7996",2020,11,155,148,149,"51.49586666","-0.191933711","Lexham Gardens, Kensington",297
"7997",2020,11,156,162,140,"51.49443626","-0.092921165","New Kent Road, The Borough",302
"7998",2020,11,157,219,255,"51.50039792","-0.193068385","Wright's Lane, Kensington",474
"7999",2020,11,158,168,154,"51.49085368","-0.196170309","Trebovir Road, Earl's Court",322
"8000",2020,11,159,397,459,"51.51461995","-0.137841333","Great Marlborough Street, Soho",856
"8001",2020,11,160,219,263,"51.50663341","-0.131773845","Waterloo Place, St. James's",482
"8002",2020,11,161,120,121,"51.49234577","-0.141334487","Guildhouse Street, Victoria",241
"8003",2020,11,162,222,231,"51.51760685","-0.121328408","Southampton Place, Holborn",453
"8004",2020,11,163,277,286,"51.4931848","-0.167894973","Sloane Avenue, Knightsbridge",563
"8005",2020,11,164,157,121,"51.515607","-0.183118788","Cleveland Gardens, Bayswater",278
"8006",2020,11,165,64,48,"51.517932","-0.183716959","Orsett Terrace, Bayswater",112
"8007",2020,11,166,155,161,"51.50185512","-0.159237081","Seville Street, Knightsbridge",316
"8008",2020,11,167,422,446,"51.49395092","-0.147624377","Eccleston Place, Victoria",868
"8009",2020,11,168,134,133,"51.50040123","-0.195455928","Argyll Road, Kensington",267
"8010",2020,11,169,253,241,"51.51474612","-0.165164288","Porchester Place, Paddington",494
"8011",2020,11,170,146,125,"51.52784273","-0.108068155","Hardwick Street, Clerkenwell",271
"8012",2020,11,171,160,152,"51.4916156","-0.186753859","Collingham Gardens, Earl's Court",312
"8013",2020,11,172,128,130,"51.49121192","-0.173715911","Sumner Place, South Kensington",258
"8014",2020,11,173,205,213,"51.50486","-0.113001","Waterloo Road, South Bank",418
"8015",2020,11,174,233,272,"51.512529","-0.115163","Strand, Strand",505
"8016",2020,11,175,253,283,"51.521668","-0.079608554","Worship Street, Shoreditch",536
"8017",2020,11,176,133,127,"51.51791921","-0.188098863","Gloucester Terrace, Bayswater",260
"8018",2020,11,177,372,417,"51.49616092","-0.140947636","Ashley Place, Victoria",789
"8019",2020,11,178,249,184,"51.48985626","-0.141923621","Warwick Square, Pimlico",433
"8020",2020,11,180,175,192,"51.5129118","-0.153645496","North Audley Street, Mayfair",367
"8021",2020,11,181,144,132,"51.49941247","-0.152317537","Belgrave Square, Belgravia",276
"8022",2020,11,182,226,214,"51.52202903","-0.165842551","Bell Street , Marylebone",440
"8023",2020,11,183,274,272,"51.482362","-0.13612398","Riverlight North, Nine Elms",546
"8024",2020,11,184,221,231,"51.52071513","-0.14521173","Portland Place, Marylebone",452
"8025",2020,11,185,251,208,"51.48805753","-0.140741432","Alderney Street, Pimlico",459
"8026",2020,11,186,551,495,"51.51733558","-0.175810943","South Wharf Road, Paddington",1046
"8027",2020,11,187,194,170,"51.49247977","-0.178433004","Queen's Gate (South), South Kensington",364
"8028",2020,11,188,95,88,"51.5165179","-0.164393768","Nutford Place, Marylebone",183
"8029",2020,11,189,148,68,"51.53166681","-0.109914711","Claremont Square, Angel",216
"8030",2020,11,190,252,217,"51.48997562","-0.132845681","Rampayne Street, Pimlico",469
"8031",2020,11,191,689,706,"51.50311799","-0.153520935","Hyde Park Corner, Hyde Park",1395
"8032",2020,11,192,350,360,"51.51251523","-0.133201961","Wardour Street, Soho",710
"8033",2020,11,193,323,476,"51.50581776","-0.100186337","Bankside Mix, Bankside",799
"8034",2020,11,194,718,1039,"51.50462759","-0.091773776","Hop Exchange, The Borough",1757
"8035",2020,11,195,256,262,"51.50724437","-0.106237501","Milroy Walk, South Bank",518
"8036",2020,11,196,229,229,"51.50368837","-0.098497684","Union Street, The Borough",458
"8037",2020,11,197,285,308,"51.50556905","-0.111606696","Stamford Street, South Bank",593
"8038",2020,11,199,508,568,"51.51048489","-0.082989638","Great Tower Street, Monument",1076
"8039",2020,11,200,265,252,"51.51492456","-0.066078037","LMU Commercial Road, Whitechapel",517
"8040",2020,11,201,266,265,"51.5225965","-0.161113413","Dorset Square, Marylebone",531
"8041",2020,11,202,395,392,"51.51236389","-0.06954201","Leman Street, Aldgate",787
"8042",2020,11,203,331,357,"51.51821864","-0.100791005","West Smithfield Rotunda, Farringdon",688
"8043",2020,11,204,160,142,"51.52659961","-0.112432615","Margery Street, Clerkenwell",302
"8044",2020,11,206,255,247,"51.518154","-0.062697","New Road 1 , Whitechapel",502
"8045",2020,11,207,93,81,"51.50135267","-0.153194766","Grosvenor Crescent, Belgravia",174
"8046",2020,11,208,67,53,"51.52505151","-0.166304359","Mallory Street, Marylebone",120
"8047",2020,11,209,115,111,"51.49358391","-0.165101392","Denyer Street, Knightsbridge",226
"8048",2020,11,210,314,315,"51.51681444","-0.151926305","Hinde Street, Marylebone",629
"8049",2020,11,211,136,186,"51.49464523","-0.158105512","Cadogan Place, Knightsbridge",322
"8050",2020,11,212,74,63,"51.50658458","-0.199004026","Campden Hill Road, Notting Hill",137
"8051",2020,11,213,594,564,"51.50274025","-0.149569201","Wellington Arch, Hyde Park",1158
"8052",2020,11,214,338,364,"51.52683806","-0.130504336","Endsleigh Gardens, Euston",702
"8053",2020,11,215,418,476,"51.51906932","-0.088285377","Moorfields, Moorgate",894
"8054",2020,11,216,203,197,"51.49094565","-0.181190899","Old Brompton Road, South Kensington",400
"8055",2020,11,217,691,767,"51.51615461","-0.082422399","Wormwood Street, Liverpool Street",1458
"8056",2020,11,218,138,141,"51.48971651","-0.170194408","St. Luke's Church, Chelsea",279
"8057",2020,11,219,273,229,"51.49016361","-0.19039362","Bramham Gardens, Earl's Court",502
"8058",2020,11,220,132,133,"51.49066456","-0.166485083","Chelsea Green, Chelsea",265
"8059",2020,11,221,290,336,"51.49481649","-0.13045856","Horseferry Road, Westminster",626
"8060",2020,11,222,61,46,"51.50275704","-0.155349725","Knightsbridge, Hyde Park",107
"8061",2020,11,223,179,167,"51.49148474","-0.090220911","Rodney Road , Walworth",346
"8062",2020,11,224,259,249,"51.51031","-0.18740235","Queensway, Kensington Gardens",508
"8063",2020,11,225,323,285,"51.50935342","-0.196422","Notting Hill Gate Station, Notting Hill",608
"8064",2020,11,226,192,235,"51.50844614","-0.131961389","Charles II Street, West End",427
"8065",2020,11,227,171,162,"51.52891573","-0.115480888","Great Percy Street, Clerkenwell",333
"8066",2020,11,228,469,588,"51.50742485","-0.134621209","St. James's Square, St. James's",1057
"8067",2020,11,229,446,524,"51.50654321","-0.123179697","Whitehall Place, Strand",970
"8068",2020,11,230,137,171,"51.50669284","-0.103137426","Poured Lines, Bankside",308
"8069",2020,11,231,209,229,"51.49396755","-0.17873226","Queen's Gate (Central), South Kensington",438
"8070",2020,11,232,93,102,"51.51501025","-0.112753217","Carey Street, Holborn",195
"8071",2020,11,233,221,323,"51.50777049","-0.130699733","Pall Mall East, West End",544
"8072",2020,11,234,302,297,"51.53450449","-0.106992706","Liverpool Road (N1 Centre), Angel",599
"8073",2020,11,235,196,160,"51.49571828","-0.110889274","Kennington Road  , Vauxhall",356
"8074",2020,11,236,146,132,"51.51838043","-0.073438925","Fashion Street, Whitechapel",278
"8075",2020,11,237,209,215,"51.5097860151","-0.0681619805156","Dock Street, Wapping",424
"8076",2020,11,238,115,61,"51.5233534","-0.175116099","Frampton Street, Paddington",176
"8077",2020,11,239,313,297,"51.52443845","-0.138019439","Warren Street Station, Euston",610
"8078",2020,11,240,85,111,"51.50545935","-0.10569204","Colombo Street, Southwark",196
"8079",2020,11,242,187,186,"51.52200801","-0.151359288","Beaumont Street, Marylebone",373
"8080",2020,11,243,236,235,"51.49096258","-0.139625122","Gloucester Street, Pimlico",471
"8081",2020,11,244,246,280,"51.51611887","-0.128585022","Earnshaw Street , Covent Garden",526
"8082",2020,11,245,119,97,"51.4853572","-0.142207481","Grosvenor Road, Pimlico",216
"8083",2020,11,246,369,393,"51.52285301","-0.099994052","Berry Street, Clerkenwell",762
"8084",2020,11,247,114,60,"51.530529","-0.167515","St. John's Wood Church, The Regent's Park",174
"8085",2020,11,248,313,340,"51.50645179","-0.170279555","Triangle Car Park, Hyde Park",653
"8086",2020,11,249,125,126,"51.49859784","-0.096191134","Harper Road, The Borough",251
"8087",2020,11,250,108,116,"51.489932","-0.162727","Royal Avenue 1, Chelsea",224
"8088",2020,11,251,573,723,"51.518908","-0.079249","Brushfield Street, Liverpool Street",1296
"8089",2020,11,252,371,392,"51.5046364","-0.116542278","Jubilee Gardens, South Bank",763
"8090",2020,11,253,285,223,"51.53404294","-0.086379717","Shoreditch Park, Hoxton",508
"8091",2020,11,254,241,172,"51.53051587","-0.106408455","Chadwell Street, Angel",413
"8092",2020,11,255,172,160,"51.52557531","-0.179592915","Clifton Road, Maida Vale",332
"8093",2020,11,256,157,156,"51.51362054","-0.116764211","Houghton Street, Strand",313
"8094",2020,11,257,146,151,"51.52248185","-0.154907218","Westminster University, Marylebone",297
"8095",2020,11,259,157,163,"51.490959","-0.1532331","Bourne Street, Belgravia",320
"8096",2020,11,260,233,247,"51.5136846","-0.135580879","Broadwick Street, Soho",480
"8097",2020,11,261,100,82,"51.5134891","-0.191351186","Princes Square, Bayswater",182
"8098",2020,11,262,162,165,"51.49874469","-0.103132904","LSBU (Borough Road), Elephant & Castle",327
"8099",2020,11,263,202,228,"51.51422502","-0.080660083","St. Mary Axe, Aldgate",430
"8100",2020,11,264,291,275,"51.52644342","-0.109256828","Tysoe Street, Clerkenwell",566
"8101",2020,11,265,176,154,"51.51595344","-0.169249375","Southwick Street, Paddington",330
"8102",2020,11,266,307,280,"51.50102668","-0.180246101","Queen's Gate (North), Kensington",587
"8103",2020,11,267,221,233,"51.49206037","-0.132224622","Regency Street, Westminster",454
"8104",2020,11,268,310,318,"51.49320445","-0.144132875","Belgrave Road, Victoria",628
"8105",2020,11,269,211,207,"51.50082346","-0.089740764","Empire Square, The Borough",418
"8106",2020,11,270,553,562,"51.4863434","-0.122492418","Kennington Lane Rail Bridge, Vauxhall",1115
"8107",2020,11,271,94,81,"51.53583617","-0.156285395","London Zoo,  The Regent's Park",175
"8108",2020,11,272,470,477,"51.50144456","-0.110699309","Baylis Road, Waterloo",947
"8109",2020,11,273,248,319,"51.50613324","-0.114686385","Belvedere Road 1, South Bank",567
"8110",2020,11,274,167,149,"51.49671237","-0.20528437","Warwick Road, Olympia",316
"8111",2020,11,275,208,240,"51.52004497","-0.092176447","Barbican Centre, Barbican",448
"8112",2020,11,276,149,159,"51.50930161","-0.084985356","Lower Thames Street, Monument",308
"8113",2020,11,277,248,235,"51.50315739","-0.191496313","Kensington Church Street, Kensington",483
"8114",2020,11,278,585,614,"51.5034938","-0.07962099","Tooley Street, Bermondsey",1199
"8115",2020,11,279,295,252,"51.51862243","-0.176645823","North Wharf Road, Paddington",547
"8116",2020,11,280,184,192,"51.490083","-0.162418","Royal Avenue 2, Chelsea",376
"8117",2020,11,281,249,274,"51.49580589","-0.127575233","Smith Square, Westminster",523
"8118",2020,11,282,484,488,"51.51906446","-0.059642081","Royal London Hospital, Whitechapel",972
"8119",2020,11,283,74,82,"51.51440928","-0.118478757","Kingsway, Covent Garden",156
"8120",2020,11,284,159,156,"51.49914063","-0.112031483","Lambeth North Station, Waterloo",315
"8121",2020,11,286,140,83,"51.5272947","-0.174653609","St. John's Wood Road, St. John's Wood",223
"8122",2020,11,287,121,138,"51.52367314","-0.128377673","Bedford Way, Bloomsbury",259
"8123",2020,11,288,308,337,"51.49236962","-0.147478734","Elizabeth Bridge, Victoria",645
"8124",2020,11,289,57,78,"51.50923022","-0.151296092","South Audley Street, Mayfair",135
"8125",2020,11,290,205,194,"51.518268","-0.17110323","St Mary's Hospital, Paddington",399
"8126",2020,11,291,189,177,"51.48483991","-0.138089062","Claverton Street, Pimlico",366
"8127",2020,11,292,173,191,"51.49888404","-0.165471605","Montpelier Street, Knightsbridge",364
"8128",2020,11,293,112,111,"51.49815779","-0.209494128","Kensington Olympia Station, Olympia",223
"8129",2020,11,294,249,237,"51.488226","-0.135635511","St. George's Square, Pimlico",486
"8130",2020,11,295,237,222,"51.50029631","-0.092762704","Swan Street, The Borough",459
"8131",2020,11,296,159,167,"51.49363156","-0.190603326","Knaresborough Place, Earl's Court",326
"8132",2020,11,297,63,51,"51.49612799","-0.106000855","Geraldine Street, Elephant & Castle",114
"8133",2020,11,298,416,418,"51.50227992","-0.074189225","Curlew Street, Shad Thames",834
"8134",2020,11,299,83,108,"51.49398524","-0.136928582","Vincent Square, Westminster",191
"8135",2020,11,300,384,397,"51.505014","-0.17306032","Serpentine Car Park, Hyde Park",781
"8136",2020,11,301,276,312,"51.51475963","-0.148105415","Marylebone Lane, Marylebone",588
"8137",2020,11,302,155,154,"51.466907","-0.216573","Putney Pier, Wandsworth",309
"8138",2020,11,303,510,510,"51.50295379","-0.158456089","Albert Gate, Hyde Park",1020
"8139",2020,11,306,207,192,"51.51816295","-0.135025698","Rathbone Street, Fitzrovia",399
"8140",2020,11,307,427,402,"51.50990837","-0.187842717","Black Lion Gate, Kensington Gardens",829
"8141",2020,11,308,212,193,"51.49907558","-0.085666316","Long Lane , Bermondsey",405
"8142",2020,11,309,133,132,"51.50963123","-0.119047563","Embankment (Savoy), Strand",265
"8143",2020,11,310,236,211,"51.4908679","-0.116911864","Black Prince Road, Vauxhall",447
"8144",2020,11,311,238,256,"51.51918144","-0.140485596","Foley Street, Fitzrovia",494
"8145",2020,11,312,183,154,"51.53088935","-0.176770502","Grove End Road, St. John's Wood",337
"8146",2020,11,313,250,269,"51.51734403","-0.138072691","Wells Street, Fitzrovia",519
"8147",2020,11,314,197,195,"51.50088934","-0.083159352","Tyers Gate, Bermondsey",392
"8148",2020,11,315,143,132,"51.52536703","-0.153463612","The Tennis Courts, The Regent's Park",275
"8149",2020,11,316,234,289,NA,NA,NA,523
"8150",2020,11,317,100,64,"51.49679128","-0.093913472","Dickens Square, Borough",164
"8151",2020,11,318,215,238,"51.51004801","-0.138846453","Sackville Street, Mayfair",453
"8152",2020,11,319,248,281,"51.52702563","-0.088542771","Baldwin Street, St. Luke's",529
"8153",2020,11,320,279,315,"51.49357351","-0.139956043","Queen Mother Sports Centre, Victoria",594
"8154",2020,11,321,359,337,"51.49785559","-0.081608045","Bermondsey Street, Bermondsey",696
"8155",2020,11,322,127,125,"51.526293","-0.073955","Palissy Street, Shoreditch",252
"8156",2020,11,323,131,157,"51.523196","-0.083067","Clifton Street, Shoreditch",288
"8157",2020,11,324,245,240,"51.49652013","-0.101384068","Ontario Street, Elephant & Castle",485
"8158",2020,11,325,166,195,"51.50908747","-0.129697889","St. Martin's Street, West End",361
"8159",2020,11,326,372,298,"51.53266186","-0.099981142","Graham Street, Angel",670
"8160",2020,11,327,71,59,"51.53095","-0.085603","New North Road 1, Hoxton",130
"8161",2020,11,328,80,68,"51.53114","-0.086016","New North Road 2, Hoxton",148
"8162",2020,11,329,155,117,"51.53589283","-0.160854428","Prince Albert Road, The Regent's Park",272
"8163",2020,11,330,316,250,"51.51641749","-0.179135079","Eastbourne Mews, Paddington",566
"8164",2020,11,331,363,411,"51.52085887","-0.089887855","Bunhill Row, Moorgate",774
"8165",2020,11,332,128,100,"51.49334336","-0.194757949","Nevern Place, Earl's Court",228
"8166",2020,11,333,177,158,"51.50860544","-0.193764092","Palace Gardens Terrace, Notting Hill",335
"8167",2020,11,334,155,162,"51.505044","-0.115851","Concert Hall Approach 1, South Bank",317
"8168",2020,11,335,234,332,"51.51196803","-0.120718759","Tavistock Street, Covent Garden",566
"8169",2020,11,336,146,246,"51.504942","-0.115533","Concert Hall Approach 2, South Bank",392
"8170",2020,11,337,110,113,"51.51108452","-0.197524944","Pembridge Villas, Notting Hill",223
"8171",2020,11,338,381,387,"51.51175646","-0.119643424","Wellington Street , Strand",768
"8172",2020,11,339,79,63,"51.5333196","-0.1117812","Risinghill Street, Angel",142
"8173",2020,11,340,367,437,"51.51444134","-0.087587447","Bank of England Museum, Bank",804
"8174",2020,11,341,596,592,"51.50810309","-0.12602103","Craven Street, Strand",1188
"8175",2020,11,343,172,151,"51.53692216","-0.150181444","London Zoo Car Park, The Regent's Park",323
"8176",2020,11,344,173,144,"51.528246","-0.10102611","Goswell Road (City Uni), Finsbury",317
"8177",2020,11,345,380,383,"51.48802358","-0.166878535","Flood Street, Chelsea",763
"8178",2020,11,347,217,219,"51.50013942","-0.113936001","Lower Marsh, Waterloo",436
"8179",2020,11,348,169,237,"51.51217033","-0.150481272","Grosvenor Square, Mayfair",406
"8180",2020,11,349,170,240,"51.51196","-0.142783033","St. George Street, Mayfair",410
"8181",2020,11,350,338,332,"51.5017154373867","-0.1798541843891","Queen's Gate, Kensington Gardens",670
"8182",2020,11,351,253,190,"51.529423","-0.097122","Macclesfield Rd, St Lukes",443
"8183",2020,11,352,183,177,"51.486965","-0.116625","Vauxhall Street, Vauxhall",360
"8184",2020,11,353,90,125,"51.49459148","-0.134234258","Greycoat Street , Westminster",215
"8185",2020,11,354,254,411,"51.506767","-0.123702","Northumberland Avenue, Strand",665
"8186",2020,11,356,476,474,"51.494412","-0.173881","South Kensington Station, South Kensington",950
"8187",2020,11,357,330,351,"51.520994","-0.139016","Howland Street, Fitzrovia",681
"8188",2020,11,358,259,290,"51.516226","-0.124826","High Holborn , Covent Garden",549
"8189",2020,11,359,151,161,"51.49782999","-0.135440826","Butler Place, Westminster",312
"8190",2020,11,360,309,370,"51.49675303","-0.138733562","Howick Place, Westminster",679
"8191",2020,11,361,669,398,"51.50391973","-0.11342629","Waterloo Station 2, Waterloo",1067
"8192",2020,11,362,200,143,"51.536264","-0.133952","Royal College Street, Camden Town",343
"8193",2020,11,363,70,49,"51.5291212008901","-0.171185284853","Lord's, St. John's Wood",119
"8194",2020,11,364,327,348,"51.519656","-0.132339","Alfred Place, Bloomsbury",675
"8195",2020,11,365,179,160,"51.530344","-0.100168","City Road, Angel",339
"8196",2020,11,366,124,167,"51.5109192966489","-0.1511263847351","Millennium Hotel, Mayfair",291
"8197",2020,11,367,145,121,"51.5173721","-0.1642075","Harrowby Street, Marylebone",266
"8198",2020,11,368,200,215,"51.50024195","-0.15934065","Harriet Street, Knightsbridge",415
"8199",2020,11,370,51,33,"51.520205","-0.174593","Paddington Green, Paddington",84
"8200",2020,11,371,99,99,"51.49775","-0.10988","King Edward Walk, Waterloo",198
"8201",2020,11,372,190,243,"51.515208","-0.117863","Sardinia Street, Holborn",433
"8202",2020,11,373,145,190,"51.49980661","-0.176415994","Prince Consort Road, Knightsbridge",335
"8203",2020,11,374,1244,1094,"51.50402794","-0.11386436","Waterloo Station 1, Waterloo",2338
"8204",2020,11,375,122,110,"51.50194596","-0.194392952","Kensington Town Hall, Kensington",232
"8205",2020,11,376,240,285,"51.49188409","-0.125674815","Millbank Tower, Pimlico",525
"8206",2020,11,377,132,141,"51.50535447","-0.113656543","Waterloo Bridge, South Bank",273
"8207",2020,11,378,68,107,"51.49559291","-0.179077626","Natural History Museum, South Kensington",175
"8208",2020,11,379,170,136,"51.51431171","-0.200838199","Turquoise Island, Notting Hill",306
"8209",2020,11,380,119,140,"51.50686435","-0.150666888","Stanhope Gate, Mayfair",259
"8210",2020,11,381,185,186,"51.51953043","-0.13577731","Charlotte Street, Fitzrovia",371
"8211",2020,11,382,98,119,"51.50935171","-0.14744969","Farm Street, Mayfair",217
"8212",2020,11,383,255,282,"51.51310333","-0.13121385","Frith Street, Soho",537
"8213",2020,11,384,105,104,"51.496481","-0.192404","Marloes Road, Kensington",209
"8214",2020,11,386,343,373,"51.51352755","-0.130110822","Moor Street, Soho",716
"8215",2020,11,387,205,200,"51.49369988","-0.121394101","Fire Brigade Pier, Vauxhall",405
"8216",2020,11,388,239,271,"51.51070161","-0.121723604","Southampton Street, Strand",510
"8217",2020,11,389,49,43,"51.51013066","-0.155757901","Upper Grosvenor Street, Mayfair",92
"8218",2020,11,390,75,62,"51.521776","-0.068856","Buxton Street 1, Shoreditch",137
"8219",2020,11,392,336,378,"51.49942855","-0.179702476","Imperial College, Knightsbridge",714
"8220",2020,11,393,321,322,"51.51733427","-0.103604248","Snow Hill, Farringdon",643
"8221",2020,11,394,112,85,"51.524826","-0.176268","Aberdeen Place, St. John's Wood",197
"8222",2020,11,395,281,287,"51.492462","-0.159919","Cadogan Gardens, Chelsea",568
"8223",2020,11,396,143,140,"51.51809","-0.163609","Shouldham Street, Marylebone",283
"8224",2020,11,397,264,241,"51.51348","-0.17977","Devonshire Terrace, Bayswater",505
"8225",2020,11,398,98,66,"51.502319","-0.200742","Holland Park, Kensington",164
"8226",2020,11,399,221,226,"51.52261762","-0.071653961","Brick Lane Market, Shoreditch",447
"8227",2020,11,400,176,239,"51.517703","-0.154106","George Street, Marylebone",415
"8228",2020,11,401,230,201,"51.528187","-0.075375","Columbia Road, Shoreditch",431
"8229",2020,11,402,116,99,"51.52289229","-0.171681991","Penfold Street, Marylebone",215
"8230",2020,11,403,159,158,"51.51689296","-0.158249929","George Place Mews, Marylebone",317
"8231",2020,11,404,343,330,"51.50204238","-0.184400221","Palace Gate, Kensington Gardens",673
"8232",2020,11,405,368,373,"51.49418566","-0.18267094","Gloucester Road Station, South Kensington",741
"8233",2020,11,408,106,58,NA,NA,NA,164
"8234",2020,11,409,215,257,"51.493146","-0.099828","Strata, Elephant & Castle",472
"8235",2020,11,410,170,139,"51.519968","-0.169774","Edgware Road Station, Marylebone",309
"8236",2020,11,411,244,236,"51.49337264","-0.09968067","Walworth Road, Elephant & Castle",480
"8237",2020,11,412,135,123,"51.488105","-0.110121","Cleaver Street, Kennington",258
"8238",2020,11,419,176,165,"51.485821","-0.149004","Chelsea Bridge, Pimlico",341
"8239",2020,11,420,122,124,"51.504043","-0.105312","Southwark Station 1, Southwark",246
"8240",2020,11,421,251,301,"51.504044","-0.104778","Southwark Station 2, Southwark",552
"8241",2020,11,423,113,110,"51.49456127","-0.15393398","Eaton Square (South), Belgravia",223
"8242",2020,11,424,161,148,"51.490491","-0.149186","Ebury Bridge, Pimlico",309
"8243",2020,11,425,195,179,"51.533379","-0.139159","Harrington Square 2, Camden Town",374
"8244",2020,11,426,274,275,"51.493072","-0.129925","Vincent Street, Pimlico",549
"8245",2020,11,427,579,631,"51.51397065","-0.09294031","Cheapside, Bank",1210
"8246",2020,11,428,429,514,"51.499917","-0.174554","Exhibition Road, Knightsbridge",943
"8247",2020,11,430,105,108,"51.48902","-0.17524","South Parade, Chelsea",213
"8248",2020,11,431,130,143,"51.534474","-0.122203","Crinan Street, King's Cross",273
"8249",2020,11,432,263,290,"51.496957","-0.173894","Exhibition Road Museums, South Kensington",553
"8250",2020,11,433,294,252,"51.524564","-0.116279","Wren Street, Holborn",546
"8251",2020,11,435,171,162,"51.488852","-0.105593","Kennington Station, Kennington",333
"8252",2020,11,436,397,384,"51.51824","-0.11655","Red Lion Street, Holborn",781
"8253",2020,11,437,167,171,"51.488124","-0.120903","Vauxhall Walk, Vauxhall",338
"8254",2020,11,439,86,81,"51.5338","-0.118677","Killick Street, King's Cross",167
"8255",2020,11,440,163,154,"51.483145","-0.113134","Kennington Oval, Oval",317
"8256",2020,11,441,236,221,"51.495656","-0.114605","Sail Street, Vauxhall",457
"8257",2020,11,442,70,68,"51.510101","-0.211358","Walmer Road, Avondale",138
"8258",2020,11,443,202,192,"51.515256","-0.058641","Philpot Street, Whitechapel",394
"8259",2020,11,444,174,151,"51.52568","-0.055312","Bethnal Green Garden, Bethnal Green",325
"8260",2020,11,445,130,121,"51.52388","-0.065076","Cheshire Street, Bethnal Green",251
"8261",2020,11,446,211,211,"51.528936","-0.055894","York Hall, Bethnal Green",422
"8262",2020,11,447,41,37,"51.493381","-0.007542","Jubilee Crescent, Cubitt Town",78
"8263",2020,11,448,144,157,"51.50623","-0.02296","Fisherman's Walk West, Canary Wharf",301
"8264",2020,11,449,260,267,"51.511088","-0.057159","Shadwell Station, Shadwell",527
"8265",2020,11,450,169,111,"51.515975","-0.053177","Jubilee Street, Stepney",280
"8266",2020,11,451,185,172,"51.504719","-0.063531","Hermitage Court, Wapping",357
"8267",2020,11,452,165,140,"51.505697","-0.070542","St. Katharine's Way, Tower",305
"8268",2020,11,453,160,140,"51.508447","-0.055167","Garnet Street, Shadwell",300
"8269",2020,11,454,66,75,"51.487679","-0.021582","Napier Avenue, Millwall",141
"8270",2020,11,455,64,57,"51.49447","-0.014409","East Ferry Road, Cubitt Town",121
"8271",2020,11,456,135,133,"51.538071","-0.144664","Parkway, Camden Town",268
"8272",2020,11,457,219,176,"51.542138","-0.145393","Castlehaven Road, Camden Town",395
"8273",2020,11,458,186,184,"51.504749","-0.057544","Wapping Lane, Wapping",370
"8274",2020,11,459,184,174,"51.535179","-0.03338","Gunmakers Lane, Old Ford",358
"8275",2020,11,460,216,201,"51.516196","-0.029138","Burdett Road, Mile End",417
"8276",2020,11,461,129,116,"51.516","-0.038775","Aston Street, Stepney",245
"8277",2020,11,462,275,240,"51.541603","-0.138853","Bonny Street, Camden Town",515
"8278",2020,11,463,112,91,"51.534776","-0.071881","Thurtle Road, Haggerston",203
"8279",2020,11,464,75,51,"51.51417","-0.052099","St. Mary & St. Michael Church, Stepney",126
"8280",2020,11,465,307,248,"51.53558","-0.08249","Pitfield Street North,Hoxton",555
"8281",2020,11,466,143,104,"51.534464","-0.076341","Whiston Road, Haggerston",247
"8282",2020,11,467,82,75,"51.523538","-0.030556","Southern Grove, Bow",157
"8283",2020,11,468,56,51,"51.521564","-0.022694","Cantrell Road, Bow",107
"8284",2020,11,469,117,103,"51.513757","-0.020467","Lindfield Street, Poplar",220
"8285",2020,11,470,139,137,"51.530535","-0.025492","Mostyn Grove, Bow",276
"8286",2020,11,471,163,150,"51.533283","-0.028155","Hewison Street, Old Ford",313
"8287",2020,11,472,27,17,"51.529452","-0.027616","Malmesbury Road, Bow",44
"8288",2020,11,473,42,47,"51.496137","-0.019355","Millharbour, Millwall",89
"8289",2020,11,475,75,79,"51.499041","-0.020157","Lightermans Road, Millwall",154
"8290",2020,11,476,33,24,"51.489096","-0.009205","Stebondale Street, Cubitt Town",57
"8291",2020,11,477,76,72,"51.49109","-0.018716","Spindrift Avenue, Millwall",148
"8292",2020,11,478,321,331,"51.521889","-0.04667","Stepney Green Station, Stepney",652
"8293",2020,11,479,247,241,"51.527152","-0.058005","Pott Street, Bethnal Green",488
"8294",2020,11,480,327,311,"51.5128711","-0.0389866","Flamborough Street, Limehouse",638
"8295",2020,11,481,143,172,"51.487129","-0.009001","Saunders Ness Road, Cubitt Town",315
"8296",2020,11,483,159,142,"51.51328","-0.047784","Albert Gardens, Stepney",301
"8297",2020,11,484,82,73,"51.528828","-0.013258","Bromley High Street, Bow",155
"8298",2020,11,485,144,138,"51.531127","-0.048017","Old Ford Road, Bethnal Green",282
"8299",2020,11,486,307,261,"51.525645","-0.069543","Granby Street, Shoreditch",568
"8300",2020,11,487,47,62,"51.511811","-0.025626","Canton Street, Poplar",109
"8301",2020,11,488,196,174,"51.506946","-0.058681","Reardon Street, Wapping",370
"8302",2020,11,489,281,225,"51.513074","-0.064094","Christian Street, Whitechapel",506
"8303",2020,11,490,104,96,"51.508622","-0.065006","Pennington Street, Wapping",200
"8304",2020,11,491,313,295,"51.522507","-0.041378","Queen Mary's, Mile End",608
"8305",2020,11,492,241,220,"51.525501","-0.032267204","Maplin Street, Mile End",461
"8306",2020,11,494,5,9,"51.50196","-0.016251","South Quay East, Canary Wharf",14
"8307",2020,11,495,146,139,"51.528169","-0.018703","Bow Church Station, Bow",285
"8308",2020,11,496,91,87,"51.52512","-0.015578","Devons Road, Bow",178
"8309",2020,11,497,91,63,"51.526149","-0.027396845","Merchant Street, Bow",154
"8310",2020,11,498,127,130,"51.527058","-0.025296","Bow Road Station, Bow",257
"8311",2020,11,499,222,204,"51.519265","-0.021345","Furze Green, Bow",426
"8312",2020,11,500,247,254,"51.519806","-0.055731","Ansell House, Stepney",501
"8313",2020,11,501,121,101,"51.522561","-0.054883","Cephas Street, Bethnal Green",222
"8314",2020,11,502,212,199,"51.53341","-0.049591815","Bonner Gate, Victoria Park",411
"8315",2020,11,503,377,357,"51.520893","-0.051394","Cleveland Way, Stepney",734
"8316",2020,11,504,23,14,"51.496454","-0.009506","St. John's Park, Cubitt Town",37
"8317",2020,11,505,124,107,"51.520398","-0.026768","Ackroyd Drive, Bow",231
"8318",2020,11,506,205,228,"51.517475","-0.075855","Bell Lane, Liverpool Street",433
"8319",2020,11,507,127,106,"51.528692","-0.059091","Clarkson Street, Bethnal Green",233
"8320",2020,11,508,305,319,"51.519362","-0.074431","Fournier Street, Whitechapel",624
"8321",2020,11,509,182,186,"51.517842","-0.090075","Fore Street, Guildhall",368
"8322",2020,11,510,227,274,"51.509303","-0.025996","Westferry DLR, Limehouse",501
"8323",2020,11,511,233,209,"51.511066","-0.053558","Sutton Street, Shadwell",442
"8324",2020,11,512,344,308,"51.532091","-0.06142","Pritchard's Road, Bethnal Green",652
"8325",2020,11,513,147,159,"51.5142228","-0.055656","Watney Market, Stepney",306
"8326",2020,11,514,171,191,"51.516204","-0.155525","Portman Square, Marylebone",362
"8327",2020,11,515,89,72,"51.500088","-0.211316","Russell Gardens, Olympia",161
"8328",2020,11,516,114,102,"51.5112","-0.014438","Chrisp Street Market, Poplar",216
"8329",2020,11,517,80,97,"51.532513","-0.033085","Ford Road, Old Ford",177
"8330",2020,11,518,135,128,"51.528224","-0.037471","Antill Road, Mile End",263
"8331",2020,11,519,18,20,"51.518811","-0.011662","Teviot Street, Poplar",38
"8332",2020,11,520,166,142,"51.526041","-0.047218","Bancroft Road, Bethnal Green",308
"8333",2020,11,521,179,167,"51.534137","-0.037366","Driffield Road, Old Ford",346
"8334",2020,11,522,209,206,"51.525941","-0.036017","Clinton Road, Mile End",415
"8335",2020,11,523,32,29,"51.51549","-0.013475","Langdon Park, Poplar",61
"8336",2020,11,524,218,151,"51.511654","-0.179668","Lancaster Gate , Bayswater",369
"8337",2020,11,526,45,33,"51.503143","-0.008428","Lancaster Drive, Blackwall",78
"8338",2020,11,527,107,113,"51.503802","-0.215808","Hansard Mews, Holland Park",220
"8339",2020,11,528,87,102,"51.507326","-0.145827","Clarges Street, Mayfair",189
"8340",2020,11,529,149,145,"51.486892","-0.170983","Manresa Road, Chelsea",294
"8341",2020,11,530,49,55,"51.508896","-0.012413","Newby Place, Poplar",104
"8342",2020,11,531,215,188,"51.530326","-0.042744","Twig Folly Bridge, Mile End",403
"8343",2020,11,532,95,152,"51.50357","-0.020068","Jubilee Plaza, Canary Wharf",247
"8344",2020,11,533,197,171,"51.528222","-0.069743","Wellington Row, Bethnal Green",368
"8345",2020,11,534,249,220,"51.531864","-0.066035","Goldsmith's Row, Haggerston",469
"8346",2020,11,535,179,146,"51.537349","-0.147154","Gloucester Avenue, Camden Town",325
"8347",2020,11,536,125,73,"51.53385","-0.06992","Queensbridge Road, Haggerston",198
"8348",2020,11,537,227,210,"51.51793","-0.067937","Old Montague Street, Whitechapel",437
"8349",2020,11,538,64,64,"51.508981","-0.00699","Naval Row, Blackwall",128
"8350",2020,11,540,201,150,"51.528302","-0.144466","Albany Street, The Regent's Park",351
"8351",2020,11,541,400,401,"51.506613","-0.142844","Green Park Station, Mayfair",801
"8352",2020,11,542,177,153,"51.514115","-0.033828","Salmon Lane, Limehouse",330
"8353",2020,11,543,66,47,"51.509591","-0.204666","Lansdowne Walk, Ladbroke Grove",113
"8354",2020,11,544,166,181,"51.526153","-0.102208","Percival Street, Finsbury",347
"8355",2020,11,545,159,167,"51.539957","-0.145246","Arlington Road, Camden Town",326
"8356",2020,11,546,387,326,"51.517428","-0.107987","New Fetter Lane, Holborn",713
"8357",2020,11,547,81,88,"51.509474","-0.002275","East India DLR, Blackwall",169
"8358",2020,11,548,70,65,"51.498386","-0.107913","Westminster Bridge Road, Elephant & Castle",135
"8359",2020,11,549,204,150,"51.49605","-0.104193","Gaywood  Street, Elephant & Castle",354
"8360",2020,11,550,152,123,"51.521564","-0.039264","Harford Street, Mile End",275
"8361",2020,11,551,116,118,"51.505772","-0.016460175","Import Dock, Canary Wharf",234
"8362",2020,11,552,250,234,"51.511542","-0.056667","Watney Street, Shadwell",484
"8363",2020,11,553,552,527,"51.535678","-0.062546","Regent's Row , Haggerston",1079
"8364",2020,11,554,30,27,"51.513548","-0.005659","Aberfeldy Street, Poplar",57
"8365",2020,11,556,70,66,"51.502661","-0.021596","Heron Quays DLR, Canary Wharf",136
"8366",2020,11,557,132,161,"51.51601","-0.0985","King Edward Street, St Pauls",293
"8367",2020,11,558,47,85,"51.493978","-0.127554","Page Street, Westminster",132
"8368",2020,11,559,51,36,"51.501391","-0.205991","Abbotsbury Road, Holland Park",87
"8369",2020,11,560,59,28,"51.511624","-0.205921","Ladbroke Grove Central, Ladbroke Grove",87
"8370",2020,11,561,109,83,"51.518369","-0.043371","Rectory Square, Stepney",192
"8371",2020,11,562,184,223,"51.51746","-0.12335","Bury Place, Holborn",407
"8372",2020,11,563,53,40,"51.499286","-0.009152","Preston's Road, Cubitt Town",93
"8373",2020,11,564,405,520,"51.509943","-0.117619","Somerset House, Strand",925
"8374",2020,11,565,87,79,"51.521905","-0.063386","Selby Street, Whitechapel",166
"8375",2020,11,566,128,156,"51.509158","-0.224103","Westfield Ariel Way, White City",284
"8376",2020,11,568,293,269,"51.51616","-0.18697","Bishop's Bridge Road West, Bayswater",562
"8377",2020,11,569,217,145,"51.53213","-0.08299","Pitfield Street Central, Hoxton",362
"8378",2020,11,570,179,186,"51.503083","-0.017676","Upper Bank Street, Canary Wharf",365
"8379",2020,11,571,117,116,"51.506256","-0.218337","Westfield Southern Terrace ,Shepherd's Bush",233
"8380",2020,11,572,226,242,"51.539099","-0.141728","Greenland Road, Camden Town",468
"8381",2020,11,573,413,427,"51.485587","-0.18119","Limerston Street, West Chelsea",840
"8382",2020,11,574,500,382,"51.53356","-0.09315","Eagle Wharf Road, Hoxton",882
"8383",2020,11,576,66,52,"51.497304","-0.022793","Alpha Grove, Millwall",118
"8384",2020,11,577,209,194,"51.528869","-0.047548","Globe Town Market, Bethnal Green",403
"8385",2020,11,578,73,93,"51.527607","-0.057133","Hollybush Gardens, Bethnal Green",166
"8386",2020,11,579,362,537,"51.511246","-0.093051","Queen Street 2, Bank",899
"8387",2020,11,580,182,169,"51.48692917","-0.102996299","Doddington Grove, Kennington",351
"8388",2020,11,581,251,288,"51.519167","-0.147983","New Cavendish Street, Marylebone",539
"8389",2020,11,583,249,315,"51.497622","-0.125978","Abingdon Green, Westminster",564
"8390",2020,11,584,175,151,"51.51244","-0.19096","Ilchester Gardens, Bayswater",326
"8391",2020,11,586,41,27,"51.490645","-0.014582","Mudchute DLR, Cubitt Town",68
"8392",2020,11,587,373,421,"51.50964","-0.08497","Monument Street, Monument",794
"8393",2020,11,588,144,149,"51.52959","-0.0801","Hoxton Street, Hoxton",293
"8394",2020,11,589,280,266,"51.487196","-0.179369","Drayton Gardens, West Chelsea",546
"8395",2020,11,590,59,31,"51.53256","-0.16862","Greenberry Street, St.John's Wood",90
"8396",2020,11,592,107,75,"51.5171","-0.18377","Bishop's Bridge Road East, Bayswater",182
"8397",2020,11,593,151,141,"51.531066","-0.11934","Northdown Street, King's Cross",292
"8398",2020,11,594,184,207,"51.513875","-0.117774","Kingsway Southbound, Strand",391
"8399",2020,11,595,246,244,"51.493267","-0.21985","Hammersmith Road, Hammersmith",490
"8400",2020,11,596,240,247,"51.472817","-0.199783","Parson's Green , Parson's Green",487
"8401",2020,11,597,150,127,"51.473471","-0.20782","Fulham Park Road, Fulham",277
"8402",2020,11,598,139,129,"51.494499","-0.228188","Southerton Road, Hammersmith",268
"8403",2020,11,599,81,78,"51.485743","-0.223616","Manbre Road, Hammersmith",159
"8404",2020,11,600,239,235,"51.481747","-0.124642","South Lambeth Road, Vauxhall",474
"8405",2020,11,601,167,179,"51.514767","-0.225787","BBC White City, White City",346
"8406",2020,11,602,216,196,"51.472993","-0.133972","Union Grove, Wandsworth Road",412
"8407",2020,11,603,208,187,"51.477839","-0.116493","Caldwell Street, Stockwell",395
"8408",2020,11,604,72,69,"51.538792","-0.138535","St Martins Close, Camden Town",141
"8409",2020,11,605,205,200,"51.520331","-0.163667","Seymour Place, Marylebone",405
"8410",2020,11,606,93,87,"51.504199","-0.210941","Addison Road, Holland Park",180
"8411",2020,11,607,156,165,"51.468814","-0.210279","Putney Bridge Station, Fulham",321
"8412",2020,11,608,9,18,"51.491093","-0.216493","Colet Gardens, Hammersmith",27
"8413",2020,11,609,98,76,"51.46512358","-0.157788279","Sugden Road, Clapham",174
"8414",2020,11,610,131,140,"51.48256792","-0.172078187","Danvers Street, West Chelsea",271
"8415",2020,11,611,94,80,"51.50646524","-0.208486599","Princedale Road , Holland Park",174
"8416",2020,11,612,165,156,"51.46925984","-0.141812513","Wandsworth Rd, Isley Court, Wandsworth Road",321
"8417",2020,11,613,307,304,"51.50403821","-0.217400093","Woodstock Grove, Shepherd's Bush",611
"8418",2020,11,614,111,81,"51.47817208","-0.144690541","Bradmead, Battersea Park",192
"8419",2020,11,615,119,106,"51.4768851","-0.215895601","Finlay Street, Fulham",225
"8420",2020,11,616,171,143,"51.48102131","-0.209973497","Aintree Street, Fulham",314
"8421",2020,11,617,82,68,"51.47107905","-0.207842908","Elysium Place, Fulham",150
"8422",2020,11,618,144,134,"51.47625965","-0.193254007","Eel Brook Common, Walham Green",278
"8423",2020,11,619,157,112,"51.4737636","-0.197010096","Irene Road, Parsons Green",269
"8424",2020,11,620,154,115,"51.47518024","-0.167160736","Surrey Lane, Battersea",269
"8425",2020,11,621,217,230,"51.46086446","-0.187427294","Wandsworth Town Station, Wandsworth",447
"8426",2020,11,622,178,176,"51.50748124","-0.205535908","Lansdowne Road, Ladbroke Grove",354
"8427",2020,11,623,63,54,"51.46193072","-0.180791784","Nantes Close, Wandsworth",117
"8428",2020,11,624,165,124,"51.4729184","-0.132102704","Courland Grove, Wandsworth Road",289
"8429",2020,11,625,239,238,"51.47761941","-0.149551631","Queen's Circus, Battersea Park",477
"8430",2020,11,626,237,239,"51.48438657","-0.20481514","Normand Park, West Kensington",476
"8431",2020,11,627,69,60,"51.4687905","-0.158230901","Holden Street, Battersea",129
"8432",2020,11,628,194,190,"51.46881971","-0.184318843","William Morris Way, Sands End",384
"8433",2020,11,629,47,32,"51.45995384","-0.190184054","Morie Street, Wandsworth",79
"8434",2020,11,630,89,82,"51.47073264","-0.126994068","Clarence Walk, Stockwell",171
"8435",2020,11,631,198,175,"51.4795017","-0.141770709","Battersea Park Road, Nine Elms",373
"8436",2020,11,632,109,101,"51.47053858","-0.163041605","Sheepcote Lane, Battersea",210
"8437",2020,11,633,157,146,"51.48959104","-0.209378594","Vereker Road, West Kensington",303
"8438",2020,11,634,130,117,"51.49434708","-0.215804559","Brook Green South, Brook Green",247
"8439",2020,11,635,167,149,"51.48606206","-0.214428378","Greyhound Road, Hammersmith",316
"8440",2020,11,636,181,161,"51.46706414","-0.193502076","South Park, Sands End",342
"8441",2020,11,637,53,26,"51.45787019","-0.174691623","Spencer Park, Wandsworth Common",79
"8442",2020,11,638,382,386,"51.46663393","-0.169821175","Falcon Road, Clapham Junction",768
"8443",2020,11,639,185,174,"51.48357068","-0.202038682","Coomer Place, West Kensington",359
"8444",2020,11,640,161,146,"51.47286577","-0.148059277","Silverthorne Road, Battersea",307
"8445",2020,11,641,105,98,"51.49824168","-0.117495865","Archbishop's Park, Waterloo",203
"8446",2020,11,642,65,58,"51.46916161","-0.174485792","Fawcett Close, Battersea",123
"8447",2020,11,643,81,57,"51.5190427","-0.204764421","All Saints' Road, Portobello",138
"8448",2020,11,644,170,162,"51.48373225","-0.223852256","Rainville Road, Hammersmith",332
"8449",2020,11,645,225,223,"51.50173215","-0.100292412","Great Suffolk Street, The Borough",448
"8450",2020,11,646,203,238,"51.49886563","-0.137424571","Buckingham Gate, Westminster",441
"8451",2020,11,647,129,123,"51.50035306","-0.217515071","Richmond Way, Shepherd's Bush",252
"8452",2020,11,648,102,72,"51.46904022","-0.19627483","Peterborough Road, Sands End",174
"8453",2020,11,649,158,156,"51.48180515","-0.18027465","World's End Place, West Chelsea",314
"8454",2020,11,650,130,124,"51.51687069","-0.213872396","St. Mark's Road, North Kensington",254
"8455",2020,11,651,109,88,"51.48089844","-0.183853573","Thorndike Close, West Chelsea",197
"8456",2020,11,652,52,60,"51.51148696","-0.218190203","Evesham Street, Avondale",112
"8457",2020,11,653,214,215,"51.47084722","-0.17070367","Simpson Street, Clapham Junction",429
"8458",2020,11,654,176,163,"51.48267821","-0.117661574","Ashmole Estate, Oval",339
"8459",2020,11,655,103,102,"51.48294452","-0.219346128","Crabtree Lane, Fulham",205
"8460",2020,11,656,81,63,"51.46841875","-0.199135704","Broomhouse Lane, Parsons Green",144
"8461",2020,11,657,92,86,"51.4996806","-0.221791552","Blythe Road West, Shepherd's Bush",178
"8462",2020,11,658,297,283,"51.47729232","-0.16478637","Ethelburga Estate, Battersea Park",580
"8463",2020,11,659,289,330,"51.511934","-0.10307894","Blackfriars Station, St. Paul's",619
"8464",2020,11,660,120,117,"51.49087074","-0.206029743","West Kensington Station, West Kensington",237
"8465",2020,11,661,231,225,"51.51632095","-0.202608612","All Saints Church, Portobello",456
"8466",2020,11,662,171,193,"51.48498496","-0.167919869","Phene Street, Chelsea",364
"8467",2020,11,663,84,81,"51.51323001","-0.211593602","Clarendon Road, Avondale",165
"8468",2020,11,664,165,161,"51.474376","-0.155442787","Austin Road, Battersea Park",326
"8469",2020,11,665,100,94,"51.46108367","-0.191722864","Smugglers Way, Wandsworth",194
"8470",2020,11,666,130,113,"51.49610093","-0.208158259","Olympia Way, Olympia",243
"8471",2020,11,667,97,98,"51.5015946","-0.222293381","Shepherd's Bush Road North, Shepherd's Bush",195
"8472",2020,11,668,199,204,"51.49422354","-0.236769936","Ravenscourt Park Station, Hammersmith",403
"8473",2020,11,669,116,90,"51.47614939","-0.1232585","Teversham Lane, Stockwell",206
"8474",2020,11,670,159,156,"51.46718562","-0.152248582","Ashley Crescent, Battersea",315
"8475",2020,11,671,348,343,"51.475089","-0.201968","Parsons Green Station, Parsons Green",691
"8476",2020,11,673,172,173,"51.46517078","-0.18038939","Hibbert Street, Battersea",345
"8477",2020,11,674,158,112,"51.53546778","-0.11619105","Carnegie Street, King's Cross",270
"8478",2020,11,675,98,94,"51.46348914","-0.182126248","Usk Road, Clapham Junction",192
"8479",2020,11,676,199,201,"51.47787084","-0.126874471","Hartington Road, Stockwell",400
"8480",2020,11,677,84,59,"51.46866929","-0.146544642","Heath Road, Battersea",143
"8481",2020,11,678,52,45,"51.46231278","-0.211468596","Esmond Street, Putney",97
"8482",2020,11,679,166,140,"51.47453545","-0.170210533","Orbel Street, Battersea",306
"8483",2020,11,680,353,322,"51.47768469","-0.170329317","Westbridge Road, Battersea",675
"8484",2020,11,681,176,166,"51.47303687","-0.214749808","Bishop's Avenue, Fulham",342
"8485",2020,11,682,243,228,"51.48810829","-0.22660621","Crisp Road, Hammersmith",471
"8486",2020,11,683,106,102,"51.46506424","-0.163750945","Dorothy Road, Clapham Junction",208
"8487",2020,11,684,114,96,"51.45475251","-0.195197203","Neville Gill Close, Wandsworth",210
"8488",2020,11,685,173,169,"51.46067005","-0.198735357","Osiers Road, Wandsworth",342
"8489",2020,11,686,136,130,"51.48814438","-0.222456468","Beryl Road, Hammersmith",266
"8490",2020,11,687,185,176,"51.49760804","-0.21145598","Maclise Road, Olympia",361
"8491",2020,11,688,70,60,"51.46095151","-0.20066766","Northfields, Wandsworth",130
"8492",2020,11,689,38,18,"51.45922541","-0.180884959","Spanish Road, Clapham Junction",56
"8493",2020,11,690,93,73,"51.47047503","-0.152130083","Stanley Grove, Battersea",166
"8494",2020,11,691,203,198,"51.47946386","-0.195777222","Erin Close, Walham Green",401
"8495",2020,11,692,180,170,"51.54211855","-0.028941601","Cadogan Close, Victoria Park",350
"8496",2020,11,693,101,94,"51.464786","-0.215618902","Felsham Road, Putney",195
"8497",2020,11,694,47,47,"51.46071722","-0.216526155","Putney Rail Station, Putney",94
"8498",2020,11,695,452,420,"51.53638435","-0.102757578","Islington Green, Angel",872
"8499",2020,11,696,157,166,"51.48728535","-0.217995921","Charing Cross Hospital, Hammersmith",323
"8500",2020,11,697,155,91,"51.53639219","-0.112721065","Charlotte Terrace, Angel",246
"8501",2020,11,698,153,119,"51.53908372","-0.070329419","Shoreditch Court, Haggerston",272
"8502",2020,11,699,118,96,"51.5366541","-0.07023031","Belford House, Haggerston",214
"8503",2020,11,700,164,143,"51.47696496","-0.174347066","Battersea Church Road, Battersea",307
"8504",2020,11,701,233,224,"51.47287627","-0.176267008","Vicarage Crescent, Battersea",457
"8505",2020,11,702,195,142,"51.52868155","-0.065550321","Durant Street, Bethnal Green",337
"8506",2020,11,703,309,416,"51.51505991","-0.10534448","St. Bride Street, Holborn",725
"8507",2020,11,704,37,27,"51.45682071","-0.202802098","Mexfield Road, East Putney",64
"8508",2020,11,705,62,60,NA,NA,NA,122
"8509",2020,11,706,254,252,"51.50215353","-0.083632928","Snowsfields, London Bridge",506
"8510",2020,11,707,257,235,"51.49021762","-0.215087092","Barons Court Station, West Kensington",492
"8511",2020,11,708,82,81,"51.46161068","-0.21614583","Disraeli Road, Putney",163
"8512",2020,11,709,78,69,"51.46321128","-0.215550761","Montserrat Road , Putney",147
"8513",2020,11,710,171,178,"51.47439218","-0.163347594","Albert Bridge Road, Battersea Park",349
"8514",2020,11,711,104,96,"51.48335692","-0.216305546","Everington Street, Fulham",200
"8515",2020,11,712,173,154,"51.51854104","-0.034903714","Mile End Stadium, Mile End",327
"8516",2020,11,713,97,95,"51.54100708","-0.14326094","Hawley Crescent, Camden Town",192
"8517",2020,11,714,95,82,"51.47311696","-0.137235175","Stewart's Road, Wandsworth Road",177
"8518",2020,11,715,122,87,"51.51563007","-0.049067243","Aylward Street, Stepney",209
"8519",2020,11,716,104,104,"51.51542791","-0.02356501","Stainsby Road , Poplar",208
"8520",2020,11,717,450,377,"51.53658514","-0.075885686","Dunston Road , Haggerston",827
"8521",2020,11,718,211,221,"51.53571683","-0.060291813","Ada Street, Hackney Central",432
"8522",2020,11,719,259,248,"51.53642464","-0.054162264","Victoria Park Road, Hackney Central",507
"8523",2020,11,720,127,112,"51.48724429","-0.205279052","Star Road, West Kensington",239
"8524",2020,11,721,82,78,"51.53603947","-0.026262677","Wendon Street, Old Ford",160
"8525",2020,11,722,147,129,"51.52458353","-0.058631453","Finnis Street, Bethnal Green",276
"8526",2020,11,723,235,221,"51.46822047","-0.190346493","Stephendale Road, Sands End",456
"8527",2020,11,724,59,47,"51.45799126","-0.184806157","Alma Road, Wandsworth",106
"8528",2020,11,725,236,243,"51.491327","-0.096518684","Walworth Square, Walworth",479
"8529",2020,11,726,205,178,"51.47505096","-0.150908371","Alfreda Street, Battersea Park",383
"8530",2020,11,727,179,159,"51.47569809","-0.20587627","Chesilton Road, Fulham",338
"8531",2020,11,728,70,57,"51.46199911","-0.206240805","Putney Bridge Road, East Putney",127
"8532",2020,11,729,243,249,"51.47893931","-0.208485293","St. Peter's Terrace, Fulham",492
"8533",2020,11,730,178,192,"51.49208492","-0.229116862","Bridge Avenue, Hammersmith",370
"8534",2020,11,731,162,168,"51.47727637","-0.189210466","Michael Road, Walham Green",330
"8535",2020,11,732,681,754,"51.50630441","-0.087262995","Duke Street Hill, London Bridge",1435
"8536",2020,11,733,128,134,"51.50542628","-0.150817316","Park Lane, Mayfair",262
"8537",2020,11,734,58,49,"51.46230566","-0.175407201","Plough Terrace, Clapham Junction",107
"8538",2020,11,735,210,218,"51.46489445","-0.17302926","Grant Road East, Clapham Junction",428
"8539",2020,11,736,54,50,"51.50659035","-0.216104479","Queensdale Road, Shepherd's Bush",104
"8540",2020,11,737,473,480,"51.47993289","-0.19411695","Fulham Broadway, Walham Green",953
"8541",2020,11,738,156,161,"51.47514228","-0.187278987","Imperial Road, Sands End",317
"8542",2020,11,739,113,123,"51.48176572","-0.185273723","Hortensia Road, West Brompton",236
"8543",2020,11,740,44,45,"51.51092871","-0.214594781","Sirdar Road, Avondale",89
"8544",2020,11,741,49,58,"51.5129814","-0.219486603","Freston Road, Avondale",107
"8545",2020,11,742,130,117,"51.51510818","-0.208565479","Blenheim Crescent, Ladbroke Grove",247
"8546",2020,11,743,38,32,"51.46079243","-0.212607684","Oxford Road, Putney",70
"8547",2020,11,744,52,54,"51.46745485","-0.172293499","Ingrave Street, Clapham Junction",106
"8548",2020,11,745,138,125,"51.47816972","-0.18243547","Upcerne Road, West Chelsea",263
"8549",2020,11,746,145,143,"51.4795738","-0.17903854","Lots Road, West Chelsea",288
"8550",2020,11,747,140,153,"51.48796408","-0.161765173","Ormonde Gate, Chelsea",293
"8551",2020,11,748,263,184,"51.53727795","-0.079201849","Hertford Road, De Beauvoir Town",447
"8552",2020,11,749,259,237,"51.53932857","-0.074284675","Haggerston Road, Haggerston",496
"8553",2020,11,750,72,54,"51.4710956","-0.157850096","Culvert Road, Battersea",126
"8554",2020,11,751,122,151,"51.51612862","-0.120909408","Newton Street, Covent Garden",273
"8555",2020,11,754,71,74,"51.5129006","-0.214762686","Grenfell Road, Avondale",145
"8556",2020,11,755,232,209,"51.48512191","-0.174971902","The Vale, Chelsea",441
"8557",2020,11,756,127,132,"51.47515398","-0.159169801","Prince of Wales Drive, Battersea Park",259
"8558",2020,11,757,215,181,"51.48795853","-0.187404506","Harcourt Terrace, West Brompton",396
"8559",2020,11,758,134,103,"51.51787005","-0.201005397","Westbourne Park Road, Portobello",237
"8560",2020,11,759,77,72,"51.52456169","-0.165668686","Broadley Terrace, Marylebone",149
"8561",2020,11,760,121,89,"51.52526975","-0.163795009","Rossmore Road, Marylebone",210
"8562",2020,11,761,146,141,"51.48321729","-0.211860644","Humbolt Road, Fulham",287
"8563",2020,11,762,459,486,"51.50070305","-0.129698963","Storey's Gate, Westminster",945
"8564",2020,11,763,169,140,"51.52059714","-0.032566533","Mile End Park Leisure Centre, Mile End",309
"8565",2020,11,764,162,191,"51.46239255","-0.16829214","St. John's Road, Clapham Junction",353
"8566",2020,11,765,86,83,"51.46760141","-0.20682737","Ranelagh Gardens, Fulham",169
"8567",2020,11,766,190,204,"51.45752945","-0.192165613","Ram Street, Wandsworth",394
"8568",2020,11,767,38,19,"51.45705988","-0.200806304","Santos Road, Wandsworth",57
"8569",2020,11,768,152,156,"51.46134382","-0.159322467","Clapham Common North Side, Clapham Common",308
"8570",2020,11,769,195,181,"51.473611","-0.191803","Sandilands Road, Walham Green",376
"8571",2020,11,770,91,90,"51.491026","-0.209121","Gwendwr Road, West Kensington",181
"8572",2020,11,771,54,59,"51.509224","-0.216016","Rifle Place, Avondale",113
"8573",2020,11,772,346,309,"51.47250956","-0.122831913","Binfield Road, Stockwell",655
"8574",2020,11,773,350,405,"51.511891","-0.107349","Tallis Street, Temple",755
"8575",2020,11,774,58,43,"51.470131","-0.20464","Hurlingham Park, Parsons Green",101
"8576",2020,11,775,130,129,"51.496664","-0.223868","Little Brook Green, Brook Green",259
"8577",2020,11,776,89,91,"51.460333","-0.167029","Abyssinia Close, Clapham Junction",180
"8578",2020,11,777,49,40,"51.4619230679","-0.165297856693","Limburg Road, Clapham Junction",89
"8579",2020,11,779,232,249,"51.514449","-0.077178979","Houndsditch, Aldgate",481
"8580",2020,11,780,247,253,"51.474665","-0.18316517","Imperial Wharf Station, Sands End",500
"8581",2020,11,781,183,213,"51.495898","-0.173009","Victoria & Albert Museum, South Kensington",396
"8582",2020,11,782,159,142,"51.483911","-0.19760944","Halford Road, West Kensington",301
"8583",2020,11,783,213,228,"51.5403115","-0.021630359","Monier Road, Hackney Wick",441
"8584",2020,11,784,152,156,"51.546326","-0.00993526","East Village, Queen Elizabeth Olympic Park",308
"8585",2020,11,785,492,465,"51.54094","-0.010510565","Aquatic Centre, Queen Elizabeth Olympic Park",957
"8586",2020,11,786,129,128,"51.549369","-0.015717614","Lee Valley VeloPark, Queen Elizabeth Olympic Park",257
"8587",2020,11,787,113,110,"51.546805","-0.01469126","Timber Lodge, Queen Elizabeth Olympic Park",223
"8588",2020,11,789,147,164,"51.538718","-0.011889482","Podium, Queen Elizabeth Olympic Park",311
"8589",2020,11,790,177,186,"51.541793","-0.00481","Stratford Station, Stratford",363
"8590",2020,11,792,207,212,"51.505461","-0.10454093","Blackfriars Road, Southwark",419
"8591",2020,11,793,72,85,"51.528279","-0.11955857","Cromer Street, Bloomsbury",157
"8592",2020,11,795,153,152,"51.527068","-0.13186102","Euston Square Gardens, Euston",305
"8593",2020,11,796,168,148,"51.524","-0.12640984","Coram Street, Bloomsbury",316
"8594",2020,11,797,243,244,"51.5293","-0.12827903","Ossulston Street, Somers Town",487
"8595",2020,11,798,284,291,"51.5301998755","-0.122299440803","Birkenhead Street, King's Cross",575
"8596",2020,11,799,171,245,"51.4976984561","-0.137598896295","Kings Gate House, Westminster",416
"8597",2020,11,800,231,229,"51.4811219398","-0.149035374873","Sopwith Way, Battersea Park",460
"8598",2020,11,801,277,293,"51.5052241745","-0.0980318118664","Lavington Street, Bankside",570
"8599",2020,11,802,182,148,"51.4765900593","-0.118256789081","Albert Square, Stockwell",330
"8600",2020,11,803,172,188,"51.5054099403","-0.0983410884509","Southwark Street, Bankside",360
"8601",2020,11,804,228,271,"51.5346677396","-0.125078652873","Good's Way, King's Cross",499
"8602",2020,11,806,218,217,"51.5372405623","-0.124807385707","Handyside Street, King's Cross",435
"8603",2020,11,807,180,180,"51.5212","-0.20888818","Bevington Road West, North Kensington",360
"8604",2020,11,809,187,230,"51.5162778834","-0.118272991635","Lincoln's Inn Fields, Holborn",417
"8605",2020,11,810,319,322,"51.5067252868","-0.0988072461627","Tate Modern, Bankside",641
"8606",2020,11,811,262,253,"51.5057030357","-0.0277727426235","Westferry Circus, Canary Wharf",515
"8607",2020,11,812,77,76,"51.5487311915","-0.0226065549321","Here East North, Queen Elizabeth Olympic Park",153
"8608",2020,11,813,169,169,"51.4878074485","-0.122759625866","New Spring Gardens Walk, Vauxhall",338
"8609",2020,11,814,110,87,"51.4714330677","-0.123670735702","Clapham Road, Lingham Street, Stockwell",197
"8610",2020,11,815,338,309,"51.5000891978","-0.116628700672","Lambeth Palace Road, Waterloo",647
"8611",2020,11,816,54,58,"51.5465327935","-0.0205975904647","Here East South, Queen Elizabeth Olympic Park",112
"8612",2020,11,817,208,195,"51.4813354746","-0.138212295869","Riverlight South, Nine Elms",403
"8613",2020,11,818,457,491,"51.501513","-0.12382322","Westminster Pier, Westminster",948
"8614",2020,11,819,130,142,"51.50621","-0.114842","Belvedere Road 2, South Bank",272
"8615",2020,11,820,129,103,"51.492807","-0.091938","Victory Place, Walworth",232
"8616",2020,11,821,456,446,"51.4835074867","-0.147714557371","Battersea Power Station, Battersea Park",902
"8617",2020,11,826,525,518,"51.496863","-0.1429434","Allington Street, Victoria",1043
"8618",2020,11,827,217,216,"51.479601","-0.11147178","Cranmer Road, Stockwell",433
"8619",2020,11,828,159,148,"51.473874","-0.11258096","Normandy Road, Stockwell",307
"8620",2020,11,829,82,53,"51.469217","-0.11268674","Wynne Road, Stockwell",135
"8621",2020,11,830,121,104,"51.469202","-0.11902256","Sidney Road, Stockwell",225
"8622",2020,11,831,113,118,"51.466232","-0.11317995","St John's Crescent, Brixton",231
"8623",2020,11,832,183,183,"51.464019","-0.11578197","Ferndale Road, Brixton",366
"8624",2020,11,833,156,179,"51.460232","-0.11537509","Saltoun Road, Brixton",335
"8625",2020,11,834,203,210,"51.477966","-0.14785703","Gas Holders, Battersea Park",413
"8626",2020,11,835,183,183,"51.516785","-0.10494775","Farringdon Street, Holborn",366
"8627",2020,11,836,169,136,"51.541596","-0.12544145","York Way, Kings Cross",305
"8628",2020,11,838,175,189,"51.518093","-0.0914017","Fore Street Avenue, Guildhall",364
"8629",2020,11,839,326,332,"51.508033","-0.10682363","Sea Containers, South Bank",658
"8630",2020,12,1,114,88,"51.52916347","-0.109970527","River Street , Clerkenwell",202
"8631",2020,12,2,203,236,"51.49960695","-0.197574246","Phillimore Gardens, Kensington",439
"8632",2020,12,3,88,85,"51.52128377","-0.084605692","Christopher Street, Liverpool Street",173
"8633",2020,12,4,63,86,"51.53005939","-0.120973687","St. Chad's Street, King's Cross",149
"8634",2020,12,5,186,222,"51.49313","-0.156876","Sedding Street, Sloane Square",408
"8635",2020,12,6,164,155,"51.51811784","-0.144228881","Broadcasting House, Marylebone",319
"8636",2020,12,7,114,111,"51.53430039","-0.1680743","Charlbert Street, St. John's Wood",225
"8637",2020,12,8,213,198,"51.529857","-0.18348604","Maida Vale, Maida Vale",411
"8638",2020,12,9,135,142,"51.5073853","-0.096440751","New Globe Walk, Bankside",277
"8639",2020,12,10,63,68,"51.50597426","-0.092754157","Park Street, Bankside",131
"8640",2020,12,11,171,161,"51.52395143","-0.122502346","Brunswick Square, Bloomsbury",332
"8641",2020,12,12,193,226,"51.52168078","-0.130431727","Malet Street, Bloomsbury",419
"8642",2020,12,13,88,99,"51.51991453","-0.136039674","Scala Street, Fitzrovia",187
"8643",2020,12,14,620,563,"51.52994371","-0.123616824","Belgrove Street , King's Cross",1183
"8644",2020,12,15,106,118,"51.51772703","-0.127854211","Great Russell Street, Bloomsbury",224
"8645",2020,12,16,173,154,"51.52635795","-0.125979294","Cartwright Gardens , Bloomsbury",327
"8646",2020,12,17,206,241,"51.5216612","-0.109006325","Hatton Wall, Holborn",447
"8647",2020,12,18,165,179,"51.51477076","-0.12221963","Drury Lane, Covent Garden",344
"8648",2020,12,19,112,99,"51.52505093","-0.131161087","Taviton Street, Bloomsbury",211
"8649",2020,12,20,101,64,"51.527326","-0.13605286","Drummond Street , Euston",165
"8650",2020,12,21,56,50,"51.53007835","-0.13884627","Hampstead Road (Cartmel), Euston",106
"8651",2020,12,22,190,194,"51.5222641","-0.114079481","Northington Street , Holborn",384
"8652",2020,12,23,89,84,"51.51943538","-0.119123345","Red Lion Square, Holborn",173
"8653",2020,12,24,163,177,"51.51908011","-0.124678402","British Museum, Bloomsbury",340
"8654",2020,12,25,177,179,"51.5288338","-0.132250369","Doric Way , Somers Town",356
"8655",2020,12,26,94,77,"51.52728093","-0.11829517","Ampton Street , Clerkenwell",171
"8656",2020,12,27,145,185,"51.51382102","-0.107927706","Bouverie Street, Temple",330
"8657",2020,12,28,179,176,"51.52351808","-0.143613641","Bolsover Street, Fitzrovia",355
"8658",2020,12,29,21,17,"51.513735","-0.193487","Hereford Road, Bayswater",38
"8659",2020,12,30,134,139,"51.52915444","-0.093421615","Windsor Terrace, Hoxton",273
"8660",2020,12,31,124,136,"51.52953709","-0.083353323","Fanshaw Street, Hoxton",260
"8661",2020,12,32,182,222,"51.52469624","-0.084439283","Leonard Circus , Shoreditch",404
"8662",2020,12,33,78,76,"51.5156","-0.070056","Central House, Aldgate",154
"8663",2020,12,34,74,64,"51.5341235","-0.129386874","Pancras Road, King's Cross",138
"8664",2020,12,36,194,190,"51.50173726","-0.184980612","De Vere Gardens, Kensington",384
"8665",2020,12,37,163,159,"51.49159394","-0.192369256","Penywern Road, Earl's Court",322
"8666",2020,12,38,121,115,"51.4973875","-0.197245586","Abingdon Villas, Kensington",236
"8667",2020,12,39,239,268,"51.5263778","-0.078130921","Shoreditch High Street, Shoreditch",507
"8668",2020,12,40,83,93,"51.52127071","-0.0755789","Commercial Street, Shoreditch",176
"8669",2020,12,41,139,133,"51.520955","-0.083493552","Pindar Street, Liverpool Street",272
"8670",2020,12,42,157,151,"51.53099181","-0.093903825","Wenlock Road , Hoxton",308
"8671",2020,12,43,156,165,"51.52026","-0.157183945","Crawford Street, Marylebone",321
"8672",2020,12,44,103,100,"51.51073687","-0.144165239","Bruton Street, Mayfair",203
"8673",2020,12,45,209,174,"51.522511","-0.162298","Boston Place, Marylebone",383
"8674",2020,12,46,373,366,"51.507131","-0.06691","Nesham Street, Wapping",739
"8675",2020,12,47,291,272,"51.52334476","-0.183846408","Warwick Avenue Station, Maida Vale",563
"8676",2020,12,48,161,184,"51.51248445","-0.099141408","Godliman Street, St. Paul's",345
"8677",2020,12,49,95,107,"51.50706909","-0.145904427","Curzon Street, Mayfair",202
"8678",2020,12,50,122,98,"51.52867339","-0.087459376","East Road, Hoxton",220
"8679",2020,12,51,91,108,"51.52671796","-0.104298194","Finsbury Library , Finsbury",199
"8680",2020,12,52,108,119,"51.52295439","-0.094934859","Roscoe Street, St. Luke's",227
"8681",2020,12,53,86,83,"51.5099923","-0.143495266","Grafton Street, Mayfair",169
"8682",2020,12,54,140,118,"51.52174785","-0.094475072","Golden Lane, Barbican",258
"8683",2020,12,55,259,279,"51.51707521","-0.086685542","Finsbury Circus, Liverpool Street",538
"8684",2020,12,56,96,117,"51.52058381","-0.154701411","Paddington Street, Marylebone",213
"8685",2020,12,57,160,141,"51.52334672","-0.120202614","Guilford Street , Bloomsbury",301
"8686",2020,12,58,180,181,"51.52452699","-0.079248081","New Inn Yard, Shoreditch",361
"8687",2020,12,60,87,73,"51.52644828","-0.172190727","Lisson Grove, St. John's Wood",160
"8688",2020,12,61,140,142,"51.49738251","-0.089446947","Great Dover Street, The Borough",282
"8689",2020,12,62,118,108,"51.4907579","-0.106323685","Cotton Garden Estate, Kennington",226
"8690",2020,12,63,103,84,"51.53089041","-0.089782579","Murray Grove , Hoxton",187
"8691",2020,12,64,205,288,"51.50946212","-0.124749274","William IV Street, Strand",493
"8692",2020,12,65,105,97,NA,NA,NA,202
"8693",2020,12,66,222,304,"51.51795029","-0.108657431","Holborn Circus, Holborn",526
"8694",2020,12,67,160,145,"51.51882555","-0.108028472","Hatton Garden, Holborn",305
"8695",2020,12,68,175,176,"51.52059681","-0.116688468","Theobald's Road , Holborn",351
"8696",2020,12,69,88,99,"51.5262363","-0.134407652","Euston Road, Euston",187
"8697",2020,12,70,48,32,"51.53136059","-0.117069978","Calshot Street , King's Cross",80
"8698",2020,12,71,261,253,"51.5154186","-0.098850915","Newgate Street , St. Paul's",514
"8699",2020,12,72,80,86,"51.52352001","-0.108340165","Farringdon Lane, Clerkenwell",166
"8700",2020,12,73,212,213,"51.52572618","-0.088486188","Old Street Station, St. Luke's",425
"8701",2020,12,74,389,392,"51.48591714","-0.124469948","Vauxhall Cross, Vauxhall",781
"8702",2020,12,75,116,115,"51.53219984","-0.105480698","Torrens Street, Angel",231
"8703",2020,12,76,98,89,"51.52559505","-0.144083893","Longford Street, The Regent's Park",187
"8704",2020,12,77,152,174,"51.52341837","-0.124121774","Russell Square Station, Bloomsbury",326
"8705",2020,12,78,135,133,"51.52486887","-0.099489485","Sadlers Sports Centre, Finsbury",268
"8706",2020,12,79,82,99,"51.511726","-0.11385596","Arundel Street, Temple",181
"8707",2020,12,80,172,165,"51.50069361","-0.102091246","Webber Street , Southwark",337
"8708",2020,12,81,150,152,"51.52025302","-0.141327271","Great Titchfield Street, Fitzrovia",302
"8709",2020,12,82,93,100,"51.514274","-0.111257","Chancery Lane, Holborn",193
"8710",2020,12,83,126,146,"51.50963938","-0.131510949","Panton Street, West End",272
"8711",2020,12,84,93,101,"51.51593725","-0.111778348","Breams Buildings, Holborn",194
"8712",2020,12,85,210,226,"51.50064702","-0.078600401","Tanner Street, Bermondsey",436
"8713",2020,12,86,133,131,"51.48947903","-0.115156562","Sancroft Street, Vauxhall",264
"8714",2020,12,87,131,132,"51.51646835","-0.079684557","Devonshire Square, Liverpool Street",263
"8715",2020,12,88,222,270,"51.51858757","-0.132053392","Bayley Street , Bloomsbury",492
"8716",2020,12,89,145,117,"51.5262503","-0.123509611","Tavistock Place, Bloomsbury",262
"8717",2020,12,90,31,41,"51.53301907","-0.139174593","Harrington Square 1, Camden Town",72
"8718",2020,12,91,190,161,"51.49368637","-0.111014912","Walnut Tree Walk, Vauxhall",351
"8719",2020,12,92,135,143,"51.49889832","-0.100440521","Borough Road, Elephant & Castle",278
"8720",2020,12,93,143,93,"51.53440868","-0.109025404","Cloudesley Road, Angel",236
"8721",2020,12,94,251,240,"51.49506109","-0.085814489","Bricklayers Arms, Borough",491
"8722",2020,12,95,242,263,"51.5208417","-0.097340162","Aldersgate Street, Barbican",505
"8723",2020,12,96,149,120,"51.53095071","-0.078505384","Falkirk Street, Hoxton",269
"8724",2020,12,97,166,176,"51.49792478","-0.183834706","Gloucester Road (North), Kensington",342
"8725",2020,12,98,148,146,"51.52554222","-0.138231303","Hampstead Road, Euston",294
"8726",2020,12,99,229,255,"51.51457763","-0.158264483","Old Quebec Street, Marylebone",484
"8727",2020,12,100,132,152,"51.49043573","-0.122806861","Albert Embankment, Vauxhall",284
"8728",2020,12,101,309,337,"51.51155322","-0.0929401","Queen Street 1, Bank",646
"8729",2020,12,102,147,145,"51.51340693","-0.076793375","Jewry Street, Aldgate",292
"8730",2020,12,103,95,80,"51.50472376","-0.192538767","Vicarage Gate, Kensington",175
"8731",2020,12,104,326,348,"51.51159481","-0.077121322","Crosswall, Tower",674
"8732",2020,12,105,181,162,"51.51552971","-0.190240716","Westbourne Grove, Bayswater",343
"8733",2020,12,106,59,62,"51.51410514","-0.147301667","Woodstock Street, Mayfair",121
"8734",2020,12,107,269,248,"51.52600832","-0.096317627","Finsbury Leisure Centre, St. Luke's",517
"8735",2020,12,108,140,152,"51.49812559","-0.132102166","Abbey Orchard Street, Westminster",292
"8736",2020,12,109,248,270,"51.51563144","-0.132328837","Soho Square , Soho",518
"8737",2020,12,110,154,134,"51.53304322","-0.172528678","Wellington Road, St. John's Wood",288
"8738",2020,12,111,299,301,"51.5100172","-0.157275636","Park Lane , Hyde Park",600
"8739",2020,12,112,79,107,"51.51580998","-0.105270275","Stonecutter Street, Holborn",186
"8740",2020,12,113,135,126,"51.49646288","-0.183289032","Gloucester Road (Central), South Kensington",261
"8741",2020,12,114,192,210,"51.52451738","-0.158963647","Park Road (Baker Street), The Regent's Park",402
"8742",2020,12,115,204,221,"51.51423368","-0.073537654","Braham Street, Aldgate",425
"8743",2020,12,116,229,236,"51.51449962","-0.141423695","Little Argyll Street, West End",465
"8744",2020,12,117,168,155,"51.49288067","-0.114934001","Lollard Street, Vauxhall",323
"8745",2020,12,118,84,112,"51.49582705","-0.13547809","Rochester Row, Westminster",196
"8746",2020,12,119,258,280,"51.52589324","-0.090847761","Bath Street, St. Luke's",538
"8747",2020,12,120,111,113,"51.51573534","-0.093080779","The Guildhall, Guildhall",224
"8748",2020,12,121,145,155,"51.51891348","-0.156166631","Baker Street, Marylebone",300
"8749",2020,12,122,112,125,"51.52111369","-0.078869751","Norton Folgate, Liverpool Street",237
"8750",2020,12,123,87,82,"51.52836014","-0.104724625","St. John Street, Finsbury",169
"8751",2020,12,124,66,70,"51.49654462","-0.150905245","Eaton Square, Belgravia",136
"8752",2020,12,125,191,187,"51.50069491","-0.094524319","Borough High Street, The Borough",378
"8753",2020,12,126,140,128,"51.51782144","-0.096496865","Museum of London, Barbican",268
"8754",2020,12,127,76,67,"51.51700801","-0.09388536","Wood Street, Guildhall",143
"8755",2020,12,128,155,146,"51.49536226","-0.185296516","Emperor's Gate, South Kensington",301
"8756",2020,12,129,131,126,"51.5118973","-0.137043852","Golden Square, Soho",257
"8757",2020,12,130,246,299,"51.50950627","-0.075459482","Tower Gardens , Tower",545
"8758",2020,12,131,104,76,"51.53300545","-0.136792671","Eversholt Street , Camden Town",180
"8759",2020,12,132,305,305,"51.52364804","-0.074754872","Bethnal Green Road, Shoreditch",610
"8760",2020,12,133,333,369,NA,NA,NA,702
"8761",2020,12,134,140,139,"51.504904","-0.06797","Wapping High Street, Wapping",279
"8762",2020,12,135,166,186,"51.52326004","-0.104708922","Clerkenwell Green, Clerkenwell",352
"8763",2020,12,136,175,228,"51.51196176","-0.097441687","Queen Victoria Street, St. Paul's",403
"8764",2020,12,138,178,177,"51.51227622","-0.157436972","Green Street, Mayfair",355
"8765",2020,12,139,134,117,"51.49488108","-0.117974901","Lambeth Road, Vauxhall",251
"8766",2020,12,140,144,159,"51.52096262","-0.085634242","Finsbury Square , Moorgate",303
"8767",2020,12,141,157,166,"51.51530805","-0.147203711","Chapel Place, Marylebone",323
"8768",2020,12,142,149,143,"51.49372451","-0.198286569","West Cromwell Road, Earl's Court",292
"8769",2020,12,143,130,140,"51.4968865","-0.161203828","Pont Street, Knightsbridge",270
"8770",2020,12,144,280,290,"51.48894022","-0.111435796","Kennington Cross, Kennington",570
"8771",2020,12,145,60,50,"51.50074359","-0.202759212","Ilchester Place, Kensington",110
"8772",2020,12,146,102,103,"51.48836528","-0.129361842","Vauxhall Bridge , Pimlico",205
"8773",2020,12,148,214,207,"51.49211134","-0.138364847","Tachbrook Street, Victoria",421
"8774",2020,12,149,219,233,"51.48478899","-0.110683213","Kennington Road Post Office, Oval",452
"8775",2020,12,150,124,137,"51.49705603","-0.168917077","Holy Trinity Brompton, Knightsbridge",261
"8776",2020,12,151,129,84,"51.51213691","-0.201554966","Chepstow Villas, Notting Hill",213
"8777",2020,12,152,209,178,"51.49217002","-0.101536865","Hampton Street, Walworth",387
"8778",2020,12,153,361,346,"51.511933","-0.174411","Bayswater Road, Hyde Park",707
"8779",2020,12,154,610,492,"51.50379168","-0.11282408","Waterloo Station 3, Waterloo",1102
"8780",2020,12,155,121,138,"51.49586666","-0.191933711","Lexham Gardens, Kensington",259
"8781",2020,12,156,105,113,"51.49443626","-0.092921165","New Kent Road, The Borough",218
"8782",2020,12,157,195,218,"51.50039792","-0.193068385","Wright's Lane, Kensington",413
"8783",2020,12,158,139,127,"51.49085368","-0.196170309","Trebovir Road, Earl's Court",266
"8784",2020,12,159,222,257,"51.51461995","-0.137841333","Great Marlborough Street, Soho",479
"8785",2020,12,160,134,147,"51.50663341","-0.131773845","Waterloo Place, St. James's",281
"8786",2020,12,161,100,109,"51.49234577","-0.141334487","Guildhouse Street, Victoria",209
"8787",2020,12,162,124,127,"51.51760685","-0.121328408","Southampton Place, Holborn",251
"8788",2020,12,163,203,205,"51.4931848","-0.167894973","Sloane Avenue, Knightsbridge",408
"8789",2020,12,164,140,128,"51.515607","-0.183118788","Cleveland Gardens, Bayswater",268
"8790",2020,12,165,73,48,"51.517932","-0.183716959","Orsett Terrace, Bayswater",121
"8791",2020,12,166,120,140,"51.50185512","-0.159237081","Seville Street, Knightsbridge",260
"8792",2020,12,167,248,261,"51.49395092","-0.147624377","Eccleston Place, Victoria",509
"8793",2020,12,168,127,147,"51.50040123","-0.195455928","Argyll Road, Kensington",274
"8794",2020,12,169,195,182,"51.51474612","-0.165164288","Porchester Place, Paddington",377
"8795",2020,12,170,56,52,"51.52784273","-0.108068155","Hardwick Street, Clerkenwell",108
"8796",2020,12,171,146,143,"51.4916156","-0.186753859","Collingham Gardens, Earl's Court",289
"8797",2020,12,172,111,107,"51.49121192","-0.173715911","Sumner Place, South Kensington",218
"8798",2020,12,173,103,102,"51.50486","-0.113001","Waterloo Road, South Bank",205
"8799",2020,12,174,111,98,"51.512529","-0.115163","Strand, Strand",209
"8800",2020,12,175,96,117,"51.521668","-0.079608554","Worship Street, Shoreditch",213
"8801",2020,12,176,132,109,"51.51791921","-0.188098863","Gloucester Terrace, Bayswater",241
"8802",2020,12,177,193,230,"51.49616092","-0.140947636","Ashley Place, Victoria",423
"8803",2020,12,178,189,177,"51.48985626","-0.141923621","Warwick Square, Pimlico",366
"8804",2020,12,180,122,123,"51.5129118","-0.153645496","North Audley Street, Mayfair",245
"8805",2020,12,181,94,89,"51.49941247","-0.152317537","Belgrave Square, Belgravia",183
"8806",2020,12,182,131,122,"51.52202903","-0.165842551","Bell Street , Marylebone",253
"8807",2020,12,183,328,318,"51.482362","-0.13612398","Riverlight North, Nine Elms",646
"8808",2020,12,184,162,165,"51.52071513","-0.14521173","Portland Place, Marylebone",327
"8809",2020,12,185,239,241,"51.48805753","-0.140741432","Alderney Street, Pimlico",480
"8810",2020,12,186,328,284,"51.51733558","-0.175810943","South Wharf Road, Paddington",612
"8811",2020,12,187,141,143,"51.49247977","-0.178433004","Queen's Gate (South), South Kensington",284
"8812",2020,12,188,114,114,"51.5165179","-0.164393768","Nutford Place, Marylebone",228
"8813",2020,12,189,94,63,"51.53166681","-0.109914711","Claremont Square, Angel",157
"8814",2020,12,190,213,212,"51.48997562","-0.132845681","Rampayne Street, Pimlico",425
"8815",2020,12,191,715,698,"51.50311799","-0.153520935","Hyde Park Corner, Hyde Park",1413
"8816",2020,12,192,271,268,"51.51251523","-0.133201961","Wardour Street, Soho",539
"8817",2020,12,193,134,158,"51.50581776","-0.100186337","Bankside Mix, Bankside",292
"8818",2020,12,194,268,559,"51.50462759","-0.091773776","Hop Exchange, The Borough",827
"8819",2020,12,195,151,144,"51.50724437","-0.106237501","Milroy Walk, South Bank",295
"8820",2020,12,196,121,114,"51.50368837","-0.098497684","Union Street, The Borough",235
"8821",2020,12,197,141,146,"51.50556905","-0.111606696","Stamford Street, South Bank",287
"8822",2020,12,199,311,311,"51.51048489","-0.082989638","Great Tower Street, Monument",622
"8823",2020,12,200,184,184,"51.51492456","-0.066078037","LMU Commercial Road, Whitechapel",368
"8824",2020,12,201,140,175,"51.5225965","-0.161113413","Dorset Square, Marylebone",315
"8825",2020,12,202,298,299,"51.51236389","-0.06954201","Leman Street, Aldgate",597
"8826",2020,12,203,186,194,"51.51821864","-0.100791005","West Smithfield Rotunda, Farringdon",380
"8827",2020,12,204,107,103,"51.52659961","-0.112432615","Margery Street, Clerkenwell",210
"8828",2020,12,206,213,215,"51.518154","-0.062697","New Road 1 , Whitechapel",428
"8829",2020,12,207,47,44,"51.50135267","-0.153194766","Grosvenor Crescent, Belgravia",91
"8830",2020,12,208,62,61,"51.52505151","-0.166304359","Mallory Street, Marylebone",123
"8831",2020,12,209,75,66,"51.49358391","-0.165101392","Denyer Street, Knightsbridge",141
"8832",2020,12,210,197,196,"51.51681444","-0.151926305","Hinde Street, Marylebone",393
"8833",2020,12,211,128,119,"51.49464523","-0.158105512","Cadogan Place, Knightsbridge",247
"8834",2020,12,212,84,54,"51.50658458","-0.199004026","Campden Hill Road, Notting Hill",138
"8835",2020,12,213,501,535,"51.50274025","-0.149569201","Wellington Arch, Hyde Park",1036
"8836",2020,12,214,141,137,"51.52683806","-0.130504336","Endsleigh Gardens, Euston",278
"8837",2020,12,215,176,212,"51.51906932","-0.088285377","Moorfields, Moorgate",388
"8838",2020,12,216,123,151,"51.49094565","-0.181190899","Old Brompton Road, South Kensington",274
"8839",2020,12,217,393,401,"51.51615461","-0.082422399","Wormwood Street, Liverpool Street",794
"8840",2020,12,218,139,132,"51.48971651","-0.170194408","St. Luke's Church, Chelsea",271
"8841",2020,12,219,261,251,"51.49016361","-0.19039362","Bramham Gardens, Earl's Court",512
"8842",2020,12,220,105,107,"51.49066456","-0.166485083","Chelsea Green, Chelsea",212
"8843",2020,12,221,166,168,"51.49481649","-0.13045856","Horseferry Road, Westminster",334
"8844",2020,12,222,94,81,"51.50275704","-0.155349725","Knightsbridge, Hyde Park",175
"8845",2020,12,223,185,164,"51.49148474","-0.090220911","Rodney Road , Walworth",349
"8846",2020,12,224,187,187,"51.51031","-0.18740235","Queensway, Kensington Gardens",374
"8847",2020,12,225,267,209,"51.50935342","-0.196422","Notting Hill Gate Station, Notting Hill",476
"8848",2020,12,226,109,125,"51.50844614","-0.131961389","Charles II Street, West End",234
"8849",2020,12,227,109,101,"51.52891573","-0.115480888","Great Percy Street, Clerkenwell",210
"8850",2020,12,228,294,408,"51.50742485","-0.134621209","St. James's Square, St. James's",702
"8851",2020,12,229,285,322,"51.50654321","-0.123179697","Whitehall Place, Strand",607
"8852",2020,12,230,63,67,"51.50669284","-0.103137426","Poured Lines, Bankside",130
"8853",2020,12,231,148,143,"51.49396755","-0.17873226","Queen's Gate (Central), South Kensington",291
"8854",2020,12,232,56,59,"51.51501025","-0.112753217","Carey Street, Holborn",115
"8855",2020,12,233,183,241,"51.50777049","-0.130699733","Pall Mall East, West End",424
"8856",2020,12,234,243,244,"51.53450449","-0.106992706","Liverpool Road (N1 Centre), Angel",487
"8857",2020,12,235,130,115,"51.49571828","-0.110889274","Kennington Road  , Vauxhall",245
"8858",2020,12,236,85,76,"51.51838043","-0.073438925","Fashion Street, Whitechapel",161
"8859",2020,12,237,152,145,"51.5097860151","-0.0681619805156","Dock Street, Wapping",297
"8860",2020,12,238,79,57,"51.5233534","-0.175116099","Frampton Street, Paddington",136
"8861",2020,12,239,206,209,"51.52443845","-0.138019439","Warren Street Station, Euston",415
"8862",2020,12,240,50,47,"51.50545935","-0.10569204","Colombo Street, Southwark",97
"8863",2020,12,242,140,135,"51.52200801","-0.151359288","Beaumont Street, Marylebone",275
"8864",2020,12,243,187,149,"51.49096258","-0.139625122","Gloucester Street, Pimlico",336
"8865",2020,12,244,124,133,"51.51611887","-0.128585022","Earnshaw Street , Covent Garden",257
"8866",2020,12,245,118,89,"51.4853572","-0.142207481","Grosvenor Road, Pimlico",207
"8867",2020,12,246,191,202,"51.52285301","-0.099994052","Berry Street, Clerkenwell",393
"8868",2020,12,247,85,73,"51.530529","-0.167515","St. John's Wood Church, The Regent's Park",158
"8869",2020,12,248,401,380,"51.50645179","-0.170279555","Triangle Car Park, Hyde Park",781
"8870",2020,12,249,83,76,"51.49859784","-0.096191134","Harper Road, The Borough",159
"8871",2020,12,250,72,96,"51.489932","-0.162727","Royal Avenue 1, Chelsea",168
"8872",2020,12,251,306,374,"51.518908","-0.079249","Brushfield Street, Liverpool Street",680
"8873",2020,12,252,172,174,"51.5046364","-0.116542278","Jubilee Gardens, South Bank",346
"8874",2020,12,253,220,173,"51.53404294","-0.086379717","Shoreditch Park, Hoxton",393
"8875",2020,12,254,140,122,"51.53051587","-0.106408455","Chadwell Street, Angel",262
"8876",2020,12,255,177,163,"51.52557531","-0.179592915","Clifton Road, Maida Vale",340
"8877",2020,12,256,52,66,"51.51362054","-0.116764211","Houghton Street, Strand",118
"8878",2020,12,257,92,90,"51.52248185","-0.154907218","Westminster University, Marylebone",182
"8879",2020,12,259,174,171,"51.490959","-0.1532331","Bourne Street, Belgravia",345
"8880",2020,12,260,114,115,"51.5136846","-0.135580879","Broadwick Street, Soho",229
"8881",2020,12,261,203,179,"51.5134891","-0.191351186","Princes Square, Bayswater",382
"8882",2020,12,262,112,128,"51.49874469","-0.103132904","LSBU (Borough Road), Elephant & Castle",240
"8883",2020,12,263,127,125,"51.51422502","-0.080660083","St. Mary Axe, Aldgate",252
"8884",2020,12,264,179,170,"51.52644342","-0.109256828","Tysoe Street, Clerkenwell",349
"8885",2020,12,265,131,114,"51.51595344","-0.169249375","Southwick Street, Paddington",245
"8886",2020,12,266,133,132,"51.50102668","-0.180246101","Queen's Gate (North), Kensington",265
"8887",2020,12,267,173,149,"51.49206037","-0.132224622","Regency Street, Westminster",322
"8888",2020,12,268,149,157,"51.49320445","-0.144132875","Belgrave Road, Victoria",306
"8889",2020,12,269,162,158,"51.50082346","-0.089740764","Empire Square, The Borough",320
"8890",2020,12,270,326,331,"51.4863434","-0.122492418","Kennington Lane Rail Bridge, Vauxhall",657
"8891",2020,12,271,91,108,"51.53583617","-0.156285395","London Zoo,  The Regent's Park",199
"8892",2020,12,272,261,264,"51.50144456","-0.110699309","Baylis Road, Waterloo",525
"8893",2020,12,273,92,117,"51.50613324","-0.114686385","Belvedere Road 1, South Bank",209
"8894",2020,12,274,127,117,"51.49671237","-0.20528437","Warwick Road, Olympia",244
"8895",2020,12,275,82,90,"51.52004497","-0.092176447","Barbican Centre, Barbican",172
"8896",2020,12,276,53,49,"51.50930161","-0.084985356","Lower Thames Street, Monument",102
"8897",2020,12,277,179,200,"51.50315739","-0.191496313","Kensington Church Street, Kensington",379
"8898",2020,12,278,376,393,"51.5034938","-0.07962099","Tooley Street, Bermondsey",769
"8899",2020,12,279,138,112,"51.51862243","-0.176645823","North Wharf Road, Paddington",250
"8900",2020,12,280,126,132,"51.490083","-0.162418","Royal Avenue 2, Chelsea",258
"8901",2020,12,281,212,243,"51.49580589","-0.127575233","Smith Square, Westminster",455
"8902",2020,12,282,337,357,"51.51906446","-0.059642081","Royal London Hospital, Whitechapel",694
"8903",2020,12,283,38,37,"51.51440928","-0.118478757","Kingsway, Covent Garden",75
"8904",2020,12,284,143,140,"51.49914063","-0.112031483","Lambeth North Station, Waterloo",283
"8905",2020,12,286,137,95,"51.5272947","-0.174653609","St. John's Wood Road, St. John's Wood",232
"8906",2020,12,287,71,67,"51.52367314","-0.128377673","Bedford Way, Bloomsbury",138
"8907",2020,12,288,179,212,"51.49236962","-0.147478734","Elizabeth Bridge, Victoria",391
"8908",2020,12,289,50,49,"51.50923022","-0.151296092","South Audley Street, Mayfair",99
"8909",2020,12,290,144,136,"51.518268","-0.17110323","St Mary's Hospital, Paddington",280
"8910",2020,12,291,184,144,"51.48483991","-0.138089062","Claverton Street, Pimlico",328
"8911",2020,12,292,190,201,"51.49888404","-0.165471605","Montpelier Street, Knightsbridge",391
"8912",2020,12,293,97,92,"51.49815779","-0.209494128","Kensington Olympia Station, Olympia",189
"8913",2020,12,294,243,222,"51.488226","-0.135635511","St. George's Square, Pimlico",465
"8914",2020,12,295,140,127,"51.50029631","-0.092762704","Swan Street, The Borough",267
"8915",2020,12,296,138,153,"51.49363156","-0.190603326","Knaresborough Place, Earl's Court",291
"8916",2020,12,297,52,48,"51.49612799","-0.106000855","Geraldine Street, Elephant & Castle",100
"8917",2020,12,298,381,373,"51.50227992","-0.074189225","Curlew Street, Shad Thames",754
"8918",2020,12,299,68,65,"51.49398524","-0.136928582","Vincent Square, Westminster",133
"8919",2020,12,300,503,493,"51.505014","-0.17306032","Serpentine Car Park, Hyde Park",996
"8920",2020,12,301,183,180,"51.51475963","-0.148105415","Marylebone Lane, Marylebone",363
"8921",2020,12,302,146,165,"51.466907","-0.216573","Putney Pier, Wandsworth",311
"8922",2020,12,303,560,551,"51.50295379","-0.158456089","Albert Gate, Hyde Park",1111
"8923",2020,12,306,99,97,"51.51816295","-0.135025698","Rathbone Street, Fitzrovia",196
"8924",2020,12,307,707,721,"51.50990837","-0.187842717","Black Lion Gate, Kensington Gardens",1428
"8925",2020,12,308,159,140,"51.49907558","-0.085666316","Long Lane , Bermondsey",299
"8926",2020,12,309,112,117,"51.50963123","-0.119047563","Embankment (Savoy), Strand",229
"8927",2020,12,310,152,145,"51.4908679","-0.116911864","Black Prince Road, Vauxhall",297
"8928",2020,12,311,137,138,"51.51918144","-0.140485596","Foley Street, Fitzrovia",275
"8929",2020,12,312,142,124,"51.53088935","-0.176770502","Grove End Road, St. John's Wood",266
"8930",2020,12,313,154,176,"51.51734403","-0.138072691","Wells Street, Fitzrovia",330
"8931",2020,12,314,131,131,"51.50088934","-0.083159352","Tyers Gate, Bermondsey",262
"8932",2020,12,315,202,210,"51.52536703","-0.153463612","The Tennis Courts, The Regent's Park",412
"8933",2020,12,316,159,180,NA,NA,NA,339
"8934",2020,12,317,65,36,"51.49679128","-0.093913472","Dickens Square, Borough",101
"8935",2020,12,318,143,154,"51.51004801","-0.138846453","Sackville Street, Mayfair",297
"8936",2020,12,319,142,155,"51.52702563","-0.088542771","Baldwin Street, St. Luke's",297
"8937",2020,12,320,186,225,"51.49357351","-0.139956043","Queen Mother Sports Centre, Victoria",411
"8938",2020,12,321,281,254,"51.49785559","-0.081608045","Bermondsey Street, Bermondsey",535
"8939",2020,12,322,127,94,"51.526293","-0.073955","Palissy Street, Shoreditch",221
"8940",2020,12,323,62,69,"51.523196","-0.083067","Clifton Street, Shoreditch",131
"8941",2020,12,324,184,193,"51.49652013","-0.101384068","Ontario Street, Elephant & Castle",377
"8942",2020,12,325,73,73,"51.50908747","-0.129697889","St. Martin's Street, West End",146
"8943",2020,12,326,262,243,"51.53266186","-0.099981142","Graham Street, Angel",505
"8944",2020,12,327,69,39,"51.53095","-0.085603","New North Road 1, Hoxton",108
"8945",2020,12,328,56,48,"51.53114","-0.086016","New North Road 2, Hoxton",104
"8946",2020,12,329,140,147,"51.53589283","-0.160854428","Prince Albert Road, The Regent's Park",287
"8947",2020,12,330,139,98,"51.51641749","-0.179135079","Eastbourne Mews, Paddington",237
"8948",2020,12,331,244,270,"51.52085887","-0.089887855","Bunhill Row, Moorgate",514
"8949",2020,12,332,90,81,"51.49334336","-0.194757949","Nevern Place, Earl's Court",171
"8950",2020,12,333,160,138,"51.50860544","-0.193764092","Palace Gardens Terrace, Notting Hill",298
"8951",2020,12,334,35,38,"51.505044","-0.115851","Concert Hall Approach 1, South Bank",73
"8952",2020,12,335,101,112,"51.51196803","-0.120718759","Tavistock Street, Covent Garden",213
"8953",2020,12,336,67,121,"51.504942","-0.115533","Concert Hall Approach 2, South Bank",188
"8954",2020,12,337,84,86,"51.51108452","-0.197524944","Pembridge Villas, Notting Hill",170
"8955",2020,12,338,184,197,"51.51175646","-0.119643424","Wellington Street , Strand",381
"8956",2020,12,339,51,57,"51.5333196","-0.1117812","Risinghill Street, Angel",108
"8957",2020,12,340,217,265,"51.51444134","-0.087587447","Bank of England Museum, Bank",482
"8958",2020,12,341,311,310,"51.50810309","-0.12602103","Craven Street, Strand",621
"8959",2020,12,343,156,172,"51.53692216","-0.150181444","London Zoo Car Park, The Regent's Park",328
"8960",2020,12,344,103,77,"51.528246","-0.10102611","Goswell Road (City Uni), Finsbury",180
"8961",2020,12,345,286,307,"51.48802358","-0.166878535","Flood Street, Chelsea",593
"8962",2020,12,347,144,159,"51.50013942","-0.113936001","Lower Marsh, Waterloo",303
"8963",2020,12,348,137,183,"51.51217033","-0.150481272","Grosvenor Square, Mayfair",320
"8964",2020,12,349,113,106,"51.51196","-0.142783033","St. George Street, Mayfair",219
"8965",2020,12,350,282,303,"51.5017154373867","-0.1798541843891","Queen's Gate, Kensington Gardens",585
"8966",2020,12,351,135,116,"51.529423","-0.097122","Macclesfield Rd, St Lukes",251
"8967",2020,12,352,10,3,"51.486965","-0.116625","Vauxhall Street, Vauxhall",13
"8968",2020,12,353,45,56,"51.49459148","-0.134234258","Greycoat Street , Westminster",101
"8969",2020,12,354,123,162,"51.506767","-0.123702","Northumberland Avenue, Strand",285
"8970",2020,12,356,290,305,"51.494412","-0.173881","South Kensington Station, South Kensington",595
"8971",2020,12,357,141,141,"51.520994","-0.139016","Howland Street, Fitzrovia",282
"8972",2020,12,358,119,136,"51.516226","-0.124826","High Holborn , Covent Garden",255
"8973",2020,12,359,78,87,"51.49782999","-0.135440826","Butler Place, Westminster",165
"8974",2020,12,360,169,196,"51.49675303","-0.138733562","Howick Place, Westminster",365
"8975",2020,12,361,172,54,"51.50391973","-0.11342629","Waterloo Station 2, Waterloo",226
"8976",2020,12,362,85,84,"51.536264","-0.133952","Royal College Street, Camden Town",169
"8977",2020,12,363,32,29,"51.5291212008901","-0.171185284853","Lord's, St. John's Wood",61
"8978",2020,12,364,157,145,"51.519656","-0.132339","Alfred Place, Bloomsbury",302
"8979",2020,12,365,117,95,"51.530344","-0.100168","City Road, Angel",212
"8980",2020,12,366,73,78,"51.5109192966489","-0.1511263847351","Millennium Hotel, Mayfair",151
"8981",2020,12,367,77,76,"51.5173721","-0.1642075","Harrowby Street, Marylebone",153
"8982",2020,12,368,160,169,"51.50024195","-0.15934065","Harriet Street, Knightsbridge",329
"8983",2020,12,370,2,26,"51.520205","-0.174593","Paddington Green, Paddington",28
"8984",2020,12,371,53,63,"51.49775","-0.10988","King Edward Walk, Waterloo",116
"8985",2020,12,372,70,74,"51.515208","-0.117863","Sardinia Street, Holborn",144
"8986",2020,12,373,70,64,"51.49980661","-0.176415994","Prince Consort Road, Knightsbridge",134
"8987",2020,12,374,359,404,"51.50402794","-0.11386436","Waterloo Station 1, Waterloo",763
"8988",2020,12,375,91,93,"51.50194596","-0.194392952","Kensington Town Hall, Kensington",184
"8989",2020,12,376,186,198,"51.49188409","-0.125674815","Millbank Tower, Pimlico",384
"8990",2020,12,377,47,57,"51.50535447","-0.113656543","Waterloo Bridge, South Bank",104
"8991",2020,12,378,68,91,"51.49559291","-0.179077626","Natural History Museum, South Kensington",159
"8992",2020,12,379,137,145,"51.51431171","-0.200838199","Turquoise Island, Notting Hill",282
"8993",2020,12,380,71,76,"51.50686435","-0.150666888","Stanhope Gate, Mayfair",147
"8994",2020,12,381,132,148,"51.51953043","-0.13577731","Charlotte Street, Fitzrovia",280
"8995",2020,12,382,92,89,"51.50935171","-0.14744969","Farm Street, Mayfair",181
"8996",2020,12,383,140,139,"51.51310333","-0.13121385","Frith Street, Soho",279
"8997",2020,12,384,106,99,"51.496481","-0.192404","Marloes Road, Kensington",205
"8998",2020,12,386,226,243,"51.51352755","-0.130110822","Moor Street, Soho",469
"8999",2020,12,387,170,168,"51.49369988","-0.121394101","Fire Brigade Pier, Vauxhall",338
"9000",2020,12,388,135,153,"51.51070161","-0.121723604","Southampton Street, Strand",288
"9001",2020,12,389,25,19,"51.51013066","-0.155757901","Upper Grosvenor Street, Mayfair",44
"9002",2020,12,390,71,69,"51.521776","-0.068856","Buxton Street 1, Shoreditch",140
"9003",2020,12,392,191,188,"51.49942855","-0.179702476","Imperial College, Knightsbridge",379
"9004",2020,12,393,111,144,"51.51733427","-0.103604248","Snow Hill, Farringdon",255
"9005",2020,12,394,107,71,"51.524826","-0.176268","Aberdeen Place, St. John's Wood",178
"9006",2020,12,395,222,239,"51.492462","-0.159919","Cadogan Gardens, Chelsea",461
"9007",2020,12,396,126,124,"51.51809","-0.163609","Shouldham Street, Marylebone",250
"9008",2020,12,397,248,236,"51.51348","-0.17977","Devonshire Terrace, Bayswater",484
"9009",2020,12,398,129,120,"51.502319","-0.200742","Holland Park, Kensington",249
"9010",2020,12,399,140,152,"51.52261762","-0.071653961","Brick Lane Market, Shoreditch",292
"9011",2020,12,400,142,161,"51.517703","-0.154106","George Street, Marylebone",303
"9012",2020,12,401,177,157,"51.528187","-0.075375","Columbia Road, Shoreditch",334
"9013",2020,12,402,74,67,"51.52289229","-0.171681991","Penfold Street, Marylebone",141
"9014",2020,12,403,118,114,"51.51689296","-0.158249929","George Place Mews, Marylebone",232
"9015",2020,12,404,430,440,"51.50204238","-0.184400221","Palace Gate, Kensington Gardens",870
"9016",2020,12,405,305,305,"51.49418566","-0.18267094","Gloucester Road Station, South Kensington",610
"9017",2020,12,409,190,177,"51.493146","-0.099828","Strata, Elephant & Castle",367
"9018",2020,12,410,143,137,"51.519968","-0.169774","Edgware Road Station, Marylebone",280
"9019",2020,12,411,186,203,"51.49337264","-0.09968067","Walworth Road, Elephant & Castle",389
"9020",2020,12,412,100,81,"51.488105","-0.110121","Cleaver Street, Kennington",181
"9021",2020,12,419,192,174,"51.485821","-0.149004","Chelsea Bridge, Pimlico",366
"9022",2020,12,420,53,72,"51.504043","-0.105312","Southwark Station 1, Southwark",125
"9023",2020,12,421,119,100,"51.504044","-0.104778","Southwark Station 2, Southwark",219
"9024",2020,12,423,89,91,"51.49456127","-0.15393398","Eaton Square (South), Belgravia",180
"9025",2020,12,424,141,113,"51.490491","-0.149186","Ebury Bridge, Pimlico",254
"9026",2020,12,425,80,72,"51.533379","-0.139159","Harrington Square 2, Camden Town",152
"9027",2020,12,426,183,183,"51.493072","-0.129925","Vincent Street, Pimlico",366
"9028",2020,12,427,339,333,"51.51397065","-0.09294031","Cheapside, Bank",672
"9029",2020,12,428,212,265,"51.499917","-0.174554","Exhibition Road, Knightsbridge",477
"9030",2020,12,430,106,112,"51.48902","-0.17524","South Parade, Chelsea",218
"9031",2020,12,431,79,75,"51.534474","-0.122203","Crinan Street, King's Cross",154
"9032",2020,12,432,134,136,"51.496957","-0.173894","Exhibition Road Museums, South Kensington",270
"9033",2020,12,433,139,139,"51.524564","-0.116279","Wren Street, Holborn",278
"9034",2020,12,435,140,137,"51.488852","-0.105593","Kennington Station, Kennington",277
"9035",2020,12,436,191,191,"51.51824","-0.11655","Red Lion Street, Holborn",382
"9036",2020,12,437,159,164,"51.488124","-0.120903","Vauxhall Walk, Vauxhall",323
"9037",2020,12,439,40,42,"51.5338","-0.118677","Killick Street, King's Cross",82
"9038",2020,12,440,116,110,"51.483145","-0.113134","Kennington Oval, Oval",226
"9039",2020,12,441,149,124,"51.495656","-0.114605","Sail Street, Vauxhall",273
"9040",2020,12,442,70,63,"51.510101","-0.211358","Walmer Road, Avondale",133
"9041",2020,12,443,115,94,"51.515256","-0.058641","Philpot Street, Whitechapel",209
"9042",2020,12,444,130,116,"51.52568","-0.055312","Bethnal Green Garden, Bethnal Green",246
"9043",2020,12,445,77,88,"51.52388","-0.065076","Cheshire Street, Bethnal Green",165
"9044",2020,12,446,150,134,"51.528936","-0.055894","York Hall, Bethnal Green",284
"9045",2020,12,447,66,58,"51.493381","-0.007542","Jubilee Crescent, Cubitt Town",124
"9046",2020,12,448,116,132,"51.50623","-0.02296","Fisherman's Walk West, Canary Wharf",248
"9047",2020,12,449,229,228,"51.511088","-0.057159","Shadwell Station, Shadwell",457
"9048",2020,12,450,136,104,"51.515975","-0.053177","Jubilee Street, Stepney",240
"9049",2020,12,451,135,126,"51.504719","-0.063531","Hermitage Court, Wapping",261
"9050",2020,12,452,157,131,"51.505697","-0.070542","St. Katharine's Way, Tower",288
"9051",2020,12,453,143,134,"51.508447","-0.055167","Garnet Street, Shadwell",277
"9052",2020,12,454,92,98,"51.487679","-0.021582","Napier Avenue, Millwall",190
"9053",2020,12,455,103,105,"51.49447","-0.014409","East Ferry Road, Cubitt Town",208
"9054",2020,12,456,114,129,"51.538071","-0.144664","Parkway, Camden Town",243
"9055",2020,12,457,165,162,"51.542138","-0.145393","Castlehaven Road, Camden Town",327
"9056",2020,12,458,205,182,"51.504749","-0.057544","Wapping Lane, Wapping",387
"9057",2020,12,459,217,228,"51.535179","-0.03338","Gunmakers Lane, Old Ford",445
"9058",2020,12,460,194,203,"51.516196","-0.029138","Burdett Road, Mile End",397
"9059",2020,12,461,103,99,"51.516","-0.038775","Aston Street, Stepney",202
"9060",2020,12,462,211,223,"51.541603","-0.138853","Bonny Street, Camden Town",434
"9061",2020,12,463,86,80,"51.534776","-0.071881","Thurtle Road, Haggerston",166
"9062",2020,12,464,54,56,"51.51417","-0.052099","St. Mary & St. Michael Church, Stepney",110
"9063",2020,12,465,182,167,"51.53558","-0.08249","Pitfield Street North,Hoxton",349
"9064",2020,12,466,112,80,"51.534464","-0.076341","Whiston Road, Haggerston",192
"9065",2020,12,467,83,69,"51.523538","-0.030556","Southern Grove, Bow",152
"9066",2020,12,468,64,42,"51.521564","-0.022694","Cantrell Road, Bow",106
"9067",2020,12,469,87,74,"51.513757","-0.020467","Lindfield Street, Poplar",161
"9068",2020,12,470,155,139,"51.530535","-0.025492","Mostyn Grove, Bow",294
"9069",2020,12,471,115,126,"51.533283","-0.028155","Hewison Street, Old Ford",241
"9070",2020,12,472,34,20,"51.529452","-0.027616","Malmesbury Road, Bow",54
"9071",2020,12,473,52,44,"51.496137","-0.019355","Millharbour, Millwall",96
"9072",2020,12,475,102,89,"51.499041","-0.020157","Lightermans Road, Millwall",191
"9073",2020,12,476,50,64,"51.489096","-0.009205","Stebondale Street, Cubitt Town",114
"9074",2020,12,477,81,87,"51.49109","-0.018716","Spindrift Avenue, Millwall",168
"9075",2020,12,478,267,264,"51.521889","-0.04667","Stepney Green Station, Stepney",531
"9076",2020,12,479,224,228,"51.527152","-0.058005","Pott Street, Bethnal Green",452
"9077",2020,12,480,325,301,"51.5128711","-0.0389866","Flamborough Street, Limehouse",626
"9078",2020,12,481,300,313,"51.487129","-0.009001","Saunders Ness Road, Cubitt Town",613
"9079",2020,12,483,137,118,"51.51328","-0.047784","Albert Gardens, Stepney",255
"9080",2020,12,484,105,86,"51.528828","-0.013258","Bromley High Street, Bow",191
"9081",2020,12,485,180,184,"51.531127","-0.048017","Old Ford Road, Bethnal Green",364
"9082",2020,12,486,181,172,"51.525645","-0.069543","Granby Street, Shoreditch",353
"9083",2020,12,487,66,49,"51.511811","-0.025626","Canton Street, Poplar",115
"9084",2020,12,488,196,176,"51.506946","-0.058681","Reardon Street, Wapping",372
"9085",2020,12,489,190,156,"51.513074","-0.064094","Christian Street, Whitechapel",346
"9086",2020,12,490,82,96,"51.508622","-0.065006","Pennington Street, Wapping",178
"9087",2020,12,491,171,141,"51.522507","-0.041378","Queen Mary's, Mile End",312
"9088",2020,12,492,194,191,"51.525501","-0.032267204","Maplin Street, Mile End",385
"9089",2020,12,494,11,5,"51.50196","-0.016251","South Quay East, Canary Wharf",16
"9090",2020,12,495,219,203,"51.528169","-0.018703","Bow Church Station, Bow",422
"9091",2020,12,496,131,115,"51.52512","-0.015578","Devons Road, Bow",246
"9092",2020,12,497,95,100,"51.526149","-0.027396845","Merchant Street, Bow",195
"9093",2020,12,498,167,141,"51.527058","-0.025296","Bow Road Station, Bow",308
"9094",2020,12,499,203,204,"51.519265","-0.021345","Furze Green, Bow",407
"9095",2020,12,500,296,261,"51.519806","-0.055731","Ansell House, Stepney",557
"9096",2020,12,501,141,131,"51.522561","-0.054883","Cephas Street, Bethnal Green",272
"9097",2020,12,502,401,396,"51.53341","-0.049591815","Bonner Gate, Victoria Park",797
"9098",2020,12,503,300,304,"51.520893","-0.051394","Cleveland Way, Stepney",604
"9099",2020,12,504,52,43,"51.496454","-0.009506","St. John's Park, Cubitt Town",95
"9100",2020,12,505,92,70,"51.520398","-0.026768","Ackroyd Drive, Bow",162
"9101",2020,12,506,138,125,"51.517475","-0.075855","Bell Lane, Liverpool Street",263
"9102",2020,12,507,103,70,"51.528692","-0.059091","Clarkson Street, Bethnal Green",173
"9103",2020,12,508,164,183,"51.519362","-0.074431","Fournier Street, Whitechapel",347
"9104",2020,12,509,92,101,"51.517842","-0.090075","Fore Street, Guildhall",193
"9105",2020,12,510,269,292,"51.509303","-0.025996","Westferry DLR, Limehouse",561
"9106",2020,12,511,193,185,"51.511066","-0.053558","Sutton Street, Shadwell",378
"9107",2020,12,512,251,246,"51.532091","-0.06142","Pritchard's Road, Bethnal Green",497
"9108",2020,12,513,174,181,"51.5142228","-0.055656","Watney Market, Stepney",355
"9109",2020,12,514,126,129,"51.516204","-0.155525","Portman Square, Marylebone",255
"9110",2020,12,515,74,67,"51.500088","-0.211316","Russell Gardens, Olympia",141
"9111",2020,12,516,105,111,"51.5112","-0.014438","Chrisp Street Market, Poplar",216
"9112",2020,12,517,112,121,"51.532513","-0.033085","Ford Road, Old Ford",233
"9113",2020,12,518,117,116,"51.528224","-0.037471","Antill Road, Mile End",233
"9114",2020,12,519,34,30,"51.518811","-0.011662","Teviot Street, Poplar",64
"9115",2020,12,520,140,118,"51.526041","-0.047218","Bancroft Road, Bethnal Green",258
"9116",2020,12,521,196,208,"51.534137","-0.037366","Driffield Road, Old Ford",404
"9117",2020,12,522,224,211,"51.525941","-0.036017","Clinton Road, Mile End",435
"9118",2020,12,523,49,39,"51.51549","-0.013475","Langdon Park, Poplar",88
"9119",2020,12,524,180,123,"51.511654","-0.179668","Lancaster Gate , Bayswater",303
"9120",2020,12,526,78,72,"51.503143","-0.008428","Lancaster Drive, Blackwall",150
"9121",2020,12,527,97,108,"51.503802","-0.215808","Hansard Mews, Holland Park",205
"9122",2020,12,528,54,54,"51.507326","-0.145827","Clarges Street, Mayfair",108
"9123",2020,12,529,104,117,"51.486892","-0.170983","Manresa Road, Chelsea",221
"9124",2020,12,530,82,71,"51.508896","-0.012413","Newby Place, Poplar",153
"9125",2020,12,531,220,216,"51.530326","-0.042744","Twig Folly Bridge, Mile End",436
"9126",2020,12,532,70,131,"51.50357","-0.020068","Jubilee Plaza, Canary Wharf",201
"9127",2020,12,533,130,110,"51.528222","-0.069743","Wellington Row, Bethnal Green",240
"9128",2020,12,534,180,148,"51.531864","-0.066035","Goldsmith's Row, Haggerston",328
"9129",2020,12,535,142,141,"51.537349","-0.147154","Gloucester Avenue, Camden Town",283
"9130",2020,12,536,88,72,"51.53385","-0.06992","Queensbridge Road, Haggerston",160
"9131",2020,12,537,192,188,"51.51793","-0.067937","Old Montague Street, Whitechapel",380
"9132",2020,12,538,91,81,"51.508981","-0.00699","Naval Row, Blackwall",172
"9133",2020,12,540,152,159,"51.528302","-0.144466","Albany Street, The Regent's Park",311
"9134",2020,12,541,266,280,"51.506613","-0.142844","Green Park Station, Mayfair",546
"9135",2020,12,542,187,165,"51.514115","-0.033828","Salmon Lane, Limehouse",352
"9136",2020,12,543,53,30,"51.509591","-0.204666","Lansdowne Walk, Ladbroke Grove",83
"9137",2020,12,544,86,87,"51.526153","-0.102208","Percival Street, Finsbury",173
"9138",2020,12,545,71,68,"51.539957","-0.145246","Arlington Road, Camden Town",139
"9139",2020,12,546,162,168,"51.517428","-0.107987","New Fetter Lane, Holborn",330
"9140",2020,12,547,136,143,"51.509474","-0.002275","East India DLR, Blackwall",279
"9141",2020,12,548,66,60,"51.498386","-0.107913","Westminster Bridge Road, Elephant & Castle",126
"9142",2020,12,549,129,115,"51.49605","-0.104193","Gaywood  Street, Elephant & Castle",244
"9143",2020,12,550,112,103,"51.521564","-0.039264","Harford Street, Mile End",215
"9144",2020,12,551,70,83,"51.505772","-0.016460175","Import Dock, Canary Wharf",153
"9145",2020,12,552,177,170,"51.511542","-0.056667","Watney Street, Shadwell",347
"9146",2020,12,553,538,530,"51.535678","-0.062546","Regent's Row , Haggerston",1068
"9147",2020,12,554,45,49,"51.513548","-0.005659","Aberfeldy Street, Poplar",94
"9148",2020,12,556,66,62,"51.502661","-0.021596","Heron Quays DLR, Canary Wharf",128
"9149",2020,12,557,81,72,"51.51601","-0.0985","King Edward Street, St Pauls",153
"9150",2020,12,558,46,49,"51.493978","-0.127554","Page Street, Westminster",95
"9151",2020,12,559,52,55,"51.501391","-0.205991","Abbotsbury Road, Holland Park",107
"9152",2020,12,560,56,38,"51.511624","-0.205921","Ladbroke Grove Central, Ladbroke Grove",94
"9153",2020,12,561,100,75,"51.518369","-0.043371","Rectory Square, Stepney",175
"9154",2020,12,562,94,86,"51.51746","-0.12335","Bury Place, Holborn",180
"9155",2020,12,563,61,62,"51.499286","-0.009152","Preston's Road, Cubitt Town",123
"9156",2020,12,564,360,399,"51.509943","-0.117619","Somerset House, Strand",759
"9157",2020,12,565,66,67,"51.521905","-0.063386","Selby Street, Whitechapel",133
"9158",2020,12,566,100,124,"51.509158","-0.224103","Westfield Ariel Way, White City",224
"9159",2020,12,568,279,272,"51.51616","-0.18697","Bishop's Bridge Road West, Bayswater",551
"9160",2020,12,569,151,117,"51.53213","-0.08299","Pitfield Street Central, Hoxton",268
"9161",2020,12,570,168,176,"51.503083","-0.017676","Upper Bank Street, Canary Wharf",344
"9162",2020,12,571,92,104,"51.506256","-0.218337","Westfield Southern Terrace ,Shepherd's Bush",196
"9163",2020,12,572,184,199,"51.539099","-0.141728","Greenland Road, Camden Town",383
"9164",2020,12,573,292,320,"51.485587","-0.18119","Limerston Street, West Chelsea",612
"9165",2020,12,574,341,309,"51.53356","-0.09315","Eagle Wharf Road, Hoxton",650
"9166",2020,12,576,99,110,"51.497304","-0.022793","Alpha Grove, Millwall",209
"9167",2020,12,577,182,180,"51.528869","-0.047548","Globe Town Market, Bethnal Green",362
"9168",2020,12,578,29,65,"51.527607","-0.057133","Hollybush Gardens, Bethnal Green",94
"9169",2020,12,579,332,426,"51.511246","-0.093051","Queen Street 2, Bank",758
"9170",2020,12,580,199,189,"51.48692917","-0.102996299","Doddington Grove, Kennington",388
"9171",2020,12,581,207,232,"51.519167","-0.147983","New Cavendish Street, Marylebone",439
"9172",2020,12,583,215,262,"51.497622","-0.125978","Abingdon Green, Westminster",477
"9173",2020,12,584,157,137,"51.51244","-0.19096","Ilchester Gardens, Bayswater",294
"9174",2020,12,586,47,57,"51.490645","-0.014582","Mudchute DLR, Cubitt Town",104
"9175",2020,12,587,252,275,"51.50964","-0.08497","Monument Street, Monument",527
"9176",2020,12,588,93,79,"51.52959","-0.0801","Hoxton Street, Hoxton",172
"9177",2020,12,589,250,265,"51.487196","-0.179369","Drayton Gardens, West Chelsea",515
"9178",2020,12,590,48,34,"51.53256","-0.16862","Greenberry Street, St.John's Wood",82
"9179",2020,12,592,70,60,"51.5171","-0.18377","Bishop's Bridge Road East, Bayswater",130
"9180",2020,12,593,74,63,"51.531066","-0.11934","Northdown Street, King's Cross",137
"9181",2020,12,594,67,101,"51.513875","-0.117774","Kingsway Southbound, Strand",168
"9182",2020,12,595,176,170,"51.493267","-0.21985","Hammersmith Road, Hammersmith",346
"9183",2020,12,596,210,214,"51.472817","-0.199783","Parson's Green , Parson's Green",424
"9184",2020,12,597,120,108,"51.473471","-0.20782","Fulham Park Road, Fulham",228
"9185",2020,12,598,128,132,"51.494499","-0.228188","Southerton Road, Hammersmith",260
"9186",2020,12,599,82,78,"51.485743","-0.223616","Manbre Road, Hammersmith",160
"9187",2020,12,600,260,257,"51.481747","-0.124642","South Lambeth Road, Vauxhall",517
"9188",2020,12,601,115,126,"51.514767","-0.225787","BBC White City, White City",241
"9189",2020,12,602,175,153,"51.472993","-0.133972","Union Grove, Wandsworth Road",328
"9190",2020,12,603,159,174,"51.477839","-0.116493","Caldwell Street, Stockwell",333
"9191",2020,12,604,49,46,"51.538792","-0.138535","St Martins Close, Camden Town",95
"9192",2020,12,605,152,140,"51.520331","-0.163667","Seymour Place, Marylebone",292
"9193",2020,12,606,66,63,"51.504199","-0.210941","Addison Road, Holland Park",129
"9194",2020,12,607,117,123,"51.468814","-0.210279","Putney Bridge Station, Fulham",240
"9195",2020,12,608,17,15,"51.491093","-0.216493","Colet Gardens, Hammersmith",32
"9196",2020,12,609,99,83,"51.46512358","-0.157788279","Sugden Road, Clapham",182
"9197",2020,12,610,148,141,"51.48256792","-0.172078187","Danvers Street, West Chelsea",289
"9198",2020,12,611,122,105,"51.50646524","-0.208486599","Princedale Road , Holland Park",227
"9199",2020,12,612,187,182,"51.46925984","-0.141812513","Wandsworth Rd, Isley Court, Wandsworth Road",369
"9200",2020,12,613,234,238,"51.50403821","-0.217400093","Woodstock Grove, Shepherd's Bush",472
"9201",2020,12,614,82,106,"51.47817208","-0.144690541","Bradmead, Battersea Park",188
"9202",2020,12,615,149,146,"51.4768851","-0.215895601","Finlay Street, Fulham",295
"9203",2020,12,616,198,195,"51.48102131","-0.209973497","Aintree Street, Fulham",393
"9204",2020,12,617,112,87,"51.47107905","-0.207842908","Elysium Place, Fulham",199
"9205",2020,12,618,131,118,"51.47625965","-0.193254007","Eel Brook Common, Walham Green",249
"9206",2020,12,619,122,97,"51.4737636","-0.197010096","Irene Road, Parsons Green",219
"9207",2020,12,620,114,118,"51.47518024","-0.167160736","Surrey Lane, Battersea",232
"9208",2020,12,621,204,214,"51.46086446","-0.187427294","Wandsworth Town Station, Wandsworth",418
"9209",2020,12,622,169,190,"51.50748124","-0.205535908","Lansdowne Road, Ladbroke Grove",359
"9210",2020,12,623,68,64,"51.46193072","-0.180791784","Nantes Close, Wandsworth",132
"9211",2020,12,624,146,142,"51.4729184","-0.132102704","Courland Grove, Wandsworth Road",288
"9212",2020,12,625,437,440,"51.47761941","-0.149551631","Queen's Circus, Battersea Park",877
"9213",2020,12,626,223,197,"51.48438657","-0.20481514","Normand Park, West Kensington",420
"9214",2020,12,627,79,56,"51.4687905","-0.158230901","Holden Street, Battersea",135
"9215",2020,12,628,161,165,"51.46881971","-0.184318843","William Morris Way, Sands End",326
"9216",2020,12,629,35,47,"51.45995384","-0.190184054","Morie Street, Wandsworth",82
"9217",2020,12,630,101,90,"51.47073264","-0.126994068","Clarence Walk, Stockwell",191
"9218",2020,12,631,155,158,"51.4795017","-0.141770709","Battersea Park Road, Nine Elms",313
"9219",2020,12,632,96,104,"51.47053858","-0.163041605","Sheepcote Lane, Battersea",200
"9220",2020,12,633,160,152,"51.48959104","-0.209378594","Vereker Road, West Kensington",312
"9221",2020,12,634,104,91,"51.49434708","-0.215804559","Brook Green South, Brook Green",195
"9222",2020,12,635,136,130,"51.48606206","-0.214428378","Greyhound Road, Hammersmith",266
"9223",2020,12,636,122,115,"51.46706414","-0.193502076","South Park, Sands End",237
"9224",2020,12,637,82,74,"51.45787019","-0.174691623","Spencer Park, Wandsworth Common",156
"9225",2020,12,638,282,313,"51.46663393","-0.169821175","Falcon Road, Clapham Junction",595
"9226",2020,12,639,174,179,"51.48357068","-0.202038682","Coomer Place, West Kensington",353
"9227",2020,12,640,155,139,"51.47286577","-0.148059277","Silverthorne Road, Battersea",294
"9228",2020,12,641,101,95,"51.49824168","-0.117495865","Archbishop's Park, Waterloo",196
"9229",2020,12,642,77,64,"51.46916161","-0.174485792","Fawcett Close, Battersea",141
"9230",2020,12,643,79,67,"51.5190427","-0.204764421","All Saints' Road, Portobello",146
"9231",2020,12,644,144,137,"51.48373225","-0.223852256","Rainville Road, Hammersmith",281
"9232",2020,12,645,140,125,"51.50173215","-0.100292412","Great Suffolk Street, The Borough",265
"9233",2020,12,646,148,178,"51.49886563","-0.137424571","Buckingham Gate, Westminster",326
"9234",2020,12,647,125,122,"51.50035306","-0.217515071","Richmond Way, Shepherd's Bush",247
"9235",2020,12,648,72,65,"51.46904022","-0.19627483","Peterborough Road, Sands End",137
"9236",2020,12,649,147,161,"51.48180515","-0.18027465","World's End Place, West Chelsea",308
"9237",2020,12,650,123,116,"51.51687069","-0.213872396","St. Mark's Road, North Kensington",239
"9238",2020,12,651,116,106,"51.48089844","-0.183853573","Thorndike Close, West Chelsea",222
"9239",2020,12,652,29,43,"51.51148696","-0.218190203","Evesham Street, Avondale",72
"9240",2020,12,653,223,225,"51.47084722","-0.17070367","Simpson Street, Clapham Junction",448
"9241",2020,12,654,154,143,"51.48267821","-0.117661574","Ashmole Estate, Oval",297
"9242",2020,12,655,93,94,"51.48294452","-0.219346128","Crabtree Lane, Fulham",187
"9243",2020,12,656,64,49,"51.46841875","-0.199135704","Broomhouse Lane, Parsons Green",113
"9244",2020,12,657,74,63,"51.4996806","-0.221791552","Blythe Road West, Shepherd's Bush",137
"9245",2020,12,658,402,417,"51.47729232","-0.16478637","Ethelburga Estate, Battersea Park",819
"9246",2020,12,659,131,145,"51.511934","-0.10307894","Blackfriars Station, St. Paul's",276
"9247",2020,12,660,98,93,"51.49087074","-0.206029743","West Kensington Station, West Kensington",191
"9248",2020,12,661,236,234,"51.51632095","-0.202608612","All Saints Church, Portobello",470
"9249",2020,12,662,187,191,"51.48498496","-0.167919869","Phene Street, Chelsea",378
"9250",2020,12,663,58,64,"51.51323001","-0.211593602","Clarendon Road, Avondale",122
"9251",2020,12,664,204,194,"51.474376","-0.155442787","Austin Road, Battersea Park",398
"9252",2020,12,665,119,121,"51.46108367","-0.191722864","Smugglers Way, Wandsworth",240
"9253",2020,12,666,124,90,"51.49610093","-0.208158259","Olympia Way, Olympia",214
"9254",2020,12,667,146,161,"51.5015946","-0.222293381","Shepherd's Bush Road North, Shepherd's Bush",307
"9255",2020,12,668,289,308,"51.49422354","-0.236769936","Ravenscourt Park Station, Hammersmith",597
"9256",2020,12,669,97,87,"51.47614939","-0.1232585","Teversham Lane, Stockwell",184
"9257",2020,12,670,184,168,"51.46718562","-0.152248582","Ashley Crescent, Battersea",352
"9258",2020,12,671,161,158,"51.475089","-0.201968","Parsons Green Station, Parsons Green",319
"9259",2020,12,673,158,163,"51.46517078","-0.18038939","Hibbert Street, Battersea",321
"9260",2020,12,674,147,101,"51.53546778","-0.11619105","Carnegie Street, King's Cross",248
"9261",2020,12,675,126,112,"51.46348914","-0.182126248","Usk Road, Clapham Junction",238
"9262",2020,12,676,188,188,"51.47787084","-0.126874471","Hartington Road, Stockwell",376
"9263",2020,12,677,82,80,"51.46866929","-0.146544642","Heath Road, Battersea",162
"9264",2020,12,678,39,50,"51.46231278","-0.211468596","Esmond Street, Putney",89
"9265",2020,12,679,120,95,"51.47453545","-0.170210533","Orbel Street, Battersea",215
"9266",2020,12,680,249,243,"51.47768469","-0.170329317","Westbridge Road, Battersea",492
"9267",2020,12,681,236,238,"51.47303687","-0.214749808","Bishop's Avenue, Fulham",474
"9268",2020,12,682,291,285,"51.48810829","-0.22660621","Crisp Road, Hammersmith",576
"9269",2020,12,683,116,133,"51.46506424","-0.163750945","Dorothy Road, Clapham Junction",249
"9270",2020,12,684,163,155,"51.45475251","-0.195197203","Neville Gill Close, Wandsworth",318
"9271",2020,12,685,192,180,"51.46067005","-0.198735357","Osiers Road, Wandsworth",372
"9272",2020,12,686,113,123,"51.48814438","-0.222456468","Beryl Road, Hammersmith",236
"9273",2020,12,687,138,116,"51.49760804","-0.21145598","Maclise Road, Olympia",254
"9274",2020,12,688,87,83,"51.46095151","-0.20066766","Northfields, Wandsworth",170
"9275",2020,12,689,62,35,"51.45922541","-0.180884959","Spanish Road, Clapham Junction",97
"9276",2020,12,690,84,70,"51.47047503","-0.152130083","Stanley Grove, Battersea",154
"9277",2020,12,691,218,232,"51.47946386","-0.195777222","Erin Close, Walham Green",450
"9278",2020,12,692,342,310,"51.54211855","-0.028941601","Cadogan Close, Victoria Park",652
"9279",2020,12,693,100,107,"51.464786","-0.215618902","Felsham Road, Putney",207
"9280",2020,12,694,84,89,"51.46071722","-0.216526155","Putney Rail Station, Putney",173
"9281",2020,12,695,389,386,"51.53638435","-0.102757578","Islington Green, Angel",775
"9282",2020,12,696,125,129,"51.48728535","-0.217995921","Charing Cross Hospital, Hammersmith",254
"9283",2020,12,697,140,102,"51.53639219","-0.112721065","Charlotte Terrace, Angel",242
"9284",2020,12,698,126,104,"51.53908372","-0.070329419","Shoreditch Court, Haggerston",230
"9285",2020,12,699,63,60,"51.5366541","-0.07023031","Belford House, Haggerston",123
"9286",2020,12,700,166,152,"51.47696496","-0.174347066","Battersea Church Road, Battersea",318
"9287",2020,12,701,301,294,"51.47287627","-0.176267008","Vicarage Crescent, Battersea",595
"9288",2020,12,702,128,103,"51.52868155","-0.065550321","Durant Street, Bethnal Green",231
"9289",2020,12,703,152,228,"51.51505991","-0.10534448","St. Bride Street, Holborn",380
"9290",2020,12,704,72,67,"51.45682071","-0.202802098","Mexfield Road, East Putney",139
"9291",2020,12,705,75,59,NA,NA,NA,134
"9292",2020,12,706,146,168,"51.50215353","-0.083632928","Snowsfields, London Bridge",314
"9293",2020,12,707,144,140,"51.49021762","-0.215087092","Barons Court Station, West Kensington",284
"9294",2020,12,708,80,85,"51.46161068","-0.21614583","Disraeli Road, Putney",165
"9295",2020,12,709,82,97,"51.46321128","-0.215550761","Montserrat Road , Putney",179
"9296",2020,12,710,290,295,"51.47439218","-0.163347594","Albert Bridge Road, Battersea Park",585
"9297",2020,12,711,83,71,"51.48335692","-0.216305546","Everington Street, Fulham",154
"9298",2020,12,712,161,148,"51.51854104","-0.034903714","Mile End Stadium, Mile End",309
"9299",2020,12,713,36,43,"51.54100708","-0.14326094","Hawley Crescent, Camden Town",79
"9300",2020,12,714,65,49,"51.47311696","-0.137235175","Stewart's Road, Wandsworth Road",114
"9301",2020,12,715,95,97,"51.51563007","-0.049067243","Aylward Street, Stepney",192
"9302",2020,12,716,110,97,"51.51542791","-0.02356501","Stainsby Road , Poplar",207
"9303",2020,12,717,314,287,"51.53658514","-0.075885686","Dunston Road , Haggerston",601
"9304",2020,12,718,137,144,"51.53571683","-0.060291813","Ada Street, Hackney Central",281
"9305",2020,12,719,263,275,"51.53642464","-0.054162264","Victoria Park Road, Hackney Central",538
"9306",2020,12,720,131,102,"51.48724429","-0.205279052","Star Road, West Kensington",233
"9307",2020,12,721,89,90,"51.53603947","-0.026262677","Wendon Street, Old Ford",179
"9308",2020,12,722,108,99,"51.52458353","-0.058631453","Finnis Street, Bethnal Green",207
"9309",2020,12,723,240,229,"51.46822047","-0.190346493","Stephendale Road, Sands End",469
"9310",2020,12,724,85,52,"51.45799126","-0.184806157","Alma Road, Wandsworth",137
"9311",2020,12,725,234,216,"51.491327","-0.096518684","Walworth Square, Walworth",450
"9312",2020,12,726,173,168,"51.47505096","-0.150908371","Alfreda Street, Battersea Park",341
"9313",2020,12,727,179,182,"51.47569809","-0.20587627","Chesilton Road, Fulham",361
"9314",2020,12,728,99,77,"51.46199911","-0.206240805","Putney Bridge Road, East Putney",176
"9315",2020,12,729,193,148,"51.47893931","-0.208485293","St. Peter's Terrace, Fulham",341
"9316",2020,12,730,186,210,"51.49208492","-0.229116862","Bridge Avenue, Hammersmith",396
"9317",2020,12,731,98,108,"51.47727637","-0.189210466","Michael Road, Walham Green",206
"9318",2020,12,732,378,390,"51.50630441","-0.087262995","Duke Street Hill, London Bridge",768
"9319",2020,12,733,79,67,"51.50542628","-0.150817316","Park Lane, Mayfair",146
"9320",2020,12,734,74,74,"51.46230566","-0.175407201","Plough Terrace, Clapham Junction",148
"9321",2020,12,735,118,141,"51.46489445","-0.17302926","Grant Road East, Clapham Junction",259
"9322",2020,12,736,53,57,"51.50659035","-0.216104479","Queensdale Road, Shepherd's Bush",110
"9323",2020,12,737,367,401,"51.47993289","-0.19411695","Fulham Broadway, Walham Green",768
"9324",2020,12,738,121,96,"51.47514228","-0.187278987","Imperial Road, Sands End",217
"9325",2020,12,739,148,133,"51.48176572","-0.185273723","Hortensia Road, West Brompton",281
"9326",2020,12,740,25,28,"51.51092871","-0.214594781","Sirdar Road, Avondale",53
"9327",2020,12,741,37,34,"51.5129814","-0.219486603","Freston Road, Avondale",71
"9328",2020,12,742,144,154,"51.51510818","-0.208565479","Blenheim Crescent, Ladbroke Grove",298
"9329",2020,12,743,53,65,"51.46079243","-0.212607684","Oxford Road, Putney",118
"9330",2020,12,744,48,42,"51.46745485","-0.172293499","Ingrave Street, Clapham Junction",90
"9331",2020,12,745,75,69,"51.47816972","-0.18243547","Upcerne Road, West Chelsea",144
"9332",2020,12,746,119,101,"51.4795738","-0.17903854","Lots Road, West Chelsea",220
"9333",2020,12,747,118,120,"51.48796408","-0.161765173","Ormonde Gate, Chelsea",238
"9334",2020,12,748,201,179,"51.53727795","-0.079201849","Hertford Road, De Beauvoir Town",380
"9335",2020,12,749,258,250,"51.53932857","-0.074284675","Haggerston Road, Haggerston",508
"9336",2020,12,750,42,45,"51.4710956","-0.157850096","Culvert Road, Battersea",87
"9337",2020,12,751,82,73,"51.51612862","-0.120909408","Newton Street, Covent Garden",155
"9338",2020,12,754,48,48,"51.5129006","-0.214762686","Grenfell Road, Avondale",96
"9339",2020,12,755,171,163,"51.48512191","-0.174971902","The Vale, Chelsea",334
"9340",2020,12,756,158,174,"51.47515398","-0.159169801","Prince of Wales Drive, Battersea Park",332
"9341",2020,12,757,187,171,"51.48795853","-0.187404506","Harcourt Terrace, West Brompton",358
"9342",2020,12,758,114,105,"51.51787005","-0.201005397","Westbourne Park Road, Portobello",219
"9343",2020,12,759,56,46,"51.52456169","-0.165668686","Broadley Terrace, Marylebone",102
"9344",2020,12,760,42,27,"51.52526975","-0.163795009","Rossmore Road, Marylebone",69
"9345",2020,12,761,121,115,"51.48321729","-0.211860644","Humbolt Road, Fulham",236
"9346",2020,12,762,360,439,"51.50070305","-0.129698963","Storey's Gate, Westminster",799
"9347",2020,12,763,144,126,"51.52059714","-0.032566533","Mile End Park Leisure Centre, Mile End",270
"9348",2020,12,764,174,240,"51.46239255","-0.16829214","St. John's Road, Clapham Junction",414
"9349",2020,12,765,94,91,"51.46760141","-0.20682737","Ranelagh Gardens, Fulham",185
"9350",2020,12,766,215,210,"51.45752945","-0.192165613","Ram Street, Wandsworth",425
"9351",2020,12,767,44,36,"51.45705988","-0.200806304","Santos Road, Wandsworth",80
"9352",2020,12,768,308,312,"51.46134382","-0.159322467","Clapham Common North Side, Clapham Common",620
"9353",2020,12,769,147,148,"51.473611","-0.191803","Sandilands Road, Walham Green",295
"9354",2020,12,770,109,94,"51.491026","-0.209121","Gwendwr Road, West Kensington",203
"9355",2020,12,771,38,48,"51.509224","-0.216016","Rifle Place, Avondale",86
"9356",2020,12,772,221,246,"51.47250956","-0.122831913","Binfield Road, Stockwell",467
"9357",2020,12,773,221,235,"51.511891","-0.107349","Tallis Street, Temple",456
"9358",2020,12,774,60,62,"51.470131","-0.20464","Hurlingham Park, Parsons Green",122
"9359",2020,12,775,97,102,"51.496664","-0.223868","Little Brook Green, Brook Green",199
"9360",2020,12,776,116,118,"51.460333","-0.167029","Abyssinia Close, Clapham Junction",234
"9361",2020,12,777,55,53,"51.4619230679","-0.165297856693","Limburg Road, Clapham Junction",108
"9362",2020,12,779,153,176,"51.514449","-0.077178979","Houndsditch, Aldgate",329
"9363",2020,12,780,257,248,"51.474665","-0.18316517","Imperial Wharf Station, Sands End",505
"9364",2020,12,781,70,64,"51.495898","-0.173009","Victoria & Albert Museum, South Kensington",134
"9365",2020,12,782,168,158,"51.483911","-0.19760944","Halford Road, West Kensington",326
"9366",2020,12,783,274,271,"51.5403115","-0.021630359","Monier Road, Hackney Wick",545
"9367",2020,12,784,218,234,"51.546326","-0.00993526","East Village, Queen Elizabeth Olympic Park",452
"9368",2020,12,785,483,496,"51.54094","-0.010510565","Aquatic Centre, Queen Elizabeth Olympic Park",979
"9369",2020,12,786,185,162,"51.549369","-0.015717614","Lee Valley VeloPark, Queen Elizabeth Olympic Park",347
"9370",2020,12,787,220,245,"51.546805","-0.01469126","Timber Lodge, Queen Elizabeth Olympic Park",465
"9371",2020,12,789,255,249,"51.538718","-0.011889482","Podium, Queen Elizabeth Olympic Park",504
"9372",2020,12,790,160,184,"51.541793","-0.00481","Stratford Station, Stratford",344
"9373",2020,12,792,115,142,"51.505461","-0.10454093","Blackfriars Road, Southwark",257
"9374",2020,12,793,89,92,"51.528279","-0.11955857","Cromer Street, Bloomsbury",181
"9375",2020,12,795,77,73,"51.527068","-0.13186102","Euston Square Gardens, Euston",150
"9376",2020,12,796,105,85,"51.524","-0.12640984","Coram Street, Bloomsbury",190
"9377",2020,12,797,102,86,"51.5293","-0.12827903","Ossulston Street, Somers Town",188
"9378",2020,12,798,132,147,"51.5301998755","-0.122299440803","Birkenhead Street, King's Cross",279
"9379",2020,12,799,122,133,"51.4976984561","-0.137598896295","Kings Gate House, Westminster",255
"9380",2020,12,800,296,290,"51.4811219398","-0.149035374873","Sopwith Way, Battersea Park",586
"9381",2020,12,801,123,138,"51.5052241745","-0.0980318118664","Lavington Street, Bankside",261
"9382",2020,12,802,170,147,"51.4765900593","-0.118256789081","Albert Square, Stockwell",317
"9383",2020,12,803,125,119,"51.5054099403","-0.0983410884509","Southwark Street, Bankside",244
"9384",2020,12,804,130,185,"51.5346677396","-0.125078652873","Good's Way, King's Cross",315
"9385",2020,12,806,153,126,"51.5372405623","-0.124807385707","Handyside Street, King's Cross",279
"9386",2020,12,807,207,204,"51.5212","-0.20888818","Bevington Road West, North Kensington",411
"9387",2020,12,809,107,95,"51.5162778834","-0.118272991635","Lincoln's Inn Fields, Holborn",202
"9388",2020,12,810,113,125,"51.5067252868","-0.0988072461627","Tate Modern, Bankside",238
"9389",2020,12,811,268,262,"51.5057030357","-0.0277727426235","Westferry Circus, Canary Wharf",530
"9390",2020,12,812,91,87,"51.5487311915","-0.0226065549321","Here East North, Queen Elizabeth Olympic Park",178
"9391",2020,12,813,79,125,"51.4878074485","-0.122759625866","New Spring Gardens Walk, Vauxhall",204
"9392",2020,12,814,132,130,"51.4714330677","-0.123670735702","Clapham Road, Lingham Street, Stockwell",262
"9393",2020,12,815,220,248,"51.5000891978","-0.116628700672","Lambeth Palace Road, Waterloo",468
"9394",2020,12,816,46,51,"51.5465327935","-0.0205975904647","Here East South, Queen Elizabeth Olympic Park",97
"9395",2020,12,817,237,237,"51.4813354746","-0.138212295869","Riverlight South, Nine Elms",474
"9396",2020,12,818,387,389,"51.501513","-0.12382322","Westminster Pier, Westminster",776
"9397",2020,12,819,78,79,"51.50621","-0.114842","Belvedere Road 2, South Bank",157
"9398",2020,12,820,128,106,"51.492807","-0.091938","Victory Place, Walworth",234
"9399",2020,12,821,366,319,"51.4835074867","-0.147714557371","Battersea Power Station, Battersea Park",685
"9400",2020,12,826,225,253,"51.496863","-0.1429434","Allington Street, Victoria",478
"9401",2020,12,827,215,212,"51.479601","-0.11147178","Cranmer Road, Stockwell",427
"9402",2020,12,828,153,134,"51.473874","-0.11258096","Normandy Road, Stockwell",287
"9403",2020,12,829,73,77,"51.469217","-0.11268674","Wynne Road, Stockwell",150
"9404",2020,12,830,113,85,"51.469202","-0.11902256","Sidney Road, Stockwell",198
"9405",2020,12,831,96,100,"51.466232","-0.11317995","St John's Crescent, Brixton",196
"9406",2020,12,832,226,243,"51.464019","-0.11578197","Ferndale Road, Brixton",469
"9407",2020,12,833,335,314,"51.460232","-0.11537509","Saltoun Road, Brixton",649
"9408",2020,12,834,224,240,"51.477966","-0.14785703","Gas Holders, Battersea Park",464
"9409",2020,12,835,98,107,"51.516785","-0.10494775","Farringdon Street, Holborn",205
"9410",2020,12,836,109,95,"51.541596","-0.12544145","York Way, Kings Cross",204
"9411",2020,12,838,90,82,"51.518093","-0.0914017","Fore Street Avenue, Guildhall",172
"9412",2020,12,839,144,164,"51.508033","-0.10682363","Sea Containers, South Bank",308
"9413",2020,13,1,67,57,"51.52916347","-0.109970527","River Street , Clerkenwell",124
"9414",2020,13,2,129,160,"51.49960695","-0.197574246","Phillimore Gardens, Kensington",289
"9415",2020,13,3,24,26,"51.52128377","-0.084605692","Christopher Street, Liverpool Street",50
"9416",2020,13,4,34,41,"51.53005939","-0.120973687","St. Chad's Street, King's Cross",75
"9417",2020,13,5,90,77,"51.49313","-0.156876","Sedding Street, Sloane Square",167
"9418",2020,13,6,85,88,"51.51811784","-0.144228881","Broadcasting House, Marylebone",173
"9419",2020,13,7,94,98,"51.53430039","-0.1680743","Charlbert Street, St. John's Wood",192
"9420",2020,13,8,117,118,"51.529857","-0.18348604","Maida Vale, Maida Vale",235
"9421",2020,13,9,93,95,"51.5073853","-0.096440751","New Globe Walk, Bankside",188
"9422",2020,13,10,40,38,"51.50597426","-0.092754157","Park Street, Bankside",78
"9423",2020,13,11,83,92,"51.52395143","-0.122502346","Brunswick Square, Bloomsbury",175
"9424",2020,13,12,53,47,"51.52168078","-0.130431727","Malet Street, Bloomsbury",100
"9425",2020,13,13,59,57,"51.51991453","-0.136039674","Scala Street, Fitzrovia",116
"9426",2020,13,14,133,121,"51.52994371","-0.123616824","Belgrove Street , King's Cross",254
"9427",2020,13,15,43,40,"51.51772703","-0.127854211","Great Russell Street, Bloomsbury",83
"9428",2020,13,16,60,49,"51.52635795","-0.125979294","Cartwright Gardens , Bloomsbury",109
"9429",2020,13,17,88,91,"51.5216612","-0.109006325","Hatton Wall, Holborn",179
"9430",2020,13,18,95,81,"51.51477076","-0.12221963","Drury Lane, Covent Garden",176
"9431",2020,13,19,32,39,"51.52505093","-0.131161087","Taviton Street, Bloomsbury",71
"9432",2020,13,20,29,19,"51.527326","-0.13605286","Drummond Street , Euston",48
"9433",2020,13,21,32,43,"51.53007835","-0.13884627","Hampstead Road (Cartmel), Euston",75
"9434",2020,13,22,114,119,"51.5222641","-0.114079481","Northington Street , Holborn",233
"9435",2020,13,23,41,33,"51.51943538","-0.119123345","Red Lion Square, Holborn",74
"9436",2020,13,24,89,77,"51.51908011","-0.124678402","British Museum, Bloomsbury",166
"9437",2020,13,25,53,46,"51.5288338","-0.132250369","Doric Way , Somers Town",99
"9438",2020,13,26,61,42,"51.52728093","-0.11829517","Ampton Street , Clerkenwell",103
"9439",2020,13,27,59,49,"51.51382102","-0.107927706","Bouverie Street, Temple",108
"9440",2020,13,28,132,126,"51.52351808","-0.143613641","Bolsover Street, Fitzrovia",258
"9441",2020,13,29,118,94,"51.513735","-0.193487","Hereford Road, Bayswater",212
"9442",2020,13,30,91,78,"51.52915444","-0.093421615","Windsor Terrace, Hoxton",169
"9443",2020,13,31,62,92,"51.52953709","-0.083353323","Fanshaw Street, Hoxton",154
"9444",2020,13,32,70,82,"51.52469624","-0.084439283","Leonard Circus , Shoreditch",152
"9445",2020,13,33,50,58,"51.5156","-0.070056","Central House, Aldgate",108
"9446",2020,13,34,52,51,"51.5341235","-0.129386874","Pancras Road, King's Cross",103
"9447",2020,13,36,155,162,"51.50173726","-0.184980612","De Vere Gardens, Kensington",317
"9448",2020,13,37,111,106,"51.49159394","-0.192369256","Penywern Road, Earl's Court",217
"9449",2020,13,38,82,81,"51.4973875","-0.197245586","Abingdon Villas, Kensington",163
"9450",2020,13,39,116,127,"51.5263778","-0.078130921","Shoreditch High Street, Shoreditch",243
"9451",2020,13,40,54,59,"51.52127071","-0.0755789","Commercial Street, Shoreditch",113
"9452",2020,13,41,48,50,"51.520955","-0.083493552","Pindar Street, Liverpool Street",98
"9453",2020,13,42,104,108,"51.53099181","-0.093903825","Wenlock Road , Hoxton",212
"9454",2020,13,43,83,91,"51.52026","-0.157183945","Crawford Street, Marylebone",174
"9455",2020,13,44,67,74,"51.51073687","-0.144165239","Bruton Street, Mayfair",141
"9456",2020,13,45,90,83,"51.522511","-0.162298","Boston Place, Marylebone",173
"9457",2020,13,46,182,170,"51.507131","-0.06691","Nesham Street, Wapping",352
"9458",2020,13,47,213,200,"51.52334476","-0.183846408","Warwick Avenue Station, Maida Vale",413
"9459",2020,13,48,68,92,"51.51248445","-0.099141408","Godliman Street, St. Paul's",160
"9460",2020,13,49,53,54,"51.50706909","-0.145904427","Curzon Street, Mayfair",107
"9461",2020,13,50,62,50,"51.52867339","-0.087459376","East Road, Hoxton",112
"9462",2020,13,51,37,46,"51.52671796","-0.104298194","Finsbury Library , Finsbury",83
"9463",2020,13,52,80,86,"51.52295439","-0.094934859","Roscoe Street, St. Luke's",166
"9464",2020,13,53,44,46,"51.5099923","-0.143495266","Grafton Street, Mayfair",90
"9465",2020,13,54,84,71,"51.52174785","-0.094475072","Golden Lane, Barbican",155
"9466",2020,13,55,79,79,"51.51707521","-0.086685542","Finsbury Circus, Liverpool Street",158
"9467",2020,13,56,72,70,"51.52058381","-0.154701411","Paddington Street, Marylebone",142
"9468",2020,13,57,120,123,"51.52334672","-0.120202614","Guilford Street , Bloomsbury",243
"9469",2020,13,58,69,60,"51.52452699","-0.079248081","New Inn Yard, Shoreditch",129
"9470",2020,13,60,69,67,"51.52644828","-0.172190727","Lisson Grove, St. John's Wood",136
"9471",2020,13,61,91,83,"51.49738251","-0.089446947","Great Dover Street, The Borough",174
"9472",2020,13,62,73,60,"51.4907579","-0.106323685","Cotton Garden Estate, Kennington",133
"9473",2020,13,63,62,49,"51.53089041","-0.089782579","Murray Grove , Hoxton",111
"9474",2020,13,64,56,73,"51.50946212","-0.124749274","William IV Street, Strand",129
"9475",2020,13,65,59,51,NA,NA,NA,110
"9476",2020,13,66,104,108,"51.51795029","-0.108657431","Holborn Circus, Holborn",212
"9477",2020,13,67,41,41,"51.51882555","-0.108028472","Hatton Garden, Holborn",82
"9478",2020,13,68,85,76,"51.52059681","-0.116688468","Theobald's Road , Holborn",161
"9479",2020,13,69,40,42,"51.5262363","-0.134407652","Euston Road, Euston",82
"9480",2020,13,70,18,32,"51.53136059","-0.117069978","Calshot Street , King's Cross",50
"9481",2020,13,71,115,94,"51.5154186","-0.098850915","Newgate Street , St. Paul's",209
"9482",2020,13,72,59,60,"51.52352001","-0.108340165","Farringdon Lane, Clerkenwell",119
"9483",2020,13,73,82,98,"51.52572618","-0.088486188","Old Street Station, St. Luke's",180
"9484",2020,13,74,202,202,"51.48591714","-0.124469948","Vauxhall Cross, Vauxhall",404
"9485",2020,13,75,43,50,"51.53219984","-0.105480698","Torrens Street, Angel",93
"9486",2020,13,76,69,57,"51.52559505","-0.144083893","Longford Street, The Regent's Park",126
"9487",2020,13,77,67,90,"51.52341837","-0.124121774","Russell Square Station, Bloomsbury",157
"9488",2020,13,78,71,66,"51.52486887","-0.099489485","Sadlers Sports Centre, Finsbury",137
"9489",2020,13,79,50,62,"51.511726","-0.11385596","Arundel Street, Temple",112
"9490",2020,13,80,103,89,"51.50069361","-0.102091246","Webber Street , Southwark",192
"9491",2020,13,81,83,77,"51.52025302","-0.141327271","Great Titchfield Street, Fitzrovia",160
"9492",2020,13,82,40,47,"51.514274","-0.111257","Chancery Lane, Holborn",87
"9493",2020,13,83,94,93,"51.50963938","-0.131510949","Panton Street, West End",187
"9494",2020,13,84,4,7,"51.51593725","-0.111778348","Breams Buildings, Holborn",11
"9495",2020,13,85,157,169,"51.50064702","-0.078600401","Tanner Street, Bermondsey",326
"9496",2020,13,86,61,64,"51.48947903","-0.115156562","Sancroft Street, Vauxhall",125
"9497",2020,13,87,53,59,"51.51646835","-0.079684557","Devonshire Square, Liverpool Street",112
"9498",2020,13,88,104,85,"51.51858757","-0.132053392","Bayley Street , Bloomsbury",189
"9499",2020,13,89,96,72,"51.5262503","-0.123509611","Tavistock Place, Bloomsbury",168
"9500",2020,13,90,11,19,"51.53301907","-0.139174593","Harrington Square 1, Camden Town",30
"9501",2020,13,91,140,121,"51.49368637","-0.111014912","Walnut Tree Walk, Vauxhall",261
"9502",2020,13,92,57,70,"51.49889832","-0.100440521","Borough Road, Elephant & Castle",127
"9503",2020,13,93,57,49,"51.53440868","-0.109025404","Cloudesley Road, Angel",106
"9504",2020,13,94,175,186,"51.49506109","-0.085814489","Bricklayers Arms, Borough",361
"9505",2020,13,95,142,138,"51.5208417","-0.097340162","Aldersgate Street, Barbican",280
"9506",2020,13,96,85,86,"51.53095071","-0.078505384","Falkirk Street, Hoxton",171
"9507",2020,13,97,123,143,"51.49792478","-0.183834706","Gloucester Road (North), Kensington",266
"9508",2020,13,98,95,98,"51.52554222","-0.138231303","Hampstead Road, Euston",193
"9509",2020,13,99,146,157,"51.51457763","-0.158264483","Old Quebec Street, Marylebone",303
"9510",2020,13,100,126,116,"51.49043573","-0.122806861","Albert Embankment, Vauxhall",242
"9511",2020,13,101,130,133,"51.51155322","-0.0929401","Queen Street 1, Bank",263
"9512",2020,13,102,79,87,"51.51340693","-0.076793375","Jewry Street, Aldgate",166
"9513",2020,13,103,70,70,"51.50472376","-0.192538767","Vicarage Gate, Kensington",140
"9514",2020,13,104,94,107,"51.51159481","-0.077121322","Crosswall, Tower",201
"9515",2020,13,105,105,117,"51.51552971","-0.190240716","Westbourne Grove, Bayswater",222
"9516",2020,13,106,25,19,"51.51410514","-0.147301667","Woodstock Street, Mayfair",44
"9517",2020,13,107,111,111,"51.52600832","-0.096317627","Finsbury Leisure Centre, St. Luke's",222
"9518",2020,13,108,84,83,"51.49812559","-0.132102166","Abbey Orchard Street, Westminster",167
"9519",2020,13,109,110,113,"51.51563144","-0.132328837","Soho Square , Soho",223
"9520",2020,13,110,81,88,"51.53304322","-0.172528678","Wellington Road, St. John's Wood",169
"9521",2020,13,111,160,154,"51.5100172","-0.157275636","Park Lane , Hyde Park",314
"9522",2020,13,112,39,40,"51.51580998","-0.105270275","Stonecutter Street, Holborn",79
"9523",2020,13,113,123,136,"51.49646288","-0.183289032","Gloucester Road (Central), South Kensington",259
"9524",2020,13,114,172,183,"51.52451738","-0.158963647","Park Road (Baker Street), The Regent's Park",355
"9525",2020,13,115,151,141,"51.51423368","-0.073537654","Braham Street, Aldgate",292
"9526",2020,13,116,98,94,"51.51449962","-0.141423695","Little Argyll Street, West End",192
"9527",2020,13,117,123,106,"51.49288067","-0.114934001","Lollard Street, Vauxhall",229
"9528",2020,13,118,54,63,"51.49582705","-0.13547809","Rochester Row, Westminster",117
"9529",2020,13,119,127,137,"51.52589324","-0.090847761","Bath Street, St. Luke's",264
"9530",2020,13,120,55,46,"51.51573534","-0.093080779","The Guildhall, Guildhall",101
"9531",2020,13,121,65,45,"51.51891348","-0.156166631","Baker Street, Marylebone",110
"9532",2020,13,122,74,70,"51.52111369","-0.078869751","Norton Folgate, Liverpool Street",144
"9533",2020,13,123,66,63,"51.52836014","-0.104724625","St. John Street, Finsbury",129
"9534",2020,13,124,53,61,"51.49654462","-0.150905245","Eaton Square, Belgravia",114
"9535",2020,13,125,79,73,"51.50069491","-0.094524319","Borough High Street, The Borough",152
"9536",2020,13,126,39,38,"51.51782144","-0.096496865","Museum of London, Barbican",77
"9537",2020,13,127,43,43,"51.51700801","-0.09388536","Wood Street, Guildhall",86
"9538",2020,13,128,103,101,"51.49536226","-0.185296516","Emperor's Gate, South Kensington",204
"9539",2020,13,129,70,73,"51.5118973","-0.137043852","Golden Square, Soho",143
"9540",2020,13,130,192,192,"51.50950627","-0.075459482","Tower Gardens , Tower",384
"9541",2020,13,131,47,50,"51.53300545","-0.136792671","Eversholt Street , Camden Town",97
"9542",2020,13,132,165,166,"51.52364804","-0.074754872","Bethnal Green Road, Shoreditch",331
"9543",2020,13,133,203,197,NA,NA,NA,400
"9544",2020,13,134,135,129,"51.504904","-0.06797","Wapping High Street, Wapping",264
"9545",2020,13,135,76,84,"51.52326004","-0.104708922","Clerkenwell Green, Clerkenwell",160
"9546",2020,13,136,112,99,"51.51196176","-0.097441687","Queen Victoria Street, St. Paul's",211
"9547",2020,13,138,82,76,"51.51227622","-0.157436972","Green Street, Mayfair",158
"9548",2020,13,139,72,66,"51.49488108","-0.117974901","Lambeth Road, Vauxhall",138
"9549",2020,13,140,69,70,"51.52096262","-0.085634242","Finsbury Square , Moorgate",139
"9550",2020,13,141,52,49,"51.51530805","-0.147203711","Chapel Place, Marylebone",101
"9551",2020,13,142,127,128,"51.49372451","-0.198286569","West Cromwell Road, Earl's Court",255
"9552",2020,13,143,79,69,"51.4968865","-0.161203828","Pont Street, Knightsbridge",148
"9553",2020,13,144,174,178,"51.48894022","-0.111435796","Kennington Cross, Kennington",352
"9554",2020,13,145,65,57,"51.50074359","-0.202759212","Ilchester Place, Kensington",122
"9555",2020,13,146,78,81,"51.48836528","-0.129361842","Vauxhall Bridge , Pimlico",159
"9556",2020,13,148,127,133,"51.49211134","-0.138364847","Tachbrook Street, Victoria",260
"9557",2020,13,149,155,166,"51.48478899","-0.110683213","Kennington Road Post Office, Oval",321
"9558",2020,13,150,101,101,"51.49705603","-0.168917077","Holy Trinity Brompton, Knightsbridge",202
"9559",2020,13,151,90,85,"51.51213691","-0.201554966","Chepstow Villas, Notting Hill",175
"9560",2020,13,152,119,120,"51.49217002","-0.101536865","Hampton Street, Walworth",239
"9561",2020,13,153,214,226,"51.511933","-0.174411","Bayswater Road, Hyde Park",440
"9562",2020,13,154,107,65,"51.50379168","-0.11282408","Waterloo Station 3, Waterloo",172
"9563",2020,13,155,91,99,"51.49586666","-0.191933711","Lexham Gardens, Kensington",190
"9564",2020,13,156,49,65,"51.49443626","-0.092921165","New Kent Road, The Borough",114
"9565",2020,13,157,89,104,"51.50039792","-0.193068385","Wright's Lane, Kensington",193
"9566",2020,13,158,97,112,"51.49085368","-0.196170309","Trebovir Road, Earl's Court",209
"9567",2020,13,159,83,79,"51.51461995","-0.137841333","Great Marlborough Street, Soho",162
"9568",2020,13,160,57,53,"51.50663341","-0.131773845","Waterloo Place, St. James's",110
"9569",2020,13,161,64,75,"51.49234577","-0.141334487","Guildhouse Street, Victoria",139
"9570",2020,13,162,43,60,"51.51760685","-0.121328408","Southampton Place, Holborn",103
"9571",2020,13,163,134,150,"51.4931848","-0.167894973","Sloane Avenue, Knightsbridge",284
"9572",2020,13,164,96,99,"51.515607","-0.183118788","Cleveland Gardens, Bayswater",195
"9573",2020,13,165,57,49,"51.517932","-0.183716959","Orsett Terrace, Bayswater",106
"9574",2020,13,166,88,81,"51.50185512","-0.159237081","Seville Street, Knightsbridge",169
"9575",2020,13,167,64,72,"51.49395092","-0.147624377","Eccleston Place, Victoria",136
"9576",2020,13,168,80,90,"51.50040123","-0.195455928","Argyll Road, Kensington",170
"9577",2020,13,169,179,193,"51.51474612","-0.165164288","Porchester Place, Paddington",372
"9578",2020,13,170,21,29,"51.52784273","-0.108068155","Hardwick Street, Clerkenwell",50
"9579",2020,13,171,89,78,"51.4916156","-0.186753859","Collingham Gardens, Earl's Court",167
"9580",2020,13,172,118,116,"51.49121192","-0.173715911","Sumner Place, South Kensington",234
"9581",2020,13,173,40,42,"51.50486","-0.113001","Waterloo Road, South Bank",82
"9582",2020,13,174,29,30,"51.512529","-0.115163","Strand, Strand",59
"9583",2020,13,175,36,38,"51.521668","-0.079608554","Worship Street, Shoreditch",74
"9584",2020,13,176,74,86,"51.51791921","-0.188098863","Gloucester Terrace, Bayswater",160
"9585",2020,13,177,97,110,"51.49616092","-0.140947636","Ashley Place, Victoria",207
"9586",2020,13,178,200,180,"51.48985626","-0.141923621","Warwick Square, Pimlico",380
"9587",2020,13,180,94,89,"51.5129118","-0.153645496","North Audley Street, Mayfair",183
"9588",2020,13,181,50,55,"51.49941247","-0.152317537","Belgrave Square, Belgravia",105
"9589",2020,13,182,90,100,"51.52202903","-0.165842551","Bell Street , Marylebone",190
"9590",2020,13,183,261,270,"51.482362","-0.13612398","Riverlight North, Nine Elms",531
"9591",2020,13,184,100,87,"51.52071513","-0.14521173","Portland Place, Marylebone",187
"9592",2020,13,185,146,142,"51.48805753","-0.140741432","Alderney Street, Pimlico",288
"9593",2020,13,186,143,132,"51.51733558","-0.175810943","South Wharf Road, Paddington",275
"9594",2020,13,187,137,118,"51.49247977","-0.178433004","Queen's Gate (South), South Kensington",255
"9595",2020,13,188,44,47,"51.5165179","-0.164393768","Nutford Place, Marylebone",91
"9596",2020,13,189,51,23,"51.53166681","-0.109914711","Claremont Square, Angel",74
"9597",2020,13,190,111,98,"51.48997562","-0.132845681","Rampayne Street, Pimlico",209
"9598",2020,13,191,528,537,"51.50311799","-0.153520935","Hyde Park Corner, Hyde Park",1065
"9599",2020,13,192,176,172,"51.51251523","-0.133201961","Wardour Street, Soho",348
"9600",2020,13,193,53,50,"51.50581776","-0.100186337","Bankside Mix, Bankside",103
"9601",2020,13,194,212,246,"51.50462759","-0.091773776","Hop Exchange, The Borough",458
"9602",2020,13,195,111,123,"51.50724437","-0.106237501","Milroy Walk, South Bank",234
"9603",2020,13,196,67,79,"51.50368837","-0.098497684","Union Street, The Borough",146
"9604",2020,13,197,48,39,"51.50556905","-0.111606696","Stamford Street, South Bank",87
"9605",2020,13,199,99,97,"51.51048489","-0.082989638","Great Tower Street, Monument",196
"9606",2020,13,200,118,106,"51.51492456","-0.066078037","LMU Commercial Road, Whitechapel",224
"9607",2020,13,201,121,130,"51.5225965","-0.161113413","Dorset Square, Marylebone",251
"9608",2020,13,202,142,146,"51.51236389","-0.06954201","Leman Street, Aldgate",288
"9609",2020,13,203,81,94,"51.51821864","-0.100791005","West Smithfield Rotunda, Farringdon",175
"9610",2020,13,204,51,47,"51.52659961","-0.112432615","Margery Street, Clerkenwell",98
"9611",2020,13,206,117,111,"51.518154","-0.062697","New Road 1 , Whitechapel",228
"9612",2020,13,207,37,39,"51.50135267","-0.153194766","Grosvenor Crescent, Belgravia",76
"9613",2020,13,208,49,44,"51.52505151","-0.166304359","Mallory Street, Marylebone",93
"9614",2020,13,209,48,37,"51.49358391","-0.165101392","Denyer Street, Knightsbridge",85
"9615",2020,13,210,83,85,"51.51681444","-0.151926305","Hinde Street, Marylebone",168
"9616",2020,13,211,88,90,"51.49464523","-0.158105512","Cadogan Place, Knightsbridge",178
"9617",2020,13,212,65,39,"51.50658458","-0.199004026","Campden Hill Road, Notting Hill",104
"9618",2020,13,213,333,335,"51.50274025","-0.149569201","Wellington Arch, Hyde Park",668
"9619",2020,13,214,31,41,"51.52683806","-0.130504336","Endsleigh Gardens, Euston",72
"9620",2020,13,215,50,40,"51.51906932","-0.088285377","Moorfields, Moorgate",90
"9621",2020,13,216,120,112,"51.49094565","-0.181190899","Old Brompton Road, South Kensington",232
"9622",2020,13,217,151,176,"51.51615461","-0.082422399","Wormwood Street, Liverpool Street",327
"9623",2020,13,218,108,115,"51.48971651","-0.170194408","St. Luke's Church, Chelsea",223
"9624",2020,13,219,206,198,"51.49016361","-0.19039362","Bramham Gardens, Earl's Court",404
"9625",2020,13,220,97,82,"51.49066456","-0.166485083","Chelsea Green, Chelsea",179
"9626",2020,13,221,69,83,"51.49481649","-0.13045856","Horseferry Road, Westminster",152
"9627",2020,13,222,50,39,"51.50275704","-0.155349725","Knightsbridge, Hyde Park",89
"9628",2020,13,223,122,137,"51.49148474","-0.090220911","Rodney Road , Walworth",259
"9629",2020,13,224,145,136,"51.51031","-0.18740235","Queensway, Kensington Gardens",281
"9630",2020,13,225,153,131,"51.50935342","-0.196422","Notting Hill Gate Station, Notting Hill",284
"9631",2020,13,226,38,46,"51.50844614","-0.131961389","Charles II Street, West End",84
"9632",2020,13,227,62,69,"51.52891573","-0.115480888","Great Percy Street, Clerkenwell",131
"9633",2020,13,228,85,95,"51.50742485","-0.134621209","St. James's Square, St. James's",180
"9634",2020,13,229,108,126,"51.50654321","-0.123179697","Whitehall Place, Strand",234
"9635",2020,13,230,46,42,"51.50669284","-0.103137426","Poured Lines, Bankside",88
"9636",2020,13,231,68,65,"51.49396755","-0.17873226","Queen's Gate (Central), South Kensington",133
"9637",2020,13,232,13,12,"51.51501025","-0.112753217","Carey Street, Holborn",25
"9638",2020,13,233,58,93,"51.50777049","-0.130699733","Pall Mall East, West End",151
"9639",2020,13,234,163,163,"51.53450449","-0.106992706","Liverpool Road (N1 Centre), Angel",326
"9640",2020,13,235,64,67,"51.49571828","-0.110889274","Kennington Road  , Vauxhall",131
"9641",2020,13,236,36,37,"51.51838043","-0.073438925","Fashion Street, Whitechapel",73
"9642",2020,13,237,130,131,"51.5097860151","-0.0681619805156","Dock Street, Wapping",261
"9643",2020,13,238,54,51,"51.5233534","-0.175116099","Frampton Street, Paddington",105
"9644",2020,13,239,111,105,"51.52443845","-0.138019439","Warren Street Station, Euston",216
"9645",2020,13,240,21,22,"51.50545935","-0.10569204","Colombo Street, Southwark",43
"9646",2020,13,242,84,96,"51.52200801","-0.151359288","Beaumont Street, Marylebone",180
"9647",2020,13,243,180,169,"51.49096258","-0.139625122","Gloucester Street, Pimlico",349
"9648",2020,13,244,64,70,"51.51611887","-0.128585022","Earnshaw Street , Covent Garden",134
"9649",2020,13,245,105,94,"51.4853572","-0.142207481","Grosvenor Road, Pimlico",199
"9650",2020,13,246,86,83,"51.52285301","-0.099994052","Berry Street, Clerkenwell",169
"9651",2020,13,247,89,96,"51.530529","-0.167515","St. John's Wood Church, The Regent's Park",185
"9652",2020,13,248,370,382,"51.50645179","-0.170279555","Triangle Car Park, Hyde Park",752
"9653",2020,13,249,50,39,"51.49859784","-0.096191134","Harper Road, The Borough",89
"9654",2020,13,250,51,47,"51.489932","-0.162727","Royal Avenue 1, Chelsea",98
"9655",2020,13,251,133,144,"51.518908","-0.079249","Brushfield Street, Liverpool Street",277
"9656",2020,13,252,123,127,"51.5046364","-0.116542278","Jubilee Gardens, South Bank",250
"9657",2020,13,253,207,188,"51.53404294","-0.086379717","Shoreditch Park, Hoxton",395
"9658",2020,13,254,102,89,"51.53051587","-0.106408455","Chadwell Street, Angel",191
"9659",2020,13,255,147,135,"51.52557531","-0.179592915","Clifton Road, Maida Vale",282
"9660",2020,13,256,34,27,"51.51362054","-0.116764211","Houghton Street, Strand",61
"9661",2020,13,257,26,34,"51.52248185","-0.154907218","Westminster University, Marylebone",60
"9662",2020,13,259,105,122,"51.490959","-0.1532331","Bourne Street, Belgravia",227
"9663",2020,13,260,57,50,"51.5136846","-0.135580879","Broadwick Street, Soho",107
"9664",2020,13,261,96,100,"51.5134891","-0.191351186","Princes Square, Bayswater",196
"9665",2020,13,262,79,57,"51.49874469","-0.103132904","LSBU (Borough Road), Elephant & Castle",136
"9666",2020,13,263,48,46,"51.51422502","-0.080660083","St. Mary Axe, Aldgate",94
"9667",2020,13,264,83,86,"51.52644342","-0.109256828","Tysoe Street, Clerkenwell",169
"9668",2020,13,265,79,75,"51.51595344","-0.169249375","Southwick Street, Paddington",154
"9669",2020,13,266,74,100,"51.50102668","-0.180246101","Queen's Gate (North), Kensington",174
"9670",2020,13,267,129,106,"51.49206037","-0.132224622","Regency Street, Westminster",235
"9671",2020,13,268,78,72,"51.49320445","-0.144132875","Belgrave Road, Victoria",150
"9672",2020,13,269,98,101,"51.50082346","-0.089740764","Empire Square, The Borough",199
"9673",2020,13,270,157,155,"51.4863434","-0.122492418","Kennington Lane Rail Bridge, Vauxhall",312
"9674",2020,13,271,119,121,"51.53583617","-0.156285395","London Zoo,  The Regent's Park",240
"9675",2020,13,272,121,130,"51.50144456","-0.110699309","Baylis Road, Waterloo",251
"9676",2020,13,273,57,43,"51.50613324","-0.114686385","Belvedere Road 1, South Bank",100
"9677",2020,13,274,97,113,"51.49671237","-0.20528437","Warwick Road, Olympia",210
"9678",2020,13,275,47,35,"51.52004497","-0.092176447","Barbican Centre, Barbican",82
"9679",2020,13,276,26,27,"51.50930161","-0.084985356","Lower Thames Street, Monument",53
"9680",2020,13,277,138,139,"51.50315739","-0.191496313","Kensington Church Street, Kensington",277
"9681",2020,13,278,202,246,"51.5034938","-0.07962099","Tooley Street, Bermondsey",448
"9682",2020,13,279,68,62,"51.51862243","-0.176645823","North Wharf Road, Paddington",130
"9683",2020,13,280,101,97,"51.490083","-0.162418","Royal Avenue 2, Chelsea",198
"9684",2020,13,281,78,89,"51.49580589","-0.127575233","Smith Square, Westminster",167
"9685",2020,13,282,239,227,"51.51906446","-0.059642081","Royal London Hospital, Whitechapel",466
"9686",2020,13,283,15,19,"51.51440928","-0.118478757","Kingsway, Covent Garden",34
"9687",2020,13,284,100,101,"51.49914063","-0.112031483","Lambeth North Station, Waterloo",201
"9688",2020,13,286,73,52,"51.5272947","-0.174653609","St. John's Wood Road, St. John's Wood",125
"9689",2020,13,287,17,19,"51.52367314","-0.128377673","Bedford Way, Bloomsbury",36
"9690",2020,13,288,94,115,"51.49236962","-0.147478734","Elizabeth Bridge, Victoria",209
"9691",2020,13,289,23,22,"51.50923022","-0.151296092","South Audley Street, Mayfair",45
"9692",2020,13,290,90,93,"51.518268","-0.17110323","St Mary's Hospital, Paddington",183
"9693",2020,13,291,103,82,"51.48483991","-0.138089062","Claverton Street, Pimlico",185
"9694",2020,13,292,127,139,"51.49888404","-0.165471605","Montpelier Street, Knightsbridge",266
"9695",2020,13,293,71,50,"51.49815779","-0.209494128","Kensington Olympia Station, Olympia",121
"9696",2020,13,294,139,118,"51.488226","-0.135635511","St. George's Square, Pimlico",257
"9697",2020,13,295,75,64,"51.50029631","-0.092762704","Swan Street, The Borough",139
"9698",2020,13,296,87,86,"51.49363156","-0.190603326","Knaresborough Place, Earl's Court",173
"9699",2020,13,297,33,30,"51.49612799","-0.106000855","Geraldine Street, Elephant & Castle",63
"9700",2020,13,298,201,210,"51.50227992","-0.074189225","Curlew Street, Shad Thames",411
"9701",2020,13,299,36,42,"51.49398524","-0.136928582","Vincent Square, Westminster",78
"9702",2020,13,300,273,280,"51.505014","-0.17306032","Serpentine Car Park, Hyde Park",553
"9703",2020,13,301,85,72,"51.51475963","-0.148105415","Marylebone Lane, Marylebone",157
"9704",2020,13,302,157,166,"51.466907","-0.216573","Putney Pier, Wandsworth",323
"9705",2020,13,303,400,406,"51.50295379","-0.158456089","Albert Gate, Hyde Park",806
"9706",2020,13,306,52,56,"51.51816295","-0.135025698","Rathbone Street, Fitzrovia",108
"9707",2020,13,307,578,566,"51.50990837","-0.187842717","Black Lion Gate, Kensington Gardens",1144
"9708",2020,13,308,111,99,"51.49907558","-0.085666316","Long Lane , Bermondsey",210
"9709",2020,13,309,43,36,"51.50963123","-0.119047563","Embankment (Savoy), Strand",79
"9710",2020,13,310,80,78,"51.4908679","-0.116911864","Black Prince Road, Vauxhall",158
"9711",2020,13,311,92,85,"51.51918144","-0.140485596","Foley Street, Fitzrovia",177
"9712",2020,13,312,145,127,"51.53088935","-0.176770502","Grove End Road, St. John's Wood",272
"9713",2020,13,313,83,84,"51.51734403","-0.138072691","Wells Street, Fitzrovia",167
"9714",2020,13,314,78,77,"51.50088934","-0.083159352","Tyers Gate, Bermondsey",155
"9715",2020,13,315,144,152,"51.52536703","-0.153463612","The Tennis Courts, The Regent's Park",296
"9716",2020,13,316,114,118,NA,NA,NA,232
"9717",2020,13,317,52,42,"51.49679128","-0.093913472","Dickens Square, Borough",94
"9718",2020,13,318,45,54,"51.51004801","-0.138846453","Sackville Street, Mayfair",99
"9719",2020,13,319,69,76,"51.52702563","-0.088542771","Baldwin Street, St. Luke's",145
"9720",2020,13,320,121,138,"51.49357351","-0.139956043","Queen Mother Sports Centre, Victoria",259
"9721",2020,13,321,161,171,"51.49785559","-0.081608045","Bermondsey Street, Bermondsey",332
"9722",2020,13,322,62,53,"51.526293","-0.073955","Palissy Street, Shoreditch",115
"9723",2020,13,323,26,19,"51.523196","-0.083067","Clifton Street, Shoreditch",45
"9724",2020,13,324,91,92,"51.49652013","-0.101384068","Ontario Street, Elephant & Castle",183
"9725",2020,13,325,32,40,"51.50908747","-0.129697889","St. Martin's Street, West End",72
"9726",2020,13,326,159,161,"51.53266186","-0.099981142","Graham Street, Angel",320
"9727",2020,13,327,49,35,"51.53095","-0.085603","New North Road 1, Hoxton",84
"9728",2020,13,328,45,27,"51.53114","-0.086016","New North Road 2, Hoxton",72
"9729",2020,13,329,184,180,"51.53589283","-0.160854428","Prince Albert Road, The Regent's Park",364
"9730",2020,13,330,53,44,"51.51641749","-0.179135079","Eastbourne Mews, Paddington",97
"9731",2020,13,331,71,95,"51.52085887","-0.089887855","Bunhill Row, Moorgate",166
"9732",2020,13,332,60,55,"51.49334336","-0.194757949","Nevern Place, Earl's Court",115
"9733",2020,13,333,85,83,"51.50860544","-0.193764092","Palace Gardens Terrace, Notting Hill",168
"9734",2020,13,334,21,23,"51.505044","-0.115851","Concert Hall Approach 1, South Bank",44
"9735",2020,13,335,31,30,"51.51196803","-0.120718759","Tavistock Street, Covent Garden",61
"9736",2020,13,336,30,32,"51.504942","-0.115533","Concert Hall Approach 2, South Bank",62
"9737",2020,13,337,56,55,"51.51108452","-0.197524944","Pembridge Villas, Notting Hill",111
"9738",2020,13,338,70,70,"51.51175646","-0.119643424","Wellington Street , Strand",140
"9739",2020,13,339,42,36,"51.5333196","-0.1117812","Risinghill Street, Angel",78
"9740",2020,13,340,98,103,"51.51444134","-0.087587447","Bank of England Museum, Bank",201
"9741",2020,13,341,130,152,"51.50810309","-0.12602103","Craven Street, Strand",282
"9742",2020,13,343,122,122,"51.53692216","-0.150181444","London Zoo Car Park, The Regent's Park",244
"9743",2020,13,344,68,53,"51.528246","-0.10102611","Goswell Road (City Uni), Finsbury",121
"9744",2020,13,345,186,177,"51.48802358","-0.166878535","Flood Street, Chelsea",363
"9745",2020,13,347,67,82,"51.50013942","-0.113936001","Lower Marsh, Waterloo",149
"9746",2020,13,348,73,73,"51.51217033","-0.150481272","Grosvenor Square, Mayfair",146
"9747",2020,13,349,52,52,"51.51196","-0.142783033","St. George Street, Mayfair",104
"9748",2020,13,350,296,291,"51.5017154373867","-0.1798541843891","Queen's Gate, Kensington Gardens",587
"9749",2020,13,351,78,83,"51.529423","-0.097122","Macclesfield Rd, St Lukes",161
"9750",2020,13,352,82,91,"51.486965","-0.116625","Vauxhall Street, Vauxhall",173
"9751",2020,13,353,49,45,"51.49459148","-0.134234258","Greycoat Street , Westminster",94
"9752",2020,13,354,70,73,"51.506767","-0.123702","Northumberland Avenue, Strand",143
"9753",2020,13,356,150,154,"51.494412","-0.173881","South Kensington Station, South Kensington",304
"9754",2020,13,357,78,65,"51.520994","-0.139016","Howland Street, Fitzrovia",143
"9755",2020,13,358,34,29,"51.516226","-0.124826","High Holborn , Covent Garden",63
"9756",2020,13,359,36,28,"51.49782999","-0.135440826","Butler Place, Westminster",64
"9757",2020,13,360,61,67,"51.49675303","-0.138733562","Howick Place, Westminster",128
"9758",2020,13,361,33,20,"51.50391973","-0.11342629","Waterloo Station 2, Waterloo",53
"9759",2020,13,362,60,60,"51.536264","-0.133952","Royal College Street, Camden Town",120
"9760",2020,13,363,39,21,"51.5291212008901","-0.171185284853","Lord's, St. John's Wood",60
"9761",2020,13,364,63,57,"51.519656","-0.132339","Alfred Place, Bloomsbury",120
"9762",2020,13,365,57,48,"51.530344","-0.100168","City Road, Angel",105
"9763",2020,13,366,27,38,"51.5109192966489","-0.1511263847351","Millennium Hotel, Mayfair",65
"9764",2020,13,367,101,117,"51.5173721","-0.1642075","Harrowby Street, Marylebone",218
"9765",2020,13,368,83,83,"51.50024195","-0.15934065","Harriet Street, Knightsbridge",166
"9766",2020,13,371,36,30,"51.49775","-0.10988","King Edward Walk, Waterloo",66
"9767",2020,13,372,11,10,"51.515208","-0.117863","Sardinia Street, Holborn",21
"9768",2020,13,373,12,14,"51.49980661","-0.176415994","Prince Consort Road, Knightsbridge",26
"9769",2020,13,374,72,110,"51.50402794","-0.11386436","Waterloo Station 1, Waterloo",182
"9770",2020,13,375,60,52,"51.50194596","-0.194392952","Kensington Town Hall, Kensington",112
"9771",2020,13,376,107,111,"51.49188409","-0.125674815","Millbank Tower, Pimlico",218
"9772",2020,13,377,30,29,"51.50535447","-0.113656543","Waterloo Bridge, South Bank",59
"9773",2020,13,378,22,29,"51.49559291","-0.179077626","Natural History Museum, South Kensington",51
"9774",2020,13,379,112,116,"51.51431171","-0.200838199","Turquoise Island, Notting Hill",228
"9775",2020,13,380,16,16,"51.50686435","-0.150666888","Stanhope Gate, Mayfair",32
"9776",2020,13,381,84,76,"51.51953043","-0.13577731","Charlotte Street, Fitzrovia",160
"9777",2020,13,382,54,61,"51.50935171","-0.14744969","Farm Street, Mayfair",115
"9778",2020,13,383,65,57,"51.51310333","-0.13121385","Frith Street, Soho",122
"9779",2020,13,384,85,79,"51.496481","-0.192404","Marloes Road, Kensington",164
"9780",2020,13,386,129,135,"51.51352755","-0.130110822","Moor Street, Soho",264
"9781",2020,13,387,126,112,"51.49369988","-0.121394101","Fire Brigade Pier, Vauxhall",238
"9782",2020,13,388,48,62,"51.51070161","-0.121723604","Southampton Street, Strand",110
"9783",2020,13,389,34,24,"51.51013066","-0.155757901","Upper Grosvenor Street, Mayfair",58
"9784",2020,13,390,56,54,"51.521776","-0.068856","Buxton Street 1, Shoreditch",110
"9785",2020,13,392,73,67,"51.49942855","-0.179702476","Imperial College, Knightsbridge",140
"9786",2020,13,393,20,25,"51.51733427","-0.103604248","Snow Hill, Farringdon",45
"9787",2020,13,394,62,42,"51.524826","-0.176268","Aberdeen Place, St. John's Wood",104
"9788",2020,13,395,91,99,"51.492462","-0.159919","Cadogan Gardens, Chelsea",190
"9789",2020,13,396,89,89,"51.51809","-0.163609","Shouldham Street, Marylebone",178
"9790",2020,13,397,214,183,"51.51348","-0.17977","Devonshire Terrace, Bayswater",397
"9791",2020,13,398,97,93,"51.502319","-0.200742","Holland Park, Kensington",190
"9792",2020,13,399,70,98,"51.52261762","-0.071653961","Brick Lane Market, Shoreditch",168
"9793",2020,13,400,47,75,"51.517703","-0.154106","George Street, Marylebone",122
"9794",2020,13,401,92,99,"51.528187","-0.075375","Columbia Road, Shoreditch",191
"9795",2020,13,402,64,62,"51.52289229","-0.171681991","Penfold Street, Marylebone",126
"9796",2020,13,403,81,77,"51.51689296","-0.158249929","George Place Mews, Marylebone",158
"9797",2020,13,404,362,369,"51.50204238","-0.184400221","Palace Gate, Kensington Gardens",731
"9798",2020,13,405,151,182,"51.49418566","-0.18267094","Gloucester Road Station, South Kensington",333
"9799",2020,13,409,114,124,"51.493146","-0.099828","Strata, Elephant & Castle",238
"9800",2020,13,410,103,92,"51.519968","-0.169774","Edgware Road Station, Marylebone",195
"9801",2020,13,411,93,118,"51.49337264","-0.09968067","Walworth Road, Elephant & Castle",211
"9802",2020,13,412,55,54,"51.488105","-0.110121","Cleaver Street, Kennington",109
"9803",2020,13,419,242,223,"51.485821","-0.149004","Chelsea Bridge, Pimlico",465
"9804",2020,13,420,29,37,"51.504043","-0.105312","Southwark Station 1, Southwark",66
"9805",2020,13,421,48,43,"51.504044","-0.104778","Southwark Station 2, Southwark",91
"9806",2020,13,423,67,58,"51.49456127","-0.15393398","Eaton Square (South), Belgravia",125
"9807",2020,13,424,92,71,"51.490491","-0.149186","Ebury Bridge, Pimlico",163
"9808",2020,13,425,60,55,"51.533379","-0.139159","Harrington Square 2, Camden Town",115
"9809",2020,13,426,87,85,"51.493072","-0.129925","Vincent Street, Pimlico",172
"9810",2020,13,427,157,131,"51.51397065","-0.09294031","Cheapside, Bank",288
"9811",2020,13,428,96,89,"51.499917","-0.174554","Exhibition Road, Knightsbridge",185
"9812",2020,13,430,78,81,"51.48902","-0.17524","South Parade, Chelsea",159
"9813",2020,13,431,44,32,"51.534474","-0.122203","Crinan Street, King's Cross",76
"9814",2020,13,432,42,38,"51.496957","-0.173894","Exhibition Road Museums, South Kensington",80
"9815",2020,13,433,76,69,"51.524564","-0.116279","Wren Street, Holborn",145
"9816",2020,13,435,81,81,"51.488852","-0.105593","Kennington Station, Kennington",162
"9817",2020,13,436,93,85,"51.51824","-0.11655","Red Lion Street, Holborn",178
"9818",2020,13,437,68,67,"51.488124","-0.120903","Vauxhall Walk, Vauxhall",135
"9819",2020,13,439,34,22,"51.5338","-0.118677","Killick Street, King's Cross",56
"9820",2020,13,440,107,102,"51.483145","-0.113134","Kennington Oval, Oval",209
"9821",2020,13,441,63,64,"51.495656","-0.114605","Sail Street, Vauxhall",127
"9822",2020,13,442,52,40,"51.510101","-0.211358","Walmer Road, Avondale",92
"9823",2020,13,443,131,113,"51.515256","-0.058641","Philpot Street, Whitechapel",244
"9824",2020,13,444,78,73,"51.52568","-0.055312","Bethnal Green Garden, Bethnal Green",151
"9825",2020,13,445,36,50,"51.52388","-0.065076","Cheshire Street, Bethnal Green",86
"9826",2020,13,446,104,105,"51.528936","-0.055894","York Hall, Bethnal Green",209
"9827",2020,13,447,63,49,"51.493381","-0.007542","Jubilee Crescent, Cubitt Town",112
"9828",2020,13,448,65,65,"51.50623","-0.02296","Fisherman's Walk West, Canary Wharf",130
"9829",2020,13,449,134,135,"51.511088","-0.057159","Shadwell Station, Shadwell",269
"9830",2020,13,450,76,65,"51.515975","-0.053177","Jubilee Street, Stepney",141
"9831",2020,13,451,108,105,"51.504719","-0.063531","Hermitage Court, Wapping",213
"9832",2020,13,452,102,99,"51.505697","-0.070542","St. Katharine's Way, Tower",201
"9833",2020,13,453,74,71,"51.508447","-0.055167","Garnet Street, Shadwell",145
"9834",2020,13,454,144,132,"51.487679","-0.021582","Napier Avenue, Millwall",276
"9835",2020,13,455,98,96,"51.49447","-0.014409","East Ferry Road, Cubitt Town",194
"9836",2020,13,456,83,96,"51.538071","-0.144664","Parkway, Camden Town",179
"9837",2020,13,457,158,167,"51.542138","-0.145393","Castlehaven Road, Camden Town",325
"9838",2020,13,458,145,134,"51.504749","-0.057544","Wapping Lane, Wapping",279
"9839",2020,13,459,150,149,"51.535179","-0.03338","Gunmakers Lane, Old Ford",299
"9840",2020,13,460,134,141,"51.516196","-0.029138","Burdett Road, Mile End",275
"9841",2020,13,461,59,64,"51.516","-0.038775","Aston Street, Stepney",123
"9842",2020,13,462,142,131,"51.541603","-0.138853","Bonny Street, Camden Town",273
"9843",2020,13,463,46,41,"51.534776","-0.071881","Thurtle Road, Haggerston",87
"9844",2020,13,464,34,27,"51.51417","-0.052099","St. Mary & St. Michael Church, Stepney",61
"9845",2020,13,465,109,109,"51.53558","-0.08249","Pitfield Street North,Hoxton",218
"9846",2020,13,466,75,64,"51.534464","-0.076341","Whiston Road, Haggerston",139
"9847",2020,13,467,65,67,"51.523538","-0.030556","Southern Grove, Bow",132
"9848",2020,13,468,33,28,"51.521564","-0.022694","Cantrell Road, Bow",61
"9849",2020,13,469,72,58,"51.513757","-0.020467","Lindfield Street, Poplar",130
"9850",2020,13,470,80,70,"51.530535","-0.025492","Mostyn Grove, Bow",150
"9851",2020,13,471,71,81,"51.533283","-0.028155","Hewison Street, Old Ford",152
"9852",2020,13,472,21,16,"51.529452","-0.027616","Malmesbury Road, Bow",37
"9853",2020,13,473,36,38,"51.496137","-0.019355","Millharbour, Millwall",74
"9854",2020,13,475,103,100,"51.499041","-0.020157","Lightermans Road, Millwall",203
"9855",2020,13,476,48,49,"51.489096","-0.009205","Stebondale Street, Cubitt Town",97
"9856",2020,13,477,82,82,"51.49109","-0.018716","Spindrift Avenue, Millwall",164
"9857",2020,13,478,160,152,"51.521889","-0.04667","Stepney Green Station, Stepney",312
"9858",2020,13,479,167,160,"51.527152","-0.058005","Pott Street, Bethnal Green",327
"9859",2020,13,480,243,249,"51.5128711","-0.0389866","Flamborough Street, Limehouse",492
"9860",2020,13,481,252,270,"51.487129","-0.009001","Saunders Ness Road, Cubitt Town",522
"9861",2020,13,483,102,102,"51.51328","-0.047784","Albert Gardens, Stepney",204
"9862",2020,13,484,81,78,"51.528828","-0.013258","Bromley High Street, Bow",159
"9863",2020,13,485,85,101,"51.531127","-0.048017","Old Ford Road, Bethnal Green",186
"9864",2020,13,486,96,100,"51.525645","-0.069543","Granby Street, Shoreditch",196
"9865",2020,13,487,54,53,"51.511811","-0.025626","Canton Street, Poplar",107
"9866",2020,13,488,125,122,"51.506946","-0.058681","Reardon Street, Wapping",247
"9867",2020,13,489,128,118,"51.513074","-0.064094","Christian Street, Whitechapel",246
"9868",2020,13,490,33,33,"51.508622","-0.065006","Pennington Street, Wapping",66
"9869",2020,13,491,90,89,"51.522507","-0.041378","Queen Mary's, Mile End",179
"9870",2020,13,492,112,110,"51.525501","-0.032267204","Maplin Street, Mile End",222
"9871",2020,13,494,8,8,"51.50196","-0.016251","South Quay East, Canary Wharf",16
"9872",2020,13,495,176,160,"51.528169","-0.018703","Bow Church Station, Bow",336
"9873",2020,13,496,97,96,"51.52512","-0.015578","Devons Road, Bow",193
"9874",2020,13,497,87,71,"51.526149","-0.027396845","Merchant Street, Bow",158
"9875",2020,13,498,100,104,"51.527058","-0.025296","Bow Road Station, Bow",204
"9876",2020,13,499,129,127,"51.519265","-0.021345","Furze Green, Bow",256
"9877",2020,13,500,166,164,"51.519806","-0.055731","Ansell House, Stepney",330
"9878",2020,13,501,86,80,"51.522561","-0.054883","Cephas Street, Bethnal Green",166
"9879",2020,13,502,266,275,"51.53341","-0.049591815","Bonner Gate, Victoria Park",541
"9880",2020,13,503,172,198,"51.520893","-0.051394","Cleveland Way, Stepney",370
"9881",2020,13,504,57,59,"51.496454","-0.009506","St. John's Park, Cubitt Town",116
"9882",2020,13,505,63,52,"51.520398","-0.026768","Ackroyd Drive, Bow",115
"9883",2020,13,506,80,82,"51.517475","-0.075855","Bell Lane, Liverpool Street",162
"9884",2020,13,507,42,34,"51.528692","-0.059091","Clarkson Street, Bethnal Green",76
"9885",2020,13,508,66,63,"51.519362","-0.074431","Fournier Street, Whitechapel",129
"9886",2020,13,509,49,45,"51.517842","-0.090075","Fore Street, Guildhall",94
"9887",2020,13,510,175,187,"51.509303","-0.025996","Westferry DLR, Limehouse",362
"9888",2020,13,511,144,140,"51.511066","-0.053558","Sutton Street, Shadwell",284
"9889",2020,13,512,119,108,"51.532091","-0.06142","Pritchard's Road, Bethnal Green",227
"9890",2020,13,513,84,106,"51.5142228","-0.055656","Watney Market, Stepney",190
"9891",2020,13,514,61,59,"51.516204","-0.155525","Portman Square, Marylebone",120
"9892",2020,13,515,69,67,"51.500088","-0.211316","Russell Gardens, Olympia",136
"9893",2020,13,516,88,85,"51.5112","-0.014438","Chrisp Street Market, Poplar",173
"9894",2020,13,517,74,68,"51.532513","-0.033085","Ford Road, Old Ford",142
"9895",2020,13,518,86,52,"51.528224","-0.037471","Antill Road, Mile End",138
"9896",2020,13,519,35,31,"51.518811","-0.011662","Teviot Street, Poplar",66
"9897",2020,13,520,89,74,"51.526041","-0.047218","Bancroft Road, Bethnal Green",163
"9898",2020,13,521,109,121,"51.534137","-0.037366","Driffield Road, Old Ford",230
"9899",2020,13,522,123,156,"51.525941","-0.036017","Clinton Road, Mile End",279
"9900",2020,13,523,63,68,"51.51549","-0.013475","Langdon Park, Poplar",131
"9901",2020,13,524,128,107,"51.511654","-0.179668","Lancaster Gate , Bayswater",235
"9902",2020,13,526,74,71,"51.503143","-0.008428","Lancaster Drive, Blackwall",145
"9903",2020,13,527,72,80,"51.503802","-0.215808","Hansard Mews, Holland Park",152
"9904",2020,13,528,14,16,"51.507326","-0.145827","Clarges Street, Mayfair",30
"9905",2020,13,529,54,49,"51.486892","-0.170983","Manresa Road, Chelsea",103
"9906",2020,13,530,69,72,"51.508896","-0.012413","Newby Place, Poplar",141
"9907",2020,13,531,144,126,"51.530326","-0.042744","Twig Folly Bridge, Mile End",270
"9908",2020,13,532,54,102,"51.50357","-0.020068","Jubilee Plaza, Canary Wharf",156
"9909",2020,13,533,59,60,"51.528222","-0.069743","Wellington Row, Bethnal Green",119
"9910",2020,13,534,130,127,"51.531864","-0.066035","Goldsmith's Row, Haggerston",257
"9911",2020,13,535,112,93,"51.537349","-0.147154","Gloucester Avenue, Camden Town",205
"9912",2020,13,536,45,41,"51.53385","-0.06992","Queensbridge Road, Haggerston",86
"9913",2020,13,537,124,124,"51.51793","-0.067937","Old Montague Street, Whitechapel",248
"9914",2020,13,538,81,85,"51.508981","-0.00699","Naval Row, Blackwall",166
"9915",2020,13,540,133,108,"51.528302","-0.144466","Albany Street, The Regent's Park",241
"9916",2020,13,541,164,149,"51.506613","-0.142844","Green Park Station, Mayfair",313
"9917",2020,13,542,104,102,"51.514115","-0.033828","Salmon Lane, Limehouse",206
"9918",2020,13,543,33,15,"51.509591","-0.204666","Lansdowne Walk, Ladbroke Grove",48
"9919",2020,13,544,61,67,"51.526153","-0.102208","Percival Street, Finsbury",128
"9920",2020,13,545,46,43,"51.539957","-0.145246","Arlington Road, Camden Town",89
"9921",2020,13,546,79,80,"51.517428","-0.107987","New Fetter Lane, Holborn",159
"9922",2020,13,547,135,123,"51.509474","-0.002275","East India DLR, Blackwall",258
"9923",2020,13,548,36,44,"51.498386","-0.107913","Westminster Bridge Road, Elephant & Castle",80
"9924",2020,13,549,93,67,"51.49605","-0.104193","Gaywood  Street, Elephant & Castle",160
"9925",2020,13,550,62,54,"51.521564","-0.039264","Harford Street, Mile End",116
"9926",2020,13,551,38,43,"51.505772","-0.016460175","Import Dock, Canary Wharf",81
"9927",2020,13,552,106,110,"51.511542","-0.056667","Watney Street, Shadwell",216
"9928",2020,13,553,320,310,"51.535678","-0.062546","Regent's Row , Haggerston",630
"9929",2020,13,554,30,25,"51.513548","-0.005659","Aberfeldy Street, Poplar",55
"9930",2020,13,556,45,49,"51.502661","-0.021596","Heron Quays DLR, Canary Wharf",94
"9931",2020,13,557,67,55,"51.51601","-0.0985","King Edward Street, St Pauls",122
"9932",2020,13,558,140,142,"51.493978","-0.127554","Page Street, Westminster",282
"9933",2020,13,559,40,46,"51.501391","-0.205991","Abbotsbury Road, Holland Park",86
"9934",2020,13,560,36,32,"51.511624","-0.205921","Ladbroke Grove Central, Ladbroke Grove",68
"9935",2020,13,561,49,42,"51.518369","-0.043371","Rectory Square, Stepney",91
"9936",2020,13,562,40,36,"51.51746","-0.12335","Bury Place, Holborn",76
"9937",2020,13,563,87,92,"51.499286","-0.009152","Preston's Road, Cubitt Town",179
"9938",2020,13,564,214,226,"51.509943","-0.117619","Somerset House, Strand",440
"9939",2020,13,565,34,37,"51.521905","-0.063386","Selby Street, Whitechapel",71
"9940",2020,13,566,70,96,"51.509158","-0.224103","Westfield Ariel Way, White City",166
"9941",2020,13,568,207,204,"51.51616","-0.18697","Bishop's Bridge Road West, Bayswater",411
"9942",2020,13,569,71,74,"51.53213","-0.08299","Pitfield Street Central, Hoxton",145
"9943",2020,13,570,142,148,"51.503083","-0.017676","Upper Bank Street, Canary Wharf",290
"9944",2020,13,571,32,41,"51.506256","-0.218337","Westfield Southern Terrace ,Shepherd's Bush",73
"9945",2020,13,572,118,133,"51.539099","-0.141728","Greenland Road, Camden Town",251
"9946",2020,13,573,205,222,"51.485587","-0.18119","Limerston Street, West Chelsea",427
"9947",2020,13,574,158,166,"51.53356","-0.09315","Eagle Wharf Road, Hoxton",324
"9948",2020,13,576,67,74,"51.497304","-0.022793","Alpha Grove, Millwall",141
"9949",2020,13,577,96,112,"51.528869","-0.047548","Globe Town Market, Bethnal Green",208
"9950",2020,13,578,22,39,"51.527607","-0.057133","Hollybush Gardens, Bethnal Green",61
"9951",2020,13,579,156,166,"51.511246","-0.093051","Queen Street 2, Bank",322
"9952",2020,13,580,156,142,"51.48692917","-0.102996299","Doddington Grove, Kennington",298
"9953",2020,13,581,145,148,"51.519167","-0.147983","New Cavendish Street, Marylebone",293
"9954",2020,13,583,132,153,"51.497622","-0.125978","Abingdon Green, Westminster",285
"9955",2020,13,584,87,72,"51.51244","-0.19096","Ilchester Gardens, Bayswater",159
"9956",2020,13,586,50,43,"51.490645","-0.014582","Mudchute DLR, Cubitt Town",93
"9957",2020,13,587,120,113,"51.50964","-0.08497","Monument Street, Monument",233
"9958",2020,13,588,53,43,"51.52959","-0.0801","Hoxton Street, Hoxton",96
"9959",2020,13,589,180,199,"51.487196","-0.179369","Drayton Gardens, West Chelsea",379
"9960",2020,13,590,54,45,"51.53256","-0.16862","Greenberry Street, St.John's Wood",99
"9961",2020,13,592,37,40,"51.5171","-0.18377","Bishop's Bridge Road East, Bayswater",77
"9962",2020,13,593,22,37,"51.531066","-0.11934","Northdown Street, King's Cross",59
"9963",2020,13,594,14,28,"51.513875","-0.117774","Kingsway Southbound, Strand",42
"9964",2020,13,595,102,93,"51.493267","-0.21985","Hammersmith Road, Hammersmith",195
"9965",2020,13,596,107,127,"51.472817","-0.199783","Parson's Green , Parson's Green",234
"9966",2020,13,597,89,95,"51.473471","-0.20782","Fulham Park Road, Fulham",184
"9967",2020,13,598,123,127,"51.494499","-0.228188","Southerton Road, Hammersmith",250
"9968",2020,13,599,68,58,"51.485743","-0.223616","Manbre Road, Hammersmith",126
"9969",2020,13,600,214,214,"51.481747","-0.124642","South Lambeth Road, Vauxhall",428
"9970",2020,13,601,108,100,"51.514767","-0.225787","BBC White City, White City",208
"9971",2020,13,602,117,102,"51.472993","-0.133972","Union Grove, Wandsworth Road",219
"9972",2020,13,603,79,102,"51.477839","-0.116493","Caldwell Street, Stockwell",181
"9973",2020,13,604,44,34,"51.538792","-0.138535","St Martins Close, Camden Town",78
"9974",2020,13,605,104,98,"51.520331","-0.163667","Seymour Place, Marylebone",202
"9975",2020,13,606,34,41,"51.504199","-0.210941","Addison Road, Holland Park",75
"9976",2020,13,607,64,60,"51.468814","-0.210279","Putney Bridge Station, Fulham",124
"9977",2020,13,608,15,11,"51.491093","-0.216493","Colet Gardens, Hammersmith",26
"9978",2020,13,609,118,113,"51.46512358","-0.157788279","Sugden Road, Clapham",231
"9979",2020,13,610,125,124,"51.48256792","-0.172078187","Danvers Street, West Chelsea",249
"9980",2020,13,611,79,78,"51.50646524","-0.208486599","Princedale Road , Holland Park",157
"9981",2020,13,612,106,99,"51.46925984","-0.141812513","Wandsworth Rd, Isley Court, Wandsworth Road",205
"9982",2020,13,613,146,147,"51.50403821","-0.217400093","Woodstock Grove, Shepherd's Bush",293
"9983",2020,13,614,47,36,"51.47817208","-0.144690541","Bradmead, Battersea Park",83
"9984",2020,13,615,125,113,"51.4768851","-0.215895601","Finlay Street, Fulham",238
"9985",2020,13,616,89,88,"51.48102131","-0.209973497","Aintree Street, Fulham",177
"9986",2020,13,617,58,41,"51.47107905","-0.207842908","Elysium Place, Fulham",99
"9987",2020,13,618,123,123,"51.47625965","-0.193254007","Eel Brook Common, Walham Green",246
"9988",2020,13,619,82,86,"51.4737636","-0.197010096","Irene Road, Parsons Green",168
"9989",2020,13,620,107,89,"51.47518024","-0.167160736","Surrey Lane, Battersea",196
"9990",2020,13,621,93,125,"51.46086446","-0.187427294","Wandsworth Town Station, Wandsworth",218
"9991",2020,13,622,74,75,"51.50748124","-0.205535908","Lansdowne Road, Ladbroke Grove",149
"9992",2020,13,623,38,40,"51.46193072","-0.180791784","Nantes Close, Wandsworth",78
"9993",2020,13,624,112,98,"51.4729184","-0.132102704","Courland Grove, Wandsworth Road",210
"9994",2020,13,625,390,396,"51.47761941","-0.149551631","Queen's Circus, Battersea Park",786
"9995",2020,13,626,102,115,"51.48438657","-0.20481514","Normand Park, West Kensington",217
"9996",2020,13,627,51,46,"51.4687905","-0.158230901","Holden Street, Battersea",97
"9997",2020,13,628,114,130,"51.46881971","-0.184318843","William Morris Way, Sands End",244
"9998",2020,13,629,26,26,"51.45995384","-0.190184054","Morie Street, Wandsworth",52
"9999",2020,13,630,82,79,"51.47073264","-0.126994068","Clarence Walk, Stockwell",161
"10000",2020,13,631,109,108,"51.4795017","-0.141770709","Battersea Park Road, Nine Elms",217
"10001",2020,13,632,49,49,"51.47053858","-0.163041605","Sheepcote Lane, Battersea",98
"10002",2020,13,633,123,105,"51.48959104","-0.209378594","Vereker Road, West Kensington",228
"10003",2020,13,634,67,64,"51.49434708","-0.215804559","Brook Green South, Brook Green",131
"10004",2020,13,635,100,96,"51.48606206","-0.214428378","Greyhound Road, Hammersmith",196
"10005",2020,13,636,67,77,"51.46706414","-0.193502076","South Park, Sands End",144
"10006",2020,13,637,65,58,"51.45787019","-0.174691623","Spencer Park, Wandsworth Common",123
"10007",2020,13,638,140,151,"51.46663393","-0.169821175","Falcon Road, Clapham Junction",291
"10008",2020,13,639,96,104,"51.48357068","-0.202038682","Coomer Place, West Kensington",200
"10009",2020,13,640,104,111,"51.47286577","-0.148059277","Silverthorne Road, Battersea",215
"10010",2020,13,641,101,108,"51.49824168","-0.117495865","Archbishop's Park, Waterloo",209
"10011",2020,13,642,53,58,"51.46916161","-0.174485792","Fawcett Close, Battersea",111
"10012",2020,13,643,68,61,"51.5190427","-0.204764421","All Saints' Road, Portobello",129
"10013",2020,13,644,111,108,"51.48373225","-0.223852256","Rainville Road, Hammersmith",219
"10014",2020,13,645,32,33,"51.50173215","-0.100292412","Great Suffolk Street, The Borough",65
"10015",2020,13,646,107,115,"51.49886563","-0.137424571","Buckingham Gate, Westminster",222
"10016",2020,13,647,104,122,"51.50035306","-0.217515071","Richmond Way, Shepherd's Bush",226
"10017",2020,13,648,54,52,"51.46904022","-0.19627483","Peterborough Road, Sands End",106
"10018",2020,13,649,126,123,"51.48180515","-0.18027465","World's End Place, West Chelsea",249
"10019",2020,13,650,112,112,"51.51687069","-0.213872396","St. Mark's Road, North Kensington",224
"10020",2020,13,651,87,92,"51.48089844","-0.183853573","Thorndike Close, West Chelsea",179
"10021",2020,13,652,35,30,"51.51148696","-0.218190203","Evesham Street, Avondale",65
"10022",2020,13,653,127,136,"51.47084722","-0.17070367","Simpson Street, Clapham Junction",263
"10023",2020,13,654,85,82,"51.48267821","-0.117661574","Ashmole Estate, Oval",167
"10024",2020,13,655,44,52,"51.48294452","-0.219346128","Crabtree Lane, Fulham",96
"10025",2020,13,656,35,27,"51.46841875","-0.199135704","Broomhouse Lane, Parsons Green",62
"10026",2020,13,657,78,91,"51.4996806","-0.221791552","Blythe Road West, Shepherd's Bush",169
"10027",2020,13,658,279,294,"51.47729232","-0.16478637","Ethelburga Estate, Battersea Park",573
"10028",2020,13,659,68,76,"51.511934","-0.10307894","Blackfriars Station, St. Paul's",144
"10029",2020,13,660,89,73,"51.49087074","-0.206029743","West Kensington Station, West Kensington",162
"10030",2020,13,661,165,188,"51.51632095","-0.202608612","All Saints Church, Portobello",353
"10031",2020,13,662,115,104,"51.48498496","-0.167919869","Phene Street, Chelsea",219
"10032",2020,13,663,51,45,"51.51323001","-0.211593602","Clarendon Road, Avondale",96
"10033",2020,13,664,115,110,"51.474376","-0.155442787","Austin Road, Battersea Park",225
"10034",2020,13,665,63,57,"51.46108367","-0.191722864","Smugglers Way, Wandsworth",120
"10035",2020,13,666,112,82,"51.49610093","-0.208158259","Olympia Way, Olympia",194
"10036",2020,13,667,81,101,"51.5015946","-0.222293381","Shepherd's Bush Road North, Shepherd's Bush",182
"10037",2020,13,668,188,195,"51.49422354","-0.236769936","Ravenscourt Park Station, Hammersmith",383
"10038",2020,13,669,73,63,"51.47614939","-0.1232585","Teversham Lane, Stockwell",136
"10039",2020,13,670,143,146,"51.46718562","-0.152248582","Ashley Crescent, Battersea",289
"10040",2020,13,671,112,119,"51.475089","-0.201968","Parsons Green Station, Parsons Green",231
"10041",2020,13,673,142,139,"51.46517078","-0.18038939","Hibbert Street, Battersea",281
"10042",2020,13,674,76,74,"51.53546778","-0.11619105","Carnegie Street, King's Cross",150
"10043",2020,13,675,90,82,"51.46348914","-0.182126248","Usk Road, Clapham Junction",172
"10044",2020,13,676,121,129,"51.47787084","-0.126874471","Hartington Road, Stockwell",250
"10045",2020,13,677,47,51,"51.46866929","-0.146544642","Heath Road, Battersea",98
"10046",2020,13,678,28,25,"51.46231278","-0.211468596","Esmond Street, Putney",53
"10047",2020,13,679,61,51,"51.47453545","-0.170210533","Orbel Street, Battersea",112
"10048",2020,13,680,100,120,"51.47768469","-0.170329317","Westbridge Road, Battersea",220
"10049",2020,13,681,179,149,"51.47303687","-0.214749808","Bishop's Avenue, Fulham",328
"10050",2020,13,682,211,208,"51.48810829","-0.22660621","Crisp Road, Hammersmith",419
"10051",2020,13,683,88,99,"51.46506424","-0.163750945","Dorothy Road, Clapham Junction",187
"10052",2020,13,684,167,170,"51.45475251","-0.195197203","Neville Gill Close, Wandsworth",337
"10053",2020,13,685,87,88,"51.46067005","-0.198735357","Osiers Road, Wandsworth",175
"10054",2020,13,686,56,64,"51.48814438","-0.222456468","Beryl Road, Hammersmith",120
"10055",2020,13,687,104,97,"51.49760804","-0.21145598","Maclise Road, Olympia",201
"10056",2020,13,688,47,48,"51.46095151","-0.20066766","Northfields, Wandsworth",95
"10057",2020,13,689,53,41,"51.45922541","-0.180884959","Spanish Road, Clapham Junction",94
"10058",2020,13,690,64,58,"51.47047503","-0.152130083","Stanley Grove, Battersea",122
"10059",2020,13,691,141,167,"51.47946386","-0.195777222","Erin Close, Walham Green",308
"10060",2020,13,692,214,224,"51.54211855","-0.028941601","Cadogan Close, Victoria Park",438
"10061",2020,13,693,71,62,"51.464786","-0.215618902","Felsham Road, Putney",133
"10062",2020,13,694,92,88,"51.46071722","-0.216526155","Putney Rail Station, Putney",180
"10063",2020,13,695,242,261,"51.53638435","-0.102757578","Islington Green, Angel",503
"10064",2020,13,696,73,69,"51.48728535","-0.217995921","Charing Cross Hospital, Hammersmith",142
"10065",2020,13,697,78,77,"51.53639219","-0.112721065","Charlotte Terrace, Angel",155
"10066",2020,13,698,84,77,"51.53908372","-0.070329419","Shoreditch Court, Haggerston",161
"10067",2020,13,699,45,53,"51.5366541","-0.07023031","Belford House, Haggerston",98
"10068",2020,13,700,112,109,"51.47696496","-0.174347066","Battersea Church Road, Battersea",221
"10069",2020,13,701,173,157,"51.47287627","-0.176267008","Vicarage Crescent, Battersea",330
"10070",2020,13,702,87,73,"51.52868155","-0.065550321","Durant Street, Bethnal Green",160
"10071",2020,13,703,57,67,"51.51505991","-0.10534448","St. Bride Street, Holborn",124
"10072",2020,13,704,41,37,"51.45682071","-0.202802098","Mexfield Road, East Putney",78
"10073",2020,13,705,55,55,NA,NA,NA,110
"10074",2020,13,706,58,76,"51.50215353","-0.083632928","Snowsfields, London Bridge",134
"10075",2020,13,707,78,84,"51.49021762","-0.215087092","Barons Court Station, West Kensington",162
"10076",2020,13,708,47,55,"51.46161068","-0.21614583","Disraeli Road, Putney",102
"10077",2020,13,709,62,65,"51.46321128","-0.215550761","Montserrat Road , Putney",127
"10078",2020,13,710,169,182,"51.47439218","-0.163347594","Albert Bridge Road, Battersea Park",351
"10079",2020,13,711,70,68,"51.48335692","-0.216305546","Everington Street, Fulham",138
"10080",2020,13,712,116,109,"51.51854104","-0.034903714","Mile End Stadium, Mile End",225
"10081",2020,13,713,34,37,"51.54100708","-0.14326094","Hawley Crescent, Camden Town",71
"10082",2020,13,714,56,51,"51.47311696","-0.137235175","Stewart's Road, Wandsworth Road",107
"10083",2020,13,715,91,71,"51.51563007","-0.049067243","Aylward Street, Stepney",162
"10084",2020,13,716,80,72,"51.51542791","-0.02356501","Stainsby Road , Poplar",152
"10085",2020,13,717,176,173,"51.53658514","-0.075885686","Dunston Road , Haggerston",349
"10086",2020,13,718,71,92,"51.53571683","-0.060291813","Ada Street, Hackney Central",163
"10087",2020,13,719,219,202,"51.53642464","-0.054162264","Victoria Park Road, Hackney Central",421
"10088",2020,13,720,83,79,"51.48724429","-0.205279052","Star Road, West Kensington",162
"10089",2020,13,721,82,82,"51.53603947","-0.026262677","Wendon Street, Old Ford",164
"10090",2020,13,722,65,60,"51.52458353","-0.058631453","Finnis Street, Bethnal Green",125
"10091",2020,13,723,175,174,"51.46822047","-0.190346493","Stephendale Road, Sands End",349
"10092",2020,13,724,54,42,"51.45799126","-0.184806157","Alma Road, Wandsworth",96
"10093",2020,13,725,139,128,"51.491327","-0.096518684","Walworth Square, Walworth",267
"10094",2020,13,726,114,107,"51.47505096","-0.150908371","Alfreda Street, Battersea Park",221
"10095",2020,13,727,127,112,"51.47569809","-0.20587627","Chesilton Road, Fulham",239
"10096",2020,13,728,61,49,"51.46199911","-0.206240805","Putney Bridge Road, East Putney",110
"10097",2020,13,729,115,123,"51.47893931","-0.208485293","St. Peter's Terrace, Fulham",238
"10098",2020,13,730,116,139,"51.49208492","-0.229116862","Bridge Avenue, Hammersmith",255
"10099",2020,13,731,64,63,"51.47727637","-0.189210466","Michael Road, Walham Green",127
"10100",2020,13,732,123,128,"51.50630441","-0.087262995","Duke Street Hill, London Bridge",251
"10101",2020,13,733,27,19,"51.50542628","-0.150817316","Park Lane, Mayfair",46
"10102",2020,13,734,62,64,"51.46230566","-0.175407201","Plough Terrace, Clapham Junction",126
"10103",2020,13,735,48,49,"51.46489445","-0.17302926","Grant Road East, Clapham Junction",97
"10104",2020,13,736,47,36,"51.50659035","-0.216104479","Queensdale Road, Shepherd's Bush",83
"10105",2020,13,737,190,214,"51.47993289","-0.19411695","Fulham Broadway, Walham Green",404
"10106",2020,13,738,68,42,"51.47514228","-0.187278987","Imperial Road, Sands End",110
"10107",2020,13,739,89,86,"51.48176572","-0.185273723","Hortensia Road, West Brompton",175
"10108",2020,13,740,24,31,"51.51092871","-0.214594781","Sirdar Road, Avondale",55
"10109",2020,13,741,30,30,"51.5129814","-0.219486603","Freston Road, Avondale",60
"10110",2020,13,742,104,115,"51.51510818","-0.208565479","Blenheim Crescent, Ladbroke Grove",219
"10111",2020,13,743,34,38,"51.46079243","-0.212607684","Oxford Road, Putney",72
"10112",2020,13,744,55,59,"51.46745485","-0.172293499","Ingrave Street, Clapham Junction",114
"10113",2020,13,745,46,28,"51.47816972","-0.18243547","Upcerne Road, West Chelsea",74
"10114",2020,13,746,79,87,"51.4795738","-0.17903854","Lots Road, West Chelsea",166
"10115",2020,13,747,70,71,"51.48796408","-0.161765173","Ormonde Gate, Chelsea",141
"10116",2020,13,748,128,113,"51.53727795","-0.079201849","Hertford Road, De Beauvoir Town",241
"10117",2020,13,749,175,191,"51.53932857","-0.074284675","Haggerston Road, Haggerston",366
"10118",2020,13,750,35,33,"51.4710956","-0.157850096","Culvert Road, Battersea",68
"10119",2020,13,751,26,25,"51.51612862","-0.120909408","Newton Street, Covent Garden",51
"10120",2020,13,754,20,23,"51.5129006","-0.214762686","Grenfell Road, Avondale",43
"10121",2020,13,755,101,104,"51.48512191","-0.174971902","The Vale, Chelsea",205
"10122",2020,13,756,148,160,"51.47515398","-0.159169801","Prince of Wales Drive, Battersea Park",308
"10123",2020,13,757,141,147,"51.48795853","-0.187404506","Harcourt Terrace, West Brompton",288
"10124",2020,13,758,113,104,"51.51787005","-0.201005397","Westbourne Park Road, Portobello",217
"10125",2020,13,759,40,35,"51.52456169","-0.165668686","Broadley Terrace, Marylebone",75
"10126",2020,13,760,37,40,"51.52526975","-0.163795009","Rossmore Road, Marylebone",77
"10127",2020,13,761,74,65,"51.48321729","-0.211860644","Humbolt Road, Fulham",139
"10128",2020,13,762,249,257,"51.50070305","-0.129698963","Storey's Gate, Westminster",506
"10129",2020,13,763,133,118,"51.52059714","-0.032566533","Mile End Park Leisure Centre, Mile End",251
"10130",2020,13,764,109,121,"51.46239255","-0.16829214","St. John's Road, Clapham Junction",230
"10131",2020,13,765,70,67,"51.46760141","-0.20682737","Ranelagh Gardens, Fulham",137
"10132",2020,13,766,111,120,"51.45752945","-0.192165613","Ram Street, Wandsworth",231
"10133",2020,13,767,16,19,"51.45705988","-0.200806304","Santos Road, Wandsworth",35
"10134",2020,13,768,206,205,"51.46134382","-0.159322467","Clapham Common North Side, Clapham Common",411
"10135",2020,13,769,112,108,"51.473611","-0.191803","Sandilands Road, Walham Green",220
"10136",2020,13,770,107,108,"51.491026","-0.209121","Gwendwr Road, West Kensington",215
"10137",2020,13,771,33,39,"51.509224","-0.216016","Rifle Place, Avondale",72
"10138",2020,13,772,184,194,"51.47250956","-0.122831913","Binfield Road, Stockwell",378
"10139",2020,13,773,91,90,"51.511891","-0.107349","Tallis Street, Temple",181
"10140",2020,13,774,50,41,"51.470131","-0.20464","Hurlingham Park, Parsons Green",91
"10141",2020,13,775,78,80,"51.496664","-0.223868","Little Brook Green, Brook Green",158
"10142",2020,13,776,61,76,"51.460333","-0.167029","Abyssinia Close, Clapham Junction",137
"10143",2020,13,777,43,47,"51.4619230679","-0.165297856693","Limburg Road, Clapham Junction",90
"10144",2020,13,779,70,71,"51.514449","-0.077178979","Houndsditch, Aldgate",141
"10145",2020,13,780,177,178,"51.474665","-0.18316517","Imperial Wharf Station, Sands End",355
"10146",2020,13,781,34,25,"51.495898","-0.173009","Victoria & Albert Museum, South Kensington",59
"10147",2020,13,782,118,109,"51.483911","-0.19760944","Halford Road, West Kensington",227
"10148",2020,13,783,113,121,"51.5403115","-0.021630359","Monier Road, Hackney Wick",234
"10149",2020,13,784,212,196,"51.546326","-0.00993526","East Village, Queen Elizabeth Olympic Park",408
"10150",2020,13,785,267,282,"51.54094","-0.010510565","Aquatic Centre, Queen Elizabeth Olympic Park",549
"10151",2020,13,786,160,156,"51.549369","-0.015717614","Lee Valley VeloPark, Queen Elizabeth Olympic Park",316
"10152",2020,13,787,243,226,"51.546805","-0.01469126","Timber Lodge, Queen Elizabeth Olympic Park",469
"10153",2020,13,789,257,264,"51.538718","-0.011889482","Podium, Queen Elizabeth Olympic Park",521
"10154",2020,13,790,78,97,"51.541793","-0.00481","Stratford Station, Stratford",175
"10155",2020,13,792,49,52,"51.505461","-0.10454093","Blackfriars Road, Southwark",101
"10156",2020,13,793,72,82,"51.528279","-0.11955857","Cromer Street, Bloomsbury",154
"10157",2020,13,795,27,23,"51.527068","-0.13186102","Euston Square Gardens, Euston",50
"10158",2020,13,796,62,56,"51.524","-0.12640984","Coram Street, Bloomsbury",118
"10159",2020,13,797,23,23,"51.5293","-0.12827903","Ossulston Street, Somers Town",46
"10160",2020,13,798,48,53,"51.5301998755","-0.122299440803","Birkenhead Street, King's Cross",101
"10161",2020,13,799,30,33,"51.4976984561","-0.137598896295","Kings Gate House, Westminster",63
"10162",2020,13,800,15,20,"51.4811219398","-0.149035374873","Sopwith Way, Battersea Park",35
"10163",2020,13,801,69,72,"51.5052241745","-0.0980318118664","Lavington Street, Bankside",141
"10164",2020,13,802,166,172,"51.4765900593","-0.118256789081","Albert Square, Stockwell",338
"10165",2020,13,803,64,93,"51.5054099403","-0.0983410884509","Southwark Street, Bankside",157
"10166",2020,13,804,47,94,"51.5346677396","-0.125078652873","Good's Way, King's Cross",141
"10167",2020,13,806,72,65,"51.5372405623","-0.124807385707","Handyside Street, King's Cross",137
"10168",2020,13,807,189,185,"51.5212","-0.20888818","Bevington Road West, North Kensington",374
"10169",2020,13,809,34,29,"51.5162778834","-0.118272991635","Lincoln's Inn Fields, Holborn",63
"10170",2020,13,810,56,58,"51.5067252868","-0.0988072461627","Tate Modern, Bankside",114
"10171",2020,13,811,200,209,"51.5057030357","-0.0277727426235","Westferry Circus, Canary Wharf",409
"10172",2020,13,812,52,67,"51.5487311915","-0.0226065549321","Here East North, Queen Elizabeth Olympic Park",119
"10173",2020,13,813,44,69,"51.4878074485","-0.122759625866","New Spring Gardens Walk, Vauxhall",113
"10174",2020,13,814,104,113,"51.4714330677","-0.123670735702","Clapham Road, Lingham Street, Stockwell",217
"10175",2020,13,815,218,193,"51.5000891978","-0.116628700672","Lambeth Palace Road, Waterloo",411
"10176",2020,13,816,31,21,"51.5465327935","-0.0205975904647","Here East South, Queen Elizabeth Olympic Park",52
"10177",2020,13,817,179,162,"51.4813354746","-0.138212295869","Riverlight South, Nine Elms",341
"10178",2020,13,818,272,267,"51.501513","-0.12382322","Westminster Pier, Westminster",539
"10179",2020,13,819,35,34,"51.50621","-0.114842","Belvedere Road 2, South Bank",69
"10180",2020,13,820,86,77,"51.492807","-0.091938","Victory Place, Walworth",163
"10181",2020,13,821,211,233,"51.4835074867","-0.147714557371","Battersea Power Station, Battersea Park",444
"10182",2020,13,826,77,81,"51.496863","-0.1429434","Allington Street, Victoria",158
"10183",2020,13,827,139,146,"51.479601","-0.11147178","Cranmer Road, Stockwell",285
"10184",2020,13,828,95,97,"51.473874","-0.11258096","Normandy Road, Stockwell",192
"10185",2020,13,829,67,58,"51.469217","-0.11268674","Wynne Road, Stockwell",125
"10186",2020,13,830,93,79,"51.469202","-0.11902256","Sidney Road, Stockwell",172
"10187",2020,13,831,68,81,"51.466232","-0.11317995","St John's Crescent, Brixton",149
"10188",2020,13,832,160,175,"51.464019","-0.11578197","Ferndale Road, Brixton",335
"10189",2020,13,833,239,254,"51.460232","-0.11537509","Saltoun Road, Brixton",493
"10190",2020,13,834,167,170,"51.477966","-0.14785703","Gas Holders, Battersea Park",337
"10191",2020,13,835,42,55,"51.516785","-0.10494775","Farringdon Street, Holborn",97
"10192",2020,13,836,83,62,"51.541596","-0.12544145","York Way, Kings Cross",145
"10193",2020,13,838,27,21,"51.518093","-0.0914017","Fore Street Avenue, Guildhall",48
"10194",2020,13,839,113,120,"51.508033","-0.10682363","Sea Containers, South Bank",233
"10195",2020,14,1,75,63,"51.52916347","-0.109970527","River Street , Clerkenwell",138
"10196",2020,14,2,161,171,"51.49960695","-0.197574246","Phillimore Gardens, Kensington",332
"10197",2020,14,3,23,21,"51.52128377","-0.084605692","Christopher Street, Liverpool Street",44
"10198",2020,14,4,54,58,"51.53005939","-0.120973687","St. Chad's Street, King's Cross",112
"10199",2020,14,5,105,100,"51.49313","-0.156876","Sedding Street, Sloane Square",205
"10200",2020,14,6,121,119,"51.51811784","-0.144228881","Broadcasting House, Marylebone",240
"10201",2020,14,7,130,118,"51.53430039","-0.1680743","Charlbert Street, St. John's Wood",248
"10202",2020,14,8,232,242,"51.529857","-0.18348604","Maida Vale, Maida Vale",474
"10203",2020,14,9,139,124,"51.5073853","-0.096440751","New Globe Walk, Bankside",263
"10204",2020,14,10,63,63,"51.50597426","-0.092754157","Park Street, Bankside",126
"10205",2020,14,11,147,164,"51.52395143","-0.122502346","Brunswick Square, Bloomsbury",311
"10206",2020,14,12,60,58,"51.52168078","-0.130431727","Malet Street, Bloomsbury",118
"10207",2020,14,13,57,57,"51.51991453","-0.136039674","Scala Street, Fitzrovia",114
"10208",2020,14,14,162,165,"51.52994371","-0.123616824","Belgrove Street , King's Cross",327
"10209",2020,14,15,64,58,"51.51772703","-0.127854211","Great Russell Street, Bloomsbury",122
"10210",2020,14,16,74,68,"51.52635795","-0.125979294","Cartwright Gardens , Bloomsbury",142
"10211",2020,14,17,132,129,"51.5216612","-0.109006325","Hatton Wall, Holborn",261
"10212",2020,14,18,100,99,"51.51477076","-0.12221963","Drury Lane, Covent Garden",199
"10213",2020,14,19,27,20,"51.52505093","-0.131161087","Taviton Street, Bloomsbury",47
"10214",2020,14,20,15,18,"51.527326","-0.13605286","Drummond Street , Euston",33
"10215",2020,14,21,37,36,"51.53007835","-0.13884627","Hampstead Road (Cartmel), Euston",73
"10216",2020,14,22,112,140,"51.5222641","-0.114079481","Northington Street , Holborn",252
"10217",2020,14,23,61,51,"51.51943538","-0.119123345","Red Lion Square, Holborn",112
"10218",2020,14,24,68,66,"51.51908011","-0.124678402","British Museum, Bloomsbury",134
"10219",2020,14,25,69,55,"51.5288338","-0.132250369","Doric Way , Somers Town",124
"10220",2020,14,26,76,68,"51.52728093","-0.11829517","Ampton Street , Clerkenwell",144
"10221",2020,14,27,53,43,"51.51382102","-0.107927706","Bouverie Street, Temple",96
"10222",2020,14,28,166,170,"51.52351808","-0.143613641","Bolsover Street, Fitzrovia",336
"10223",2020,14,29,134,135,"51.513735","-0.193487","Hereford Road, Bayswater",269
"10224",2020,14,30,120,118,"51.52915444","-0.093421615","Windsor Terrace, Hoxton",238
"10225",2020,14,31,58,115,"51.52953709","-0.083353323","Fanshaw Street, Hoxton",173
"10226",2020,14,32,114,122,"51.52469624","-0.084439283","Leonard Circus , Shoreditch",236
"10227",2020,14,33,43,50,"51.5156","-0.070056","Central House, Aldgate",93
"10228",2020,14,34,59,68,"51.5341235","-0.129386874","Pancras Road, King's Cross",127
"10229",2020,14,36,171,179,"51.50173726","-0.184980612","De Vere Gardens, Kensington",350
"10230",2020,14,37,167,178,"51.49159394","-0.192369256","Penywern Road, Earl's Court",345
"10231",2020,14,38,101,111,"51.4973875","-0.197245586","Abingdon Villas, Kensington",212
"10232",2020,14,39,146,130,"51.5263778","-0.078130921","Shoreditch High Street, Shoreditch",276
"10233",2020,14,40,91,81,"51.52127071","-0.0755789","Commercial Street, Shoreditch",172
"10234",2020,14,41,30,32,"51.520955","-0.083493552","Pindar Street, Liverpool Street",62
"10235",2020,14,42,215,216,"51.53099181","-0.093903825","Wenlock Road , Hoxton",431
"10236",2020,14,43,119,124,"51.52026","-0.157183945","Crawford Street, Marylebone",243
"10237",2020,14,44,57,55,"51.51073687","-0.144165239","Bruton Street, Mayfair",112
"10238",2020,14,45,104,87,"51.522511","-0.162298","Boston Place, Marylebone",191
"10239",2020,14,46,1,1,"51.507131","-0.06691","Nesham Street, Wapping",2
"10240",2020,14,47,281,280,"51.52334476","-0.183846408","Warwick Avenue Station, Maida Vale",561
"10241",2020,14,48,102,100,"51.51248445","-0.099141408","Godliman Street, St. Paul's",202
"10242",2020,14,49,70,69,"51.50706909","-0.145904427","Curzon Street, Mayfair",139
"10243",2020,14,50,82,70,"51.52867339","-0.087459376","East Road, Hoxton",152
"10244",2020,14,51,56,50,"51.52671796","-0.104298194","Finsbury Library , Finsbury",106
"10245",2020,14,52,99,85,"51.52295439","-0.094934859","Roscoe Street, St. Luke's",184
"10246",2020,14,53,65,60,"51.5099923","-0.143495266","Grafton Street, Mayfair",125
"10247",2020,14,54,121,124,"51.52174785","-0.094475072","Golden Lane, Barbican",245
"10248",2020,14,55,88,82,"51.51707521","-0.086685542","Finsbury Circus, Liverpool Street",170
"10249",2020,14,56,71,84,"51.52058381","-0.154701411","Paddington Street, Marylebone",155
"10250",2020,14,57,137,136,"51.52334672","-0.120202614","Guilford Street , Bloomsbury",273
"10251",2020,14,58,80,87,"51.52452699","-0.079248081","New Inn Yard, Shoreditch",167
"10252",2020,14,60,99,91,"51.52644828","-0.172190727","Lisson Grove, St. John's Wood",190
"10253",2020,14,61,58,72,"51.49738251","-0.089446947","Great Dover Street, The Borough",130
"10254",2020,14,62,112,111,"51.4907579","-0.106323685","Cotton Garden Estate, Kennington",223
"10255",2020,14,63,81,67,"51.53089041","-0.089782579","Murray Grove , Hoxton",148
"10256",2020,14,64,115,120,"51.50946212","-0.124749274","William IV Street, Strand",235
"10257",2020,14,65,68,54,NA,NA,NA,122
"10258",2020,14,66,106,96,"51.51795029","-0.108657431","Holborn Circus, Holborn",202
"10259",2020,14,67,38,28,"51.51882555","-0.108028472","Hatton Garden, Holborn",66
"10260",2020,14,68,97,94,"51.52059681","-0.116688468","Theobald's Road , Holborn",191
"10261",2020,14,69,30,34,"51.5262363","-0.134407652","Euston Road, Euston",64
"10262",2020,14,70,36,34,"51.53136059","-0.117069978","Calshot Street , King's Cross",70
"10263",2020,14,71,139,118,"51.5154186","-0.098850915","Newgate Street , St. Paul's",257
"10264",2020,14,72,63,66,"51.52352001","-0.108340165","Farringdon Lane, Clerkenwell",129
"10265",2020,14,73,137,144,"51.52572618","-0.088486188","Old Street Station, St. Luke's",281
"10266",2020,14,74,310,310,"51.48591714","-0.124469948","Vauxhall Cross, Vauxhall",620
"10267",2020,14,75,54,64,"51.53219984","-0.105480698","Torrens Street, Angel",118
"10268",2020,14,76,49,40,"51.52559505","-0.144083893","Longford Street, The Regent's Park",89
"10269",2020,14,77,80,101,"51.52341837","-0.124121774","Russell Square Station, Bloomsbury",181
"10270",2020,14,78,69,57,"51.52486887","-0.099489485","Sadlers Sports Centre, Finsbury",126
"10271",2020,14,79,53,51,"51.511726","-0.11385596","Arundel Street, Temple",104
"10272",2020,14,80,127,118,"51.50069361","-0.102091246","Webber Street , Southwark",245
"10273",2020,14,81,114,105,"51.52025302","-0.141327271","Great Titchfield Street, Fitzrovia",219
"10274",2020,14,82,42,44,"51.514274","-0.111257","Chancery Lane, Holborn",86
"10275",2020,14,83,114,119,"51.50963938","-0.131510949","Panton Street, West End",233
"10276",2020,14,85,238,250,"51.50064702","-0.078600401","Tanner Street, Bermondsey",488
"10277",2020,14,86,67,63,"51.48947903","-0.115156562","Sancroft Street, Vauxhall",130
"10278",2020,14,87,52,45,"51.51646835","-0.079684557","Devonshire Square, Liverpool Street",97
"10279",2020,14,88,129,116,"51.51858757","-0.132053392","Bayley Street , Bloomsbury",245
"10280",2020,14,89,120,113,"51.5262503","-0.123509611","Tavistock Place, Bloomsbury",233
"10281",2020,14,90,24,22,"51.53301907","-0.139174593","Harrington Square 1, Camden Town",46
"10282",2020,14,91,157,146,"51.49368637","-0.111014912","Walnut Tree Walk, Vauxhall",303
"10283",2020,14,92,70,84,"51.49889832","-0.100440521","Borough Road, Elephant & Castle",154
"10284",2020,14,93,105,118,"51.53440868","-0.109025404","Cloudesley Road, Angel",223
"10285",2020,14,94,190,203,"51.49506109","-0.085814489","Bricklayers Arms, Borough",393
"10286",2020,14,95,141,150,"51.5208417","-0.097340162","Aldersgate Street, Barbican",291
"10287",2020,14,96,79,76,"51.53095071","-0.078505384","Falkirk Street, Hoxton",155
"10288",2020,14,97,167,177,"51.49792478","-0.183834706","Gloucester Road (North), Kensington",344
"10289",2020,14,98,136,114,"51.52554222","-0.138231303","Hampstead Road, Euston",250
"10290",2020,14,99,193,190,"51.51457763","-0.158264483","Old Quebec Street, Marylebone",383
"10291",2020,14,100,147,142,"51.49043573","-0.122806861","Albert Embankment, Vauxhall",289
"10292",2020,14,101,128,124,"51.51155322","-0.0929401","Queen Street 1, Bank",252
"10293",2020,14,102,84,83,"51.51340693","-0.076793375","Jewry Street, Aldgate",167
"10294",2020,14,103,119,109,"51.50472376","-0.192538767","Vicarage Gate, Kensington",228
"10295",2020,14,104,85,69,"51.51159481","-0.077121322","Crosswall, Tower",154
"10296",2020,14,105,170,184,"51.51552971","-0.190240716","Westbourne Grove, Bayswater",354
"10297",2020,14,106,19,18,"51.51410514","-0.147301667","Woodstock Street, Mayfair",37
"10298",2020,14,107,145,151,"51.52600832","-0.096317627","Finsbury Leisure Centre, St. Luke's",296
"10299",2020,14,108,115,97,"51.49812559","-0.132102166","Abbey Orchard Street, Westminster",212
"10300",2020,14,109,125,111,"51.51563144","-0.132328837","Soho Square , Soho",236
"10301",2020,14,110,111,110,"51.53304322","-0.172528678","Wellington Road, St. John's Wood",221
"10302",2020,14,111,226,251,"51.5100172","-0.157275636","Park Lane , Hyde Park",477
"10303",2020,14,112,44,49,"51.51580998","-0.105270275","Stonecutter Street, Holborn",93
"10304",2020,14,113,161,151,"51.49646288","-0.183289032","Gloucester Road (Central), South Kensington",312
"10305",2020,14,114,308,313,"51.52451738","-0.158963647","Park Road (Baker Street), The Regent's Park",621
"10306",2020,14,115,167,173,"51.51423368","-0.073537654","Braham Street, Aldgate",340
"10307",2020,14,116,97,98,"51.51449962","-0.141423695","Little Argyll Street, West End",195
"10308",2020,14,117,107,107,"51.49288067","-0.114934001","Lollard Street, Vauxhall",214
"10309",2020,14,118,85,90,"51.49582705","-0.13547809","Rochester Row, Westminster",175
"10310",2020,14,119,142,161,"51.52589324","-0.090847761","Bath Street, St. Luke's",303
"10311",2020,14,120,61,55,"51.51573534","-0.093080779","The Guildhall, Guildhall",116
"10312",2020,14,121,54,51,"51.51891348","-0.156166631","Baker Street, Marylebone",105
"10313",2020,14,122,78,56,"51.52111369","-0.078869751","Norton Folgate, Liverpool Street",134
"10314",2020,14,123,57,67,"51.52836014","-0.104724625","St. John Street, Finsbury",124
"10315",2020,14,124,29,29,"51.49654462","-0.150905245","Eaton Square, Belgravia",58
"10316",2020,14,125,92,98,"51.50069491","-0.094524319","Borough High Street, The Borough",190
"10317",2020,14,126,38,37,"51.51782144","-0.096496865","Museum of London, Barbican",75
"10318",2020,14,127,38,33,"51.51700801","-0.09388536","Wood Street, Guildhall",71
"10319",2020,14,128,145,142,"51.49536226","-0.185296516","Emperor's Gate, South Kensington",287
"10320",2020,14,129,95,94,"51.5118973","-0.137043852","Golden Square, Soho",189
"10321",2020,14,130,361,382,"51.50950627","-0.075459482","Tower Gardens , Tower",743
"10322",2020,14,131,63,54,"51.53300545","-0.136792671","Eversholt Street , Camden Town",117
"10323",2020,14,132,185,194,"51.52364804","-0.074754872","Bethnal Green Road, Shoreditch",379
"10324",2020,14,133,253,272,NA,NA,NA,525
"10325",2020,14,134,269,277,"51.504904","-0.06797","Wapping High Street, Wapping",546
"10326",2020,14,135,95,114,"51.52326004","-0.104708922","Clerkenwell Green, Clerkenwell",209
"10327",2020,14,136,134,129,"51.51196176","-0.097441687","Queen Victoria Street, St. Paul's",263
"10328",2020,14,138,149,147,"51.51227622","-0.157436972","Green Street, Mayfair",296
"10329",2020,14,139,104,104,"51.49488108","-0.117974901","Lambeth Road, Vauxhall",208
"10330",2020,14,140,57,56,"51.52096262","-0.085634242","Finsbury Square , Moorgate",113
"10331",2020,14,141,58,47,"51.51530805","-0.147203711","Chapel Place, Marylebone",105
"10332",2020,14,142,123,118,"51.49372451","-0.198286569","West Cromwell Road, Earl's Court",241
"10333",2020,14,143,119,111,"51.4968865","-0.161203828","Pont Street, Knightsbridge",230
"10334",2020,14,144,192,189,"51.48894022","-0.111435796","Kennington Cross, Kennington",381
"10335",2020,14,145,89,76,"51.50074359","-0.202759212","Ilchester Place, Kensington",165
"10336",2020,14,146,114,110,"51.48836528","-0.129361842","Vauxhall Bridge , Pimlico",224
"10337",2020,14,148,142,150,"51.49211134","-0.138364847","Tachbrook Street, Victoria",292
"10338",2020,14,149,215,214,"51.48478899","-0.110683213","Kennington Road Post Office, Oval",429
"10339",2020,14,150,102,97,"51.49705603","-0.168917077","Holy Trinity Brompton, Knightsbridge",199
"10340",2020,14,151,130,121,"51.51213691","-0.201554966","Chepstow Villas, Notting Hill",251
"10341",2020,14,152,181,178,"51.49217002","-0.101536865","Hampton Street, Walworth",359
"10342",2020,14,153,369,371,"51.511933","-0.174411","Bayswater Road, Hyde Park",740
"10343",2020,14,154,37,24,"51.50379168","-0.11282408","Waterloo Station 3, Waterloo",61
"10344",2020,14,155,92,107,"51.49586666","-0.191933711","Lexham Gardens, Kensington",199
"10345",2020,14,156,68,84,"51.49443626","-0.092921165","New Kent Road, The Borough",152
"10346",2020,14,157,127,124,"51.50039792","-0.193068385","Wright's Lane, Kensington",251
"10347",2020,14,158,128,129,"51.49085368","-0.196170309","Trebovir Road, Earl's Court",257
"10348",2020,14,159,121,123,"51.51461995","-0.137841333","Great Marlborough Street, Soho",244
"10349",2020,14,160,94,89,"51.50663341","-0.131773845","Waterloo Place, St. James's",183
"10350",2020,14,161,60,61,"51.49234577","-0.141334487","Guildhouse Street, Victoria",121
"10351",2020,14,162,75,71,"51.51760685","-0.121328408","Southampton Place, Holborn",146
"10352",2020,14,163,166,189,"51.4931848","-0.167894973","Sloane Avenue, Knightsbridge",355
"10353",2020,14,164,115,102,"51.515607","-0.183118788","Cleveland Gardens, Bayswater",217
"10354",2020,14,165,57,46,"51.517932","-0.183716959","Orsett Terrace, Bayswater",103
"10355",2020,14,166,85,70,"51.50185512","-0.159237081","Seville Street, Knightsbridge",155
"10356",2020,14,167,99,101,"51.49395092","-0.147624377","Eccleston Place, Victoria",200
"10357",2020,14,168,108,113,"51.50040123","-0.195455928","Argyll Road, Kensington",221
"10358",2020,14,169,200,220,"51.51474612","-0.165164288","Porchester Place, Paddington",420
"10359",2020,14,170,54,47,"51.52784273","-0.108068155","Hardwick Street, Clerkenwell",101
"10360",2020,14,171,127,130,"51.4916156","-0.186753859","Collingham Gardens, Earl's Court",257
"10361",2020,14,172,145,159,"51.49121192","-0.173715911","Sumner Place, South Kensington",304
"10362",2020,14,173,27,41,"51.50486","-0.113001","Waterloo Road, South Bank",68
"10363",2020,14,174,60,61,"51.512529","-0.115163","Strand, Strand",121
"10364",2020,14,175,28,39,"51.521668","-0.079608554","Worship Street, Shoreditch",67
"10365",2020,14,176,120,115,"51.51791921","-0.188098863","Gloucester Terrace, Bayswater",235
"10366",2020,14,177,108,114,"51.49616092","-0.140947636","Ashley Place, Victoria",222
"10367",2020,14,178,199,187,"51.48985626","-0.141923621","Warwick Square, Pimlico",386
"10368",2020,14,180,119,113,"51.5129118","-0.153645496","North Audley Street, Mayfair",232
"10369",2020,14,181,75,64,"51.49941247","-0.152317537","Belgrave Square, Belgravia",139
"10370",2020,14,182,103,89,"51.52202903","-0.165842551","Bell Street , Marylebone",192
"10371",2020,14,183,268,255,"51.482362","-0.13612398","Riverlight North, Nine Elms",523
"10372",2020,14,184,122,122,"51.52071513","-0.14521173","Portland Place, Marylebone",244
"10373",2020,14,185,173,173,"51.48805753","-0.140741432","Alderney Street, Pimlico",346
"10374",2020,14,186,123,115,"51.51733558","-0.175810943","South Wharf Road, Paddington",238
"10375",2020,14,187,171,176,"51.49247977","-0.178433004","Queen's Gate (South), South Kensington",347
"10376",2020,14,188,60,51,"51.5165179","-0.164393768","Nutford Place, Marylebone",111
"10377",2020,14,189,73,56,"51.53166681","-0.109914711","Claremont Square, Angel",129
"10378",2020,14,190,137,128,"51.48997562","-0.132845681","Rampayne Street, Pimlico",265
"10379",2020,14,191,797,787,"51.50311799","-0.153520935","Hyde Park Corner, Hyde Park",1584
"10380",2020,14,192,163,166,"51.51251523","-0.133201961","Wardour Street, Soho",329
"10381",2020,14,193,87,72,"51.50581776","-0.100186337","Bankside Mix, Bankside",159
"10382",2020,14,194,318,371,"51.50462759","-0.091773776","Hop Exchange, The Borough",689
"10383",2020,14,195,151,150,"51.50724437","-0.106237501","Milroy Walk, South Bank",301
"10384",2020,14,196,110,101,"51.50368837","-0.098497684","Union Street, The Borough",211
"10385",2020,14,197,71,61,"51.50556905","-0.111606696","Stamford Street, South Bank",132
"10386",2020,14,199,153,145,"51.51048489","-0.082989638","Great Tower Street, Monument",298
"10387",2020,14,200,137,140,"51.51492456","-0.066078037","LMU Commercial Road, Whitechapel",277
"10388",2020,14,201,168,176,"51.5225965","-0.161113413","Dorset Square, Marylebone",344
"10389",2020,14,202,191,218,"51.51236389","-0.06954201","Leman Street, Aldgate",409
"10390",2020,14,203,97,100,"51.51821864","-0.100791005","West Smithfield Rotunda, Farringdon",197
"10391",2020,14,204,59,59,"51.52659961","-0.112432615","Margery Street, Clerkenwell",118
"10392",2020,14,206,122,124,"51.518154","-0.062697","New Road 1 , Whitechapel",246
"10393",2020,14,207,48,40,"51.50135267","-0.153194766","Grosvenor Crescent, Belgravia",88
"10394",2020,14,208,44,25,"51.52505151","-0.166304359","Mallory Street, Marylebone",69
"10395",2020,14,209,86,69,"51.49358391","-0.165101392","Denyer Street, Knightsbridge",155
"10396",2020,14,210,85,80,"51.51681444","-0.151926305","Hinde Street, Marylebone",165
"10397",2020,14,211,91,77,"51.49464523","-0.158105512","Cadogan Place, Knightsbridge",168
"10398",2020,14,212,71,50,"51.50658458","-0.199004026","Campden Hill Road, Notting Hill",121
"10399",2020,14,213,583,584,"51.50274025","-0.149569201","Wellington Arch, Hyde Park",1167
"10400",2020,14,214,51,70,"51.52683806","-0.130504336","Endsleigh Gardens, Euston",121
"10401",2020,14,215,52,52,"51.51906932","-0.088285377","Moorfields, Moorgate",104
"10402",2020,14,216,193,181,"51.49094565","-0.181190899","Old Brompton Road, South Kensington",374
"10403",2020,14,217,136,133,"51.51615461","-0.082422399","Wormwood Street, Liverpool Street",269
"10404",2020,14,218,134,154,"51.48971651","-0.170194408","St. Luke's Church, Chelsea",288
"10405",2020,14,219,222,225,"51.49016361","-0.19039362","Bramham Gardens, Earl's Court",447
"10406",2020,14,220,128,136,"51.49066456","-0.166485083","Chelsea Green, Chelsea",264
"10407",2020,14,221,106,113,"51.49481649","-0.13045856","Horseferry Road, Westminster",219
"10408",2020,14,222,83,68,"51.50275704","-0.155349725","Knightsbridge, Hyde Park",151
"10409",2020,14,223,181,183,"51.49148474","-0.090220911","Rodney Road , Walworth",364
"10410",2020,14,224,227,235,"51.51031","-0.18740235","Queensway, Kensington Gardens",462
"10411",2020,14,225,189,173,"51.50935342","-0.196422","Notting Hill Gate Station, Notting Hill",362
"10412",2020,14,226,59,58,"51.50844614","-0.131961389","Charles II Street, West End",117
"10413",2020,14,227,74,91,"51.52891573","-0.115480888","Great Percy Street, Clerkenwell",165
"10414",2020,14,228,134,141,"51.50742485","-0.134621209","St. James's Square, St. James's",275
"10415",2020,14,229,208,199,"51.50654321","-0.123179697","Whitehall Place, Strand",407
"10416",2020,14,230,86,73,"51.50669284","-0.103137426","Poured Lines, Bankside",159
"10417",2020,14,231,120,111,"51.49396755","-0.17873226","Queen's Gate (Central), South Kensington",231
"10418",2020,14,232,18,17,"51.51501025","-0.112753217","Carey Street, Holborn",35
"10419",2020,14,233,157,167,"51.50777049","-0.130699733","Pall Mall East, West End",324
"10420",2020,14,234,154,157,"51.53450449","-0.106992706","Liverpool Road (N1 Centre), Angel",311
"10421",2020,14,235,87,93,"51.49571828","-0.110889274","Kennington Road  , Vauxhall",180
"10422",2020,14,236,47,48,"51.51838043","-0.073438925","Fashion Street, Whitechapel",95
"10423",2020,14,237,198,201,"51.5097860151","-0.0681619805156","Dock Street, Wapping",399
"10424",2020,14,238,78,62,"51.5233534","-0.175116099","Frampton Street, Paddington",140
"10425",2020,14,239,131,142,"51.52443845","-0.138019439","Warren Street Station, Euston",273
"10426",2020,14,240,22,17,"51.50545935","-0.10569204","Colombo Street, Southwark",39
"10427",2020,14,242,130,134,"51.52200801","-0.151359288","Beaumont Street, Marylebone",264
"10428",2020,14,243,179,186,"51.49096258","-0.139625122","Gloucester Street, Pimlico",365
"10429",2020,14,244,66,59,"51.51611887","-0.128585022","Earnshaw Street , Covent Garden",125
"10430",2020,14,245,141,126,"51.4853572","-0.142207481","Grosvenor Road, Pimlico",267
"10431",2020,14,246,127,134,"51.52285301","-0.099994052","Berry Street, Clerkenwell",261
"10432",2020,14,247,150,121,"51.530529","-0.167515","St. John's Wood Church, The Regent's Park",271
"10433",2020,14,248,707,707,"51.50645179","-0.170279555","Triangle Car Park, Hyde Park",1414
"10434",2020,14,249,85,61,"51.49859784","-0.096191134","Harper Road, The Borough",146
"10435",2020,14,250,61,63,"51.489932","-0.162727","Royal Avenue 1, Chelsea",124
"10436",2020,14,251,157,177,"51.518908","-0.079249","Brushfield Street, Liverpool Street",334
"10437",2020,14,252,188,207,"51.5046364","-0.116542278","Jubilee Gardens, South Bank",395
"10438",2020,14,253,269,284,"51.53404294","-0.086379717","Shoreditch Park, Hoxton",553
"10439",2020,14,254,117,113,"51.53051587","-0.106408455","Chadwell Street, Angel",230
"10440",2020,14,255,184,182,"51.52557531","-0.179592915","Clifton Road, Maida Vale",366
"10441",2020,14,256,31,26,"51.51362054","-0.116764211","Houghton Street, Strand",57
"10442",2020,14,257,70,65,"51.52248185","-0.154907218","Westminster University, Marylebone",135
"10443",2020,14,259,181,141,"51.490959","-0.1532331","Bourne Street, Belgravia",322
"10444",2020,14,260,64,66,"51.5136846","-0.135580879","Broadwick Street, Soho",130
"10445",2020,14,261,139,136,"51.5134891","-0.191351186","Princes Square, Bayswater",275
"10446",2020,14,262,80,81,"51.49874469","-0.103132904","LSBU (Borough Road), Elephant & Castle",161
"10447",2020,14,263,50,55,"51.51422502","-0.080660083","St. Mary Axe, Aldgate",105
"10448",2020,14,264,93,115,"51.52644342","-0.109256828","Tysoe Street, Clerkenwell",208
"10449",2020,14,265,98,91,"51.51595344","-0.169249375","Southwick Street, Paddington",189
"10450",2020,14,266,167,196,"51.50102668","-0.180246101","Queen's Gate (North), Kensington",363
"10451",2020,14,267,142,129,"51.49206037","-0.132224622","Regency Street, Westminster",271
"10452",2020,14,268,87,92,"51.49320445","-0.144132875","Belgrave Road, Victoria",179
"10453",2020,14,269,143,150,"51.50082346","-0.089740764","Empire Square, The Borough",293
"10454",2020,14,270,206,198,"51.4863434","-0.122492418","Kennington Lane Rail Bridge, Vauxhall",404
"10455",2020,14,271,183,213,"51.53583617","-0.156285395","London Zoo,  The Regent's Park",396
"10456",2020,14,272,145,173,"51.50144456","-0.110699309","Baylis Road, Waterloo",318
"10457",2020,14,273,62,51,"51.50613324","-0.114686385","Belvedere Road 1, South Bank",113
"10458",2020,14,274,80,109,"51.49671237","-0.20528437","Warwick Road, Olympia",189
"10459",2020,14,275,54,60,"51.52004497","-0.092176447","Barbican Centre, Barbican",114
"10460",2020,14,276,50,48,"51.50930161","-0.084985356","Lower Thames Street, Monument",98
"10461",2020,14,277,147,151,"51.50315739","-0.191496313","Kensington Church Street, Kensington",298
"10462",2020,14,278,347,370,"51.5034938","-0.07962099","Tooley Street, Bermondsey",717
"10463",2020,14,279,74,57,"51.51862243","-0.176645823","North Wharf Road, Paddington",131
"10464",2020,14,280,87,86,"51.490083","-0.162418","Royal Avenue 2, Chelsea",173
"10465",2020,14,281,113,127,"51.49580589","-0.127575233","Smith Square, Westminster",240
"10466",2020,14,282,283,278,"51.51906446","-0.059642081","Royal London Hospital, Whitechapel",561
"10467",2020,14,283,25,20,"51.51440928","-0.118478757","Kingsway, Covent Garden",45
"10468",2020,14,284,107,101,"51.49914063","-0.112031483","Lambeth North Station, Waterloo",208
"10469",2020,14,286,92,77,"51.5272947","-0.174653609","St. John's Wood Road, St. John's Wood",169
"10470",2020,14,287,23,22,"51.52367314","-0.128377673","Bedford Way, Bloomsbury",45
"10471",2020,14,288,136,139,"51.49236962","-0.147478734","Elizabeth Bridge, Victoria",275
"10472",2020,14,289,32,29,"51.50923022","-0.151296092","South Audley Street, Mayfair",61
"10473",2020,14,290,126,131,"51.518268","-0.17110323","St Mary's Hospital, Paddington",257
"10474",2020,14,291,164,157,"51.48483991","-0.138089062","Claverton Street, Pimlico",321
"10475",2020,14,292,165,176,"51.49888404","-0.165471605","Montpelier Street, Knightsbridge",341
"10476",2020,14,293,68,71,"51.49815779","-0.209494128","Kensington Olympia Station, Olympia",139
"10477",2020,14,294,158,168,"51.488226","-0.135635511","St. George's Square, Pimlico",326
"10478",2020,14,295,75,76,"51.50029631","-0.092762704","Swan Street, The Borough",151
"10479",2020,14,296,111,110,"51.49363156","-0.190603326","Knaresborough Place, Earl's Court",221
"10480",2020,14,297,45,36,"51.49612799","-0.106000855","Geraldine Street, Elephant & Castle",81
"10481",2020,14,298,321,328,"51.50227992","-0.074189225","Curlew Street, Shad Thames",649
"10482",2020,14,299,55,52,"51.49398524","-0.136928582","Vincent Square, Westminster",107
"10483",2020,14,300,433,420,"51.505014","-0.17306032","Serpentine Car Park, Hyde Park",853
"10484",2020,14,301,101,96,"51.51475963","-0.148105415","Marylebone Lane, Marylebone",197
"10485",2020,14,302,187,185,"51.466907","-0.216573","Putney Pier, Wandsworth",372
"10486",2020,14,303,563,565,"51.50295379","-0.158456089","Albert Gate, Hyde Park",1128
"10487",2020,14,306,75,57,"51.51816295","-0.135025698","Rathbone Street, Fitzrovia",132
"10488",2020,14,307,694,710,"51.50990837","-0.187842717","Black Lion Gate, Kensington Gardens",1404
"10489",2020,14,308,134,128,"51.49907558","-0.085666316","Long Lane , Bermondsey",262
"10490",2020,14,309,112,107,"51.50963123","-0.119047563","Embankment (Savoy), Strand",219
"10491",2020,14,310,97,90,"51.4908679","-0.116911864","Black Prince Road, Vauxhall",187
"10492",2020,14,311,94,96,"51.51918144","-0.140485596","Foley Street, Fitzrovia",190
"10493",2020,14,312,190,186,"51.53088935","-0.176770502","Grove End Road, St. John's Wood",376
"10494",2020,14,313,84,76,"51.51734403","-0.138072691","Wells Street, Fitzrovia",160
"10495",2020,14,314,77,93,"51.50088934","-0.083159352","Tyers Gate, Bermondsey",170
"10496",2020,14,315,328,321,"51.52536703","-0.153463612","The Tennis Courts, The Regent's Park",649
"10497",2020,14,316,136,151,NA,NA,NA,287
"10498",2020,14,317,26,47,"51.49679128","-0.093913472","Dickens Square, Borough",73
"10499",2020,14,318,105,97,"51.51004801","-0.138846453","Sackville Street, Mayfair",202
"10500",2020,14,319,77,82,"51.52702563","-0.088542771","Baldwin Street, St. Luke's",159
"10501",2020,14,320,121,130,"51.49357351","-0.139956043","Queen Mother Sports Centre, Victoria",251
"10502",2020,14,321,261,265,"51.49785559","-0.081608045","Bermondsey Street, Bermondsey",526
"10503",2020,14,322,91,78,"51.526293","-0.073955","Palissy Street, Shoreditch",169
"10504",2020,14,323,23,20,"51.523196","-0.083067","Clifton Street, Shoreditch",43
"10505",2020,14,324,122,118,"51.49652013","-0.101384068","Ontario Street, Elephant & Castle",240
"10506",2020,14,325,54,44,"51.50908747","-0.129697889","St. Martin's Street, West End",98
"10507",2020,14,326,222,231,"51.53266186","-0.099981142","Graham Street, Angel",453
"10508",2020,14,327,60,42,"51.53095","-0.085603","New North Road 1, Hoxton",102
"10509",2020,14,328,53,43,"51.53114","-0.086016","New North Road 2, Hoxton",96
"10510",2020,14,329,305,274,"51.53589283","-0.160854428","Prince Albert Road, The Regent's Park",579
"10511",2020,14,330,71,67,"51.51641749","-0.179135079","Eastbourne Mews, Paddington",138
"10512",2020,14,331,100,116,"51.52085887","-0.089887855","Bunhill Row, Moorgate",216
"10513",2020,14,332,74,71,"51.49334336","-0.194757949","Nevern Place, Earl's Court",145
"10514",2020,14,333,163,131,"51.50860544","-0.193764092","Palace Gardens Terrace, Notting Hill",294
"10515",2020,14,334,34,35,"51.505044","-0.115851","Concert Hall Approach 1, South Bank",69
"10516",2020,14,335,48,56,"51.51196803","-0.120718759","Tavistock Street, Covent Garden",104
"10517",2020,14,336,21,31,"51.504942","-0.115533","Concert Hall Approach 2, South Bank",52
"10518",2020,14,337,75,80,"51.51108452","-0.197524944","Pembridge Villas, Notting Hill",155
"10519",2020,14,338,121,116,"51.51175646","-0.119643424","Wellington Street , Strand",237
"10520",2020,14,339,56,53,"51.5333196","-0.1117812","Risinghill Street, Angel",109
"10521",2020,14,340,99,91,"51.51444134","-0.087587447","Bank of England Museum, Bank",190
"10522",2020,14,341,178,184,"51.50810309","-0.12602103","Craven Street, Strand",362
"10523",2020,14,343,152,169,"51.53692216","-0.150181444","London Zoo Car Park, The Regent's Park",321
"10524",2020,14,344,79,66,"51.528246","-0.10102611","Goswell Road (City Uni), Finsbury",145
"10525",2020,14,345,199,209,"51.48802358","-0.166878535","Flood Street, Chelsea",408
"10526",2020,14,347,91,90,"51.50013942","-0.113936001","Lower Marsh, Waterloo",181
"10527",2020,14,348,90,97,"51.51217033","-0.150481272","Grosvenor Square, Mayfair",187
"10528",2020,14,349,57,56,"51.51196","-0.142783033","St. George Street, Mayfair",113
"10529",2020,14,350,378,387,"51.5017154373867","-0.1798541843891","Queen's Gate, Kensington Gardens",765
"10530",2020,14,351,116,130,"51.529423","-0.097122","Macclesfield Rd, St Lukes",246
"10531",2020,14,352,79,94,"51.486965","-0.116625","Vauxhall Street, Vauxhall",173
"10532",2020,14,353,59,57,"51.49459148","-0.134234258","Greycoat Street , Westminster",116
"10533",2020,14,354,137,103,"51.506767","-0.123702","Northumberland Avenue, Strand",240
"10534",2020,14,356,182,185,"51.494412","-0.173881","South Kensington Station, South Kensington",367
"10535",2020,14,357,89,75,"51.520994","-0.139016","Howland Street, Fitzrovia",164
"10536",2020,14,358,51,45,"51.516226","-0.124826","High Holborn , Covent Garden",96
"10537",2020,14,359,42,42,"51.49782999","-0.135440826","Butler Place, Westminster",84
"10538",2020,14,360,77,84,"51.49675303","-0.138733562","Howick Place, Westminster",161
"10539",2020,14,361,39,33,"51.50391973","-0.11342629","Waterloo Station 2, Waterloo",72
"10540",2020,14,362,84,87,"51.536264","-0.133952","Royal College Street, Camden Town",171
"10541",2020,14,363,32,24,"51.5291212008901","-0.171185284853","Lord's, St. John's Wood",56
"10542",2020,14,364,58,45,"51.519656","-0.132339","Alfred Place, Bloomsbury",103
"10543",2020,14,365,52,56,"51.530344","-0.100168","City Road, Angel",108
"10544",2020,14,366,30,39,"51.5109192966489","-0.1511263847351","Millennium Hotel, Mayfair",69
"10545",2020,14,367,140,155,"51.5173721","-0.1642075","Harrowby Street, Marylebone",295
"10546",2020,14,368,119,112,"51.50024195","-0.15934065","Harriet Street, Knightsbridge",231
"10547",2020,14,371,30,24,"51.49775","-0.10988","King Edward Walk, Waterloo",54
"10548",2020,14,372,22,20,"51.515208","-0.117863","Sardinia Street, Holborn",42
"10549",2020,14,373,35,22,"51.49980661","-0.176415994","Prince Consort Road, Knightsbridge",57
"10550",2020,14,374,57,72,"51.50402794","-0.11386436","Waterloo Station 1, Waterloo",129
"10551",2020,14,375,70,72,"51.50194596","-0.194392952","Kensington Town Hall, Kensington",142
"10552",2020,14,376,163,156,"51.49188409","-0.125674815","Millbank Tower, Pimlico",319
"10553",2020,14,377,43,36,"51.50535447","-0.113656543","Waterloo Bridge, South Bank",79
"10554",2020,14,378,33,41,"51.49559291","-0.179077626","Natural History Museum, South Kensington",74
"10555",2020,14,379,145,148,"51.51431171","-0.200838199","Turquoise Island, Notting Hill",293
"10556",2020,14,380,39,34,"51.50686435","-0.150666888","Stanhope Gate, Mayfair",73
"10557",2020,14,381,103,105,"51.51953043","-0.13577731","Charlotte Street, Fitzrovia",208
"10558",2020,14,382,50,48,"51.50935171","-0.14744969","Farm Street, Mayfair",98
"10559",2020,14,383,79,80,"51.51310333","-0.13121385","Frith Street, Soho",159
"10560",2020,14,384,105,108,"51.496481","-0.192404","Marloes Road, Kensington",213
"10561",2020,14,386,138,127,"51.51352755","-0.130110822","Moor Street, Soho",265
"10562",2020,14,387,212,184,"51.49369988","-0.121394101","Fire Brigade Pier, Vauxhall",396
"10563",2020,14,388,68,68,"51.51070161","-0.121723604","Southampton Street, Strand",136
"10564",2020,14,389,20,13,"51.51013066","-0.155757901","Upper Grosvenor Street, Mayfair",33
"10565",2020,14,390,58,44,"51.521776","-0.068856","Buxton Street 1, Shoreditch",102
"10566",2020,14,392,85,76,"51.49942855","-0.179702476","Imperial College, Knightsbridge",161
"10567",2020,14,393,51,54,"51.51733427","-0.103604248","Snow Hill, Farringdon",105
"10568",2020,14,394,70,55,"51.524826","-0.176268","Aberdeen Place, St. John's Wood",125
"10569",2020,14,395,156,159,"51.492462","-0.159919","Cadogan Gardens, Chelsea",315
"10570",2020,14,396,91,100,"51.51809","-0.163609","Shouldham Street, Marylebone",191
"10571",2020,14,397,214,210,"51.51348","-0.17977","Devonshire Terrace, Bayswater",424
"10572",2020,14,398,166,134,"51.502319","-0.200742","Holland Park, Kensington",300
"10573",2020,14,399,99,125,"51.52261762","-0.071653961","Brick Lane Market, Shoreditch",224
"10574",2020,14,400,85,92,"51.517703","-0.154106","George Street, Marylebone",177
"10575",2020,14,401,122,137,"51.528187","-0.075375","Columbia Road, Shoreditch",259
"10576",2020,14,402,67,64,"51.52289229","-0.171681991","Penfold Street, Marylebone",131
"10577",2020,14,403,108,104,"51.51689296","-0.158249929","George Place Mews, Marylebone",212
"10578",2020,14,404,465,466,"51.50204238","-0.184400221","Palace Gate, Kensington Gardens",931
"10579",2020,14,405,220,237,"51.49418566","-0.18267094","Gloucester Road Station, South Kensington",457
"10580",2020,14,409,166,149,"51.493146","-0.099828","Strata, Elephant & Castle",315
"10581",2020,14,410,125,135,"51.519968","-0.169774","Edgware Road Station, Marylebone",260
"10582",2020,14,411,171,186,"51.49337264","-0.09968067","Walworth Road, Elephant & Castle",357
"10583",2020,14,412,70,79,"51.488105","-0.110121","Cleaver Street, Kennington",149
"10584",2020,14,419,352,330,"51.485821","-0.149004","Chelsea Bridge, Pimlico",682
"10585",2020,14,420,50,58,"51.504043","-0.105312","Southwark Station 1, Southwark",108
"10586",2020,14,421,62,63,"51.504044","-0.104778","Southwark Station 2, Southwark",125
"10587",2020,14,423,100,91,"51.49456127","-0.15393398","Eaton Square (South), Belgravia",191
"10588",2020,14,424,121,89,"51.490491","-0.149186","Ebury Bridge, Pimlico",210
"10589",2020,14,425,77,63,"51.533379","-0.139159","Harrington Square 2, Camden Town",140
"10590",2020,14,426,129,127,"51.493072","-0.129925","Vincent Street, Pimlico",256
"10591",2020,14,427,210,206,"51.51397065","-0.09294031","Cheapside, Bank",416
"10592",2020,14,428,100,100,"51.499917","-0.174554","Exhibition Road, Knightsbridge",200
"10593",2020,14,430,111,103,"51.48902","-0.17524","South Parade, Chelsea",214
"10594",2020,14,431,80,72,"51.534474","-0.122203","Crinan Street, King's Cross",152
"10595",2020,14,432,75,72,"51.496957","-0.173894","Exhibition Road Museums, South Kensington",147
"10596",2020,14,433,52,43,"51.524564","-0.116279","Wren Street, Holborn",95
"10597",2020,14,435,113,108,"51.488852","-0.105593","Kennington Station, Kennington",221
"10598",2020,14,436,95,97,"51.51824","-0.11655","Red Lion Street, Holborn",192
"10599",2020,14,437,113,114,"51.488124","-0.120903","Vauxhall Walk, Vauxhall",227
"10600",2020,14,439,32,25,"51.5338","-0.118677","Killick Street, King's Cross",57
"10601",2020,14,440,107,108,"51.483145","-0.113134","Kennington Oval, Oval",215
"10602",2020,14,441,98,94,"51.495656","-0.114605","Sail Street, Vauxhall",192
"10603",2020,14,442,81,79,"51.510101","-0.211358","Walmer Road, Avondale",160
"10604",2020,14,443,157,152,"51.515256","-0.058641","Philpot Street, Whitechapel",309
"10605",2020,14,444,97,102,"51.52568","-0.055312","Bethnal Green Garden, Bethnal Green",199
"10606",2020,14,445,60,65,"51.52388","-0.065076","Cheshire Street, Bethnal Green",125
"10607",2020,14,446,89,98,"51.528936","-0.055894","York Hall, Bethnal Green",187
"10608",2020,14,447,88,83,"51.493381","-0.007542","Jubilee Crescent, Cubitt Town",171
"10609",2020,14,448,128,121,"51.50623","-0.02296","Fisherman's Walk West, Canary Wharf",249
"10610",2020,14,449,169,153,"51.511088","-0.057159","Shadwell Station, Shadwell",322
"10611",2020,14,450,99,94,"51.515975","-0.053177","Jubilee Street, Stepney",193
"10612",2020,14,451,119,118,"51.504719","-0.063531","Hermitage Court, Wapping",237
"10613",2020,14,452,136,153,"51.505697","-0.070542","St. Katharine's Way, Tower",289
"10614",2020,14,453,132,122,"51.508447","-0.055167","Garnet Street, Shadwell",254
"10615",2020,14,454,172,180,"51.487679","-0.021582","Napier Avenue, Millwall",352
"10616",2020,14,455,118,123,"51.49447","-0.014409","East Ferry Road, Cubitt Town",241
"10617",2020,14,456,103,126,"51.538071","-0.144664","Parkway, Camden Town",229
"10618",2020,14,457,29,25,"51.542138","-0.145393","Castlehaven Road, Camden Town",54
"10619",2020,14,458,165,168,"51.504749","-0.057544","Wapping Lane, Wapping",333
"10620",2020,14,459,122,135,"51.535179","-0.03338","Gunmakers Lane, Old Ford",257
"10621",2020,14,460,156,159,"51.516196","-0.029138","Burdett Road, Mile End",315
"10622",2020,14,461,58,54,"51.516","-0.038775","Aston Street, Stepney",112
"10623",2020,14,462,191,211,"51.541603","-0.138853","Bonny Street, Camden Town",402
"10624",2020,14,463,62,59,"51.534776","-0.071881","Thurtle Road, Haggerston",121
"10625",2020,14,464,43,32,"51.51417","-0.052099","St. Mary & St. Michael Church, Stepney",75
"10626",2020,14,465,119,108,"51.53558","-0.08249","Pitfield Street North,Hoxton",227
"10627",2020,14,466,62,68,"51.534464","-0.076341","Whiston Road, Haggerston",130
"10628",2020,14,467,95,93,"51.523538","-0.030556","Southern Grove, Bow",188
"10629",2020,14,468,37,41,"51.521564","-0.022694","Cantrell Road, Bow",78
"10630",2020,14,469,78,79,"51.513757","-0.020467","Lindfield Street, Poplar",157
"10631",2020,14,470,115,106,"51.530535","-0.025492","Mostyn Grove, Bow",221
"10632",2020,14,471,111,112,"51.533283","-0.028155","Hewison Street, Old Ford",223
"10633",2020,14,472,27,20,"51.529452","-0.027616","Malmesbury Road, Bow",47
"10634",2020,14,473,59,71,"51.496137","-0.019355","Millharbour, Millwall",130
"10635",2020,14,475,146,160,"51.499041","-0.020157","Lightermans Road, Millwall",306
"10636",2020,14,476,50,93,"51.489096","-0.009205","Stebondale Street, Cubitt Town",143
"10637",2020,14,477,125,114,"51.49109","-0.018716","Spindrift Avenue, Millwall",239
"10638",2020,14,478,174,175,"51.521889","-0.04667","Stepney Green Station, Stepney",349
"10639",2020,14,479,162,160,"51.527152","-0.058005","Pott Street, Bethnal Green",322
"10640",2020,14,480,323,330,"51.5128711","-0.0389866","Flamborough Street, Limehouse",653
"10641",2020,14,481,439,449,"51.487129","-0.009001","Saunders Ness Road, Cubitt Town",888
"10642",2020,14,483,158,144,"51.51328","-0.047784","Albert Gardens, Stepney",302
"10643",2020,14,484,91,85,"51.528828","-0.013258","Bromley High Street, Bow",176
"10644",2020,14,485,121,123,"51.531127","-0.048017","Old Ford Road, Bethnal Green",244
"10645",2020,14,486,146,144,"51.525645","-0.069543","Granby Street, Shoreditch",290
"10646",2020,14,487,111,104,"51.511811","-0.025626","Canton Street, Poplar",215
"10647",2020,14,488,121,117,"51.506946","-0.058681","Reardon Street, Wapping",238
"10648",2020,14,489,150,136,"51.513074","-0.064094","Christian Street, Whitechapel",286
"10649",2020,14,490,58,59,"51.508622","-0.065006","Pennington Street, Wapping",117
"10650",2020,14,491,77,52,"51.522507","-0.041378","Queen Mary's, Mile End",129
"10651",2020,14,492,153,153,"51.525501","-0.032267204","Maplin Street, Mile End",306
"10652",2020,14,494,14,17,"51.50196","-0.016251","South Quay East, Canary Wharf",31
"10653",2020,14,495,266,254,"51.528169","-0.018703","Bow Church Station, Bow",520
"10654",2020,14,496,124,121,"51.52512","-0.015578","Devons Road, Bow",245
"10655",2020,14,497,83,85,"51.526149","-0.027396845","Merchant Street, Bow",168
"10656",2020,14,498,141,118,"51.527058","-0.025296","Bow Road Station, Bow",259
"10657",2020,14,499,146,146,"51.519265","-0.021345","Furze Green, Bow",292
"10658",2020,14,500,185,223,"51.519806","-0.055731","Ansell House, Stepney",408
"10659",2020,14,501,96,86,"51.522561","-0.054883","Cephas Street, Bethnal Green",182
"10660",2020,14,502,153,139,"51.53341","-0.049591815","Bonner Gate, Victoria Park",292
"10661",2020,14,503,195,211,"51.520893","-0.051394","Cleveland Way, Stepney",406
"10662",2020,14,504,102,98,"51.496454","-0.009506","St. John's Park, Cubitt Town",200
"10663",2020,14,505,77,74,"51.520398","-0.026768","Ackroyd Drive, Bow",151
"10664",2020,14,506,130,124,"51.517475","-0.075855","Bell Lane, Liverpool Street",254
"10665",2020,14,507,62,55,"51.528692","-0.059091","Clarkson Street, Bethnal Green",117
"10666",2020,14,508,114,111,"51.519362","-0.074431","Fournier Street, Whitechapel",225
"10667",2020,14,509,43,38,"51.517842","-0.090075","Fore Street, Guildhall",81
"10668",2020,14,510,267,255,"51.509303","-0.025996","Westferry DLR, Limehouse",522
"10669",2020,14,511,157,166,"51.511066","-0.053558","Sutton Street, Shadwell",323
"10670",2020,14,512,126,115,"51.532091","-0.06142","Pritchard's Road, Bethnal Green",241
"10671",2020,14,513,108,123,"51.5142228","-0.055656","Watney Market, Stepney",231
"10672",2020,14,514,101,85,"51.516204","-0.155525","Portman Square, Marylebone",186
"10673",2020,14,515,65,71,"51.500088","-0.211316","Russell Gardens, Olympia",136
"10674",2020,14,516,90,100,"51.5112","-0.014438","Chrisp Street Market, Poplar",190
"10675",2020,14,517,104,108,"51.532513","-0.033085","Ford Road, Old Ford",212
"10676",2020,14,518,132,125,"51.528224","-0.037471","Antill Road, Mile End",257
"10677",2020,14,519,40,43,"51.518811","-0.011662","Teviot Street, Poplar",83
"10678",2020,14,520,88,83,"51.526041","-0.047218","Bancroft Road, Bethnal Green",171
"10679",2020,14,521,131,138,"51.534137","-0.037366","Driffield Road, Old Ford",269
"10680",2020,14,522,142,162,"51.525941","-0.036017","Clinton Road, Mile End",304
"10681",2020,14,523,72,65,"51.51549","-0.013475","Langdon Park, Poplar",137
"10682",2020,14,524,143,117,"51.511654","-0.179668","Lancaster Gate , Bayswater",260
"10683",2020,14,526,89,85,"51.503143","-0.008428","Lancaster Drive, Blackwall",174
"10684",2020,14,527,86,104,"51.503802","-0.215808","Hansard Mews, Holland Park",190
"10685",2020,14,528,21,14,"51.507326","-0.145827","Clarges Street, Mayfair",35
"10686",2020,14,529,79,74,"51.486892","-0.170983","Manresa Road, Chelsea",153
"10687",2020,14,530,101,101,"51.508896","-0.012413","Newby Place, Poplar",202
"10688",2020,14,531,181,167,"51.530326","-0.042744","Twig Folly Bridge, Mile End",348
"10689",2020,14,532,77,105,"51.50357","-0.020068","Jubilee Plaza, Canary Wharf",182
"10690",2020,14,533,85,78,"51.528222","-0.069743","Wellington Row, Bethnal Green",163
"10691",2020,14,534,152,154,"51.531864","-0.066035","Goldsmith's Row, Haggerston",306
"10692",2020,14,535,111,110,"51.537349","-0.147154","Gloucester Avenue, Camden Town",221
"10693",2020,14,536,56,59,"51.53385","-0.06992","Queensbridge Road, Haggerston",115
"10694",2020,14,537,165,172,"51.51793","-0.067937","Old Montague Street, Whitechapel",337
"10695",2020,14,538,127,126,"51.508981","-0.00699","Naval Row, Blackwall",253
"10696",2020,14,540,148,140,"51.528302","-0.144466","Albany Street, The Regent's Park",288
"10697",2020,14,541,188,192,"51.506613","-0.142844","Green Park Station, Mayfair",380
"10698",2020,14,542,174,151,"51.514115","-0.033828","Salmon Lane, Limehouse",325
"10699",2020,14,543,38,33,"51.509591","-0.204666","Lansdowne Walk, Ladbroke Grove",71
"10700",2020,14,544,49,72,"51.526153","-0.102208","Percival Street, Finsbury",121
"10701",2020,14,545,79,91,"51.539957","-0.145246","Arlington Road, Camden Town",170
"10702",2020,14,546,100,101,"51.517428","-0.107987","New Fetter Lane, Holborn",201
"10703",2020,14,547,206,193,"51.509474","-0.002275","East India DLR, Blackwall",399
"10704",2020,14,548,48,40,"51.498386","-0.107913","Westminster Bridge Road, Elephant & Castle",88
"10705",2020,14,549,117,119,"51.49605","-0.104193","Gaywood  Street, Elephant & Castle",236
"10706",2020,14,550,49,39,"51.521564","-0.039264","Harford Street, Mile End",88
"10707",2020,14,551,49,46,"51.505772","-0.016460175","Import Dock, Canary Wharf",95
"10708",2020,14,552,114,106,"51.511542","-0.056667","Watney Street, Shadwell",220
"10709",2020,14,553,443,452,"51.535678","-0.062546","Regent's Row , Haggerston",895
"10710",2020,14,554,46,50,"51.513548","-0.005659","Aberfeldy Street, Poplar",96
"10711",2020,14,556,59,58,"51.502661","-0.021596","Heron Quays DLR, Canary Wharf",117
"10712",2020,14,557,88,81,"51.51601","-0.0985","King Edward Street, St Pauls",169
"10713",2020,14,558,134,123,"51.493978","-0.127554","Page Street, Westminster",257
"10714",2020,14,559,85,92,"51.501391","-0.205991","Abbotsbury Road, Holland Park",177
"10715",2020,14,560,52,36,"51.511624","-0.205921","Ladbroke Grove Central, Ladbroke Grove",88
"10716",2020,14,561,88,76,"51.518369","-0.043371","Rectory Square, Stepney",164
"10717",2020,14,562,50,33,"51.51746","-0.12335","Bury Place, Holborn",83
"10718",2020,14,563,93,87,"51.499286","-0.009152","Preston's Road, Cubitt Town",180
"10719",2020,14,564,380,380,"51.509943","-0.117619","Somerset House, Strand",760
"10720",2020,14,565,51,55,"51.521905","-0.063386","Selby Street, Whitechapel",106
"10721",2020,14,566,98,115,"51.509158","-0.224103","Westfield Ariel Way, White City",213
"10722",2020,14,568,222,216,"51.51616","-0.18697","Bishop's Bridge Road West, Bayswater",438
"10723",2020,14,569,103,82,"51.53213","-0.08299","Pitfield Street Central, Hoxton",185
"10724",2020,14,570,160,173,"51.503083","-0.017676","Upper Bank Street, Canary Wharf",333
"10725",2020,14,571,39,59,"51.506256","-0.218337","Westfield Southern Terrace ,Shepherd's Bush",98
"10726",2020,14,572,150,163,"51.539099","-0.141728","Greenland Road, Camden Town",313
"10727",2020,14,573,259,267,"51.485587","-0.18119","Limerston Street, West Chelsea",526
"10728",2020,14,574,4,1,"51.53356","-0.09315","Eagle Wharf Road, Hoxton",5
"10729",2020,14,576,128,134,"51.497304","-0.022793","Alpha Grove, Millwall",262
"10730",2020,14,577,155,158,"51.528869","-0.047548","Globe Town Market, Bethnal Green",313
"10731",2020,14,578,22,40,"51.527607","-0.057133","Hollybush Gardens, Bethnal Green",62
"10732",2020,14,579,256,240,"51.511246","-0.093051","Queen Street 2, Bank",496
"10733",2020,14,580,202,205,"51.48692917","-0.102996299","Doddington Grove, Kennington",407
"10734",2020,14,581,136,141,"51.519167","-0.147983","New Cavendish Street, Marylebone",277
"10735",2020,14,583,191,201,"51.497622","-0.125978","Abingdon Green, Westminster",392
"10736",2020,14,584,2,NA,"51.51244","-0.19096","Ilchester Gardens, Bayswater",NA
"10737",2020,14,586,85,59,"51.490645","-0.014582","Mudchute DLR, Cubitt Town",144
"10738",2020,14,587,194,194,"51.50964","-0.08497","Monument Street, Monument",388
"10739",2020,14,588,62,63,"51.52959","-0.0801","Hoxton Street, Hoxton",125
"10740",2020,14,589,208,227,"51.487196","-0.179369","Drayton Gardens, West Chelsea",435
"10741",2020,14,590,58,41,"51.53256","-0.16862","Greenberry Street, St.John's Wood",99
"10742",2020,14,592,50,44,"51.5171","-0.18377","Bishop's Bridge Road East, Bayswater",94
"10743",2020,14,593,26,28,"51.531066","-0.11934","Northdown Street, King's Cross",54
"10744",2020,14,594,16,27,"51.513875","-0.117774","Kingsway Southbound, Strand",43
"10745",2020,14,595,104,94,"51.493267","-0.21985","Hammersmith Road, Hammersmith",198
"10746",2020,14,596,168,166,"51.472817","-0.199783","Parson's Green , Parson's Green",334
"10747",2020,14,597,125,116,"51.473471","-0.20782","Fulham Park Road, Fulham",241
"10748",2020,14,598,149,147,"51.494499","-0.228188","Southerton Road, Hammersmith",296
"10749",2020,14,599,73,69,"51.485743","-0.223616","Manbre Road, Hammersmith",142
"10750",2020,14,600,261,257,"51.481747","-0.124642","South Lambeth Road, Vauxhall",518
"10751",2020,14,601,129,139,"51.514767","-0.225787","BBC White City, White City",268
"10752",2020,14,602,164,154,"51.472993","-0.133972","Union Grove, Wandsworth Road",318
"10753",2020,14,603,140,156,"51.477839","-0.116493","Caldwell Street, Stockwell",296
"10754",2020,14,604,59,54,"51.538792","-0.138535","St Martins Close, Camden Town",113
"10755",2020,14,605,99,88,"51.520331","-0.163667","Seymour Place, Marylebone",187
"10756",2020,14,606,67,71,"51.504199","-0.210941","Addison Road, Holland Park",138
"10757",2020,14,607,152,141,"51.468814","-0.210279","Putney Bridge Station, Fulham",293
"10758",2020,14,608,22,22,"51.491093","-0.216493","Colet Gardens, Hammersmith",44
"10759",2020,14,609,137,137,"51.46512358","-0.157788279","Sugden Road, Clapham",274
"10760",2020,14,610,229,225,"51.48256792","-0.172078187","Danvers Street, West Chelsea",454
"10761",2020,14,611,146,153,"51.50646524","-0.208486599","Princedale Road , Holland Park",299
"10762",2020,14,612,143,147,"51.46925984","-0.141812513","Wandsworth Rd, Isley Court, Wandsworth Road",290
"10763",2020,14,613,174,188,"51.50403821","-0.217400093","Woodstock Grove, Shepherd's Bush",362
"10764",2020,14,614,76,88,"51.47817208","-0.144690541","Bradmead, Battersea Park",164
"10765",2020,14,615,153,138,"51.4768851","-0.215895601","Finlay Street, Fulham",291
"10766",2020,14,616,101,109,"51.48102131","-0.209973497","Aintree Street, Fulham",210
"10767",2020,14,617,60,63,"51.47107905","-0.207842908","Elysium Place, Fulham",123
"10768",2020,14,618,136,153,"51.47625965","-0.193254007","Eel Brook Common, Walham Green",289
"10769",2020,14,619,116,131,"51.4737636","-0.197010096","Irene Road, Parsons Green",247
"10770",2020,14,620,116,122,"51.47518024","-0.167160736","Surrey Lane, Battersea",238
"10771",2020,14,621,105,125,"51.46086446","-0.187427294","Wandsworth Town Station, Wandsworth",230
"10772",2020,14,622,79,108,"51.50748124","-0.205535908","Lansdowne Road, Ladbroke Grove",187
"10773",2020,14,623,41,47,"51.46193072","-0.180791784","Nantes Close, Wandsworth",88
"10774",2020,14,624,124,131,"51.4729184","-0.132102704","Courland Grove, Wandsworth Road",255
"10775",2020,14,625,490,492,"51.47761941","-0.149551631","Queen's Circus, Battersea Park",982
"10776",2020,14,626,134,128,"51.48438657","-0.20481514","Normand Park, West Kensington",262
"10777",2020,14,627,51,40,"51.4687905","-0.158230901","Holden Street, Battersea",91
"10778",2020,14,628,173,181,"51.46881971","-0.184318843","William Morris Way, Sands End",354
"10779",2020,14,629,41,51,"51.45995384","-0.190184054","Morie Street, Wandsworth",92
"10780",2020,14,630,108,104,"51.47073264","-0.126994068","Clarence Walk, Stockwell",212
"10781",2020,14,631,126,127,"51.4795017","-0.141770709","Battersea Park Road, Nine Elms",253
"10782",2020,14,632,53,57,"51.47053858","-0.163041605","Sheepcote Lane, Battersea",110
"10783",2020,14,633,129,144,"51.48959104","-0.209378594","Vereker Road, West Kensington",273
"10784",2020,14,634,82,80,"51.49434708","-0.215804559","Brook Green South, Brook Green",162
"10785",2020,14,635,128,124,"51.48606206","-0.214428378","Greyhound Road, Hammersmith",252
"10786",2020,14,636,72,64,"51.46706414","-0.193502076","South Park, Sands End",136
"10787",2020,14,637,81,84,"51.45787019","-0.174691623","Spencer Park, Wandsworth Common",165
"10788",2020,14,638,162,169,"51.46663393","-0.169821175","Falcon Road, Clapham Junction",331
"10789",2020,14,639,131,120,"51.48357068","-0.202038682","Coomer Place, West Kensington",251
"10790",2020,14,640,147,148,"51.47286577","-0.148059277","Silverthorne Road, Battersea",295
"10791",2020,14,641,111,130,"51.49824168","-0.117495865","Archbishop's Park, Waterloo",241
"10792",2020,14,642,60,53,"51.46916161","-0.174485792","Fawcett Close, Battersea",113
"10793",2020,14,643,113,118,"51.5190427","-0.204764421","All Saints' Road, Portobello",231
"10794",2020,14,644,153,140,"51.48373225","-0.223852256","Rainville Road, Hammersmith",293
"10795",2020,14,645,67,65,"51.50173215","-0.100292412","Great Suffolk Street, The Borough",132
"10796",2020,14,646,120,125,"51.49886563","-0.137424571","Buckingham Gate, Westminster",245
"10797",2020,14,647,167,172,"51.50035306","-0.217515071","Richmond Way, Shepherd's Bush",339
"10798",2020,14,648,55,65,"51.46904022","-0.19627483","Peterborough Road, Sands End",120
"10799",2020,14,649,144,151,"51.48180515","-0.18027465","World's End Place, West Chelsea",295
"10800",2020,14,650,133,136,"51.51687069","-0.213872396","St. Mark's Road, North Kensington",269
"10801",2020,14,651,100,97,"51.48089844","-0.183853573","Thorndike Close, West Chelsea",197
"10802",2020,14,652,55,51,"51.51148696","-0.218190203","Evesham Street, Avondale",106
"10803",2020,14,653,169,165,"51.47084722","-0.17070367","Simpson Street, Clapham Junction",334
"10804",2020,14,654,110,124,"51.48267821","-0.117661574","Ashmole Estate, Oval",234
"10805",2020,14,655,87,90,"51.48294452","-0.219346128","Crabtree Lane, Fulham",177
"10806",2020,14,656,66,56,"51.46841875","-0.199135704","Broomhouse Lane, Parsons Green",122
"10807",2020,14,657,119,126,"51.4996806","-0.221791552","Blythe Road West, Shepherd's Bush",245
"10808",2020,14,658,355,358,"51.47729232","-0.16478637","Ethelburga Estate, Battersea Park",713
"10809",2020,14,659,119,109,"51.511934","-0.10307894","Blackfriars Station, St. Paul's",228
"10810",2020,14,660,65,62,"51.49087074","-0.206029743","West Kensington Station, West Kensington",127
"10811",2020,14,661,160,177,"51.51632095","-0.202608612","All Saints Church, Portobello",337
"10812",2020,14,662,178,165,"51.48498496","-0.167919869","Phene Street, Chelsea",343
"10813",2020,14,663,57,44,"51.51323001","-0.211593602","Clarendon Road, Avondale",101
"10814",2020,14,664,166,164,"51.474376","-0.155442787","Austin Road, Battersea Park",330
"10815",2020,14,665,99,96,"51.46108367","-0.191722864","Smugglers Way, Wandsworth",195
"10816",2020,14,666,128,128,"51.49610093","-0.208158259","Olympia Way, Olympia",256
"10817",2020,14,667,116,132,"51.5015946","-0.222293381","Shepherd's Bush Road North, Shepherd's Bush",248
"10818",2020,14,668,248,268,"51.49422354","-0.236769936","Ravenscourt Park Station, Hammersmith",516
"10819",2020,14,669,93,92,"51.47614939","-0.1232585","Teversham Lane, Stockwell",185
"10820",2020,14,670,126,129,"51.46718562","-0.152248582","Ashley Crescent, Battersea",255
"10821",2020,14,671,108,133,"51.475089","-0.201968","Parsons Green Station, Parsons Green",241
"10822",2020,14,673,168,169,"51.46517078","-0.18038939","Hibbert Street, Battersea",337
"10823",2020,14,674,97,81,"51.53546778","-0.11619105","Carnegie Street, King's Cross",178
"10824",2020,14,675,98,90,"51.46348914","-0.182126248","Usk Road, Clapham Junction",188
"10825",2020,14,676,157,155,"51.47787084","-0.126874471","Hartington Road, Stockwell",312
"10826",2020,14,677,80,78,"51.46866929","-0.146544642","Heath Road, Battersea",158
"10827",2020,14,678,41,50,"51.46231278","-0.211468596","Esmond Street, Putney",91
"10828",2020,14,679,56,61,"51.47453545","-0.170210533","Orbel Street, Battersea",117
"10829",2020,14,680,182,196,"51.47768469","-0.170329317","Westbridge Road, Battersea",378
"10830",2020,14,681,192,204,"51.47303687","-0.214749808","Bishop's Avenue, Fulham",396
"10831",2020,14,682,341,338,"51.48810829","-0.22660621","Crisp Road, Hammersmith",679
"10832",2020,14,683,105,115,"51.46506424","-0.163750945","Dorothy Road, Clapham Junction",220
"10833",2020,14,684,171,184,"51.45475251","-0.195197203","Neville Gill Close, Wandsworth",355
"10834",2020,14,685,129,136,"51.46067005","-0.198735357","Osiers Road, Wandsworth",265
"10835",2020,14,686,85,89,"51.48814438","-0.222456468","Beryl Road, Hammersmith",174
"10836",2020,14,687,128,104,"51.49760804","-0.21145598","Maclise Road, Olympia",232
"10837",2020,14,688,64,71,"51.46095151","-0.20066766","Northfields, Wandsworth",135
"10838",2020,14,689,44,40,"51.45922541","-0.180884959","Spanish Road, Clapham Junction",84
"10839",2020,14,690,49,50,"51.47047503","-0.152130083","Stanley Grove, Battersea",99
"10840",2020,14,691,148,173,"51.47946386","-0.195777222","Erin Close, Walham Green",321
"10841",2020,14,692,205,207,"51.54211855","-0.028941601","Cadogan Close, Victoria Park",412
"10842",2020,14,693,113,122,"51.464786","-0.215618902","Felsham Road, Putney",235
"10843",2020,14,694,128,144,"51.46071722","-0.216526155","Putney Rail Station, Putney",272
"10844",2020,14,695,334,335,"51.53638435","-0.102757578","Islington Green, Angel",669
"10845",2020,14,696,85,76,"51.48728535","-0.217995921","Charing Cross Hospital, Hammersmith",161
"10846",2020,14,697,109,82,"51.53639219","-0.112721065","Charlotte Terrace, Angel",191
"10847",2020,14,698,128,102,"51.53908372","-0.070329419","Shoreditch Court, Haggerston",230
"10848",2020,14,699,65,52,"51.5366541","-0.07023031","Belford House, Haggerston",117
"10849",2020,14,700,130,126,"51.47696496","-0.174347066","Battersea Church Road, Battersea",256
"10850",2020,14,701,209,216,"51.47287627","-0.176267008","Vicarage Crescent, Battersea",425
"10851",2020,14,702,99,96,"51.52868155","-0.065550321","Durant Street, Bethnal Green",195
"10852",2020,14,703,71,63,"51.51505991","-0.10534448","St. Bride Street, Holborn",134
"10853",2020,14,704,74,50,"51.45682071","-0.202802098","Mexfield Road, East Putney",124
"10854",2020,14,705,82,81,NA,NA,NA,163
"10855",2020,14,706,81,99,"51.50215353","-0.083632928","Snowsfields, London Bridge",180
"10856",2020,14,707,102,107,"51.49021762","-0.215087092","Barons Court Station, West Kensington",209
"10857",2020,14,708,80,98,"51.46161068","-0.21614583","Disraeli Road, Putney",178
"10858",2020,14,709,51,67,"51.46321128","-0.215550761","Montserrat Road , Putney",118
"10859",2020,14,710,343,359,"51.47439218","-0.163347594","Albert Bridge Road, Battersea Park",702
"10860",2020,14,711,108,98,"51.48335692","-0.216305546","Everington Street, Fulham",206
"10861",2020,14,712,178,187,"51.51854104","-0.034903714","Mile End Stadium, Mile End",365
"10862",2020,14,713,142,140,"51.54100708","-0.14326094","Hawley Crescent, Camden Town",282
"10863",2020,14,714,69,62,"51.47311696","-0.137235175","Stewart's Road, Wandsworth Road",131
"10864",2020,14,715,92,83,"51.51563007","-0.049067243","Aylward Street, Stepney",175
"10865",2020,14,716,96,99,"51.51542791","-0.02356501","Stainsby Road , Poplar",195
"10866",2020,14,717,219,208,"51.53658514","-0.075885686","Dunston Road , Haggerston",427
"10867",2020,14,718,102,118,"51.53571683","-0.060291813","Ada Street, Hackney Central",220
"10868",2020,14,719,268,288,"51.53642464","-0.054162264","Victoria Park Road, Hackney Central",556
"10869",2020,14,720,140,136,"51.48724429","-0.205279052","Star Road, West Kensington",276
"10870",2020,14,721,126,116,"51.53603947","-0.026262677","Wendon Street, Old Ford",242
"10871",2020,14,722,73,81,"51.52458353","-0.058631453","Finnis Street, Bethnal Green",154
"10872",2020,14,723,217,236,"51.46822047","-0.190346493","Stephendale Road, Sands End",453
"10873",2020,14,724,78,81,"51.45799126","-0.184806157","Alma Road, Wandsworth",159
"10874",2020,14,725,179,173,"51.491327","-0.096518684","Walworth Square, Walworth",352
"10875",2020,14,726,128,144,"51.47505096","-0.150908371","Alfreda Street, Battersea Park",272
"10876",2020,14,727,169,157,"51.47569809","-0.20587627","Chesilton Road, Fulham",326
"10877",2020,14,728,93,98,"51.46199911","-0.206240805","Putney Bridge Road, East Putney",191
"10878",2020,14,729,149,151,"51.47893931","-0.208485293","St. Peter's Terrace, Fulham",300
"10879",2020,14,730,171,173,"51.49208492","-0.229116862","Bridge Avenue, Hammersmith",344
"10880",2020,14,731,99,100,"51.47727637","-0.189210466","Michael Road, Walham Green",199
"10881",2020,14,732,185,195,"51.50630441","-0.087262995","Duke Street Hill, London Bridge",380
"10882",2020,14,733,33,33,"51.50542628","-0.150817316","Park Lane, Mayfair",66
"10883",2020,14,734,81,68,"51.46230566","-0.175407201","Plough Terrace, Clapham Junction",149
"10884",2020,14,735,45,51,"51.46489445","-0.17302926","Grant Road East, Clapham Junction",96
"10885",2020,14,736,65,56,"51.50659035","-0.216104479","Queensdale Road, Shepherd's Bush",121
"10886",2020,14,737,244,272,"51.47993289","-0.19411695","Fulham Broadway, Walham Green",516
"10887",2020,14,738,124,104,"51.47514228","-0.187278987","Imperial Road, Sands End",228
"10888",2020,14,739,117,133,"51.48176572","-0.185273723","Hortensia Road, West Brompton",250
"10889",2020,14,740,26,26,"51.51092871","-0.214594781","Sirdar Road, Avondale",52
"10890",2020,14,741,23,25,"51.5129814","-0.219486603","Freston Road, Avondale",48
"10891",2020,14,742,173,177,"51.51510818","-0.208565479","Blenheim Crescent, Ladbroke Grove",350
"10892",2020,14,743,49,50,"51.46079243","-0.212607684","Oxford Road, Putney",99
"10893",2020,14,744,65,60,"51.46745485","-0.172293499","Ingrave Street, Clapham Junction",125
"10894",2020,14,745,94,86,"51.47816972","-0.18243547","Upcerne Road, West Chelsea",180
"10895",2020,14,746,115,102,"51.4795738","-0.17903854","Lots Road, West Chelsea",217
"10896",2020,14,747,122,120,"51.48796408","-0.161765173","Ormonde Gate, Chelsea",242
"10897",2020,14,748,143,134,"51.53727795","-0.079201849","Hertford Road, De Beauvoir Town",277
"10898",2020,14,749,228,248,"51.53932857","-0.074284675","Haggerston Road, Haggerston",476
"10899",2020,14,750,51,55,"51.4710956","-0.157850096","Culvert Road, Battersea",106
"10900",2020,14,751,33,35,"51.51612862","-0.120909408","Newton Street, Covent Garden",68
"10901",2020,14,754,26,27,"51.5129006","-0.214762686","Grenfell Road, Avondale",53
"10902",2020,14,755,149,152,"51.48512191","-0.174971902","The Vale, Chelsea",301
"10903",2020,14,756,236,242,"51.47515398","-0.159169801","Prince of Wales Drive, Battersea Park",478
"10904",2020,14,757,179,192,"51.48795853","-0.187404506","Harcourt Terrace, West Brompton",371
"10905",2020,14,758,114,103,"51.51787005","-0.201005397","Westbourne Park Road, Portobello",217
"10906",2020,14,759,41,35,"51.52456169","-0.165668686","Broadley Terrace, Marylebone",76
"10907",2020,14,760,45,27,"51.52526975","-0.163795009","Rossmore Road, Marylebone",72
"10908",2020,14,761,64,73,"51.48321729","-0.211860644","Humbolt Road, Fulham",137
"10909",2020,14,762,433,431,"51.50070305","-0.129698963","Storey's Gate, Westminster",864
"10910",2020,14,763,139,141,"51.52059714","-0.032566533","Mile End Park Leisure Centre, Mile End",280
"10911",2020,14,764,113,117,"51.46239255","-0.16829214","St. John's Road, Clapham Junction",230
"10912",2020,14,765,86,71,"51.46760141","-0.20682737","Ranelagh Gardens, Fulham",157
"10913",2020,14,766,132,139,"51.45752945","-0.192165613","Ram Street, Wandsworth",271
"10914",2020,14,767,42,33,"51.45705988","-0.200806304","Santos Road, Wandsworth",75
"10915",2020,14,768,336,349,"51.46134382","-0.159322467","Clapham Common North Side, Clapham Common",685
"10916",2020,14,769,134,141,"51.473611","-0.191803","Sandilands Road, Walham Green",275
"10917",2020,14,770,106,111,"51.491026","-0.209121","Gwendwr Road, West Kensington",217
"10918",2020,14,771,58,65,"51.509224","-0.216016","Rifle Place, Avondale",123
"10919",2020,14,772,280,283,"51.47250956","-0.122831913","Binfield Road, Stockwell",563
"10920",2020,14,773,129,111,"51.511891","-0.107349","Tallis Street, Temple",240
"10921",2020,14,774,65,61,"51.470131","-0.20464","Hurlingham Park, Parsons Green",126
"10922",2020,14,775,123,117,"51.496664","-0.223868","Little Brook Green, Brook Green",240
"10923",2020,14,776,102,112,"51.460333","-0.167029","Abyssinia Close, Clapham Junction",214
"10924",2020,14,777,75,79,"51.4619230679","-0.165297856693","Limburg Road, Clapham Junction",154
"10925",2020,14,779,70,65,"51.514449","-0.077178979","Houndsditch, Aldgate",135
"10926",2020,14,780,262,269,"51.474665","-0.18316517","Imperial Wharf Station, Sands End",531
"10927",2020,14,781,82,68,"51.495898","-0.173009","Victoria & Albert Museum, South Kensington",150
"10928",2020,14,782,165,156,"51.483911","-0.19760944","Halford Road, West Kensington",321
"10929",2020,14,783,176,162,"51.5403115","-0.021630359","Monier Road, Hackney Wick",338
"10930",2020,14,784,267,264,"51.546326","-0.00993526","East Village, Queen Elizabeth Olympic Park",531
"10931",2020,14,785,456,444,"51.54094","-0.010510565","Aquatic Centre, Queen Elizabeth Olympic Park",900
"10932",2020,14,786,282,297,"51.549369","-0.015717614","Lee Valley VeloPark, Queen Elizabeth Olympic Park",579
"10933",2020,14,787,347,346,"51.546805","-0.01469126","Timber Lodge, Queen Elizabeth Olympic Park",693
"10934",2020,14,789,440,449,"51.538718","-0.011889482","Podium, Queen Elizabeth Olympic Park",889
"10935",2020,14,790,140,141,"51.541793","-0.00481","Stratford Station, Stratford",281
"10936",2020,14,792,70,67,"51.505461","-0.10454093","Blackfriars Road, Southwark",137
"10937",2020,14,793,69,70,"51.528279","-0.11955857","Cromer Street, Bloomsbury",139
"10938",2020,14,795,28,26,"51.527068","-0.13186102","Euston Square Gardens, Euston",54
"10939",2020,14,796,69,64,"51.524","-0.12640984","Coram Street, Bloomsbury",133
"10940",2020,14,797,36,30,"51.5293","-0.12827903","Ossulston Street, Somers Town",66
"10941",2020,14,798,55,46,"51.5301998755","-0.122299440803","Birkenhead Street, King's Cross",101
"10942",2020,14,799,49,47,"51.4976984561","-0.137598896295","Kings Gate House, Westminster",96
"10943",2020,14,801,111,113,"51.5052241745","-0.0980318118664","Lavington Street, Bankside",224
"10944",2020,14,802,196,187,"51.4765900593","-0.118256789081","Albert Square, Stockwell",383
"10945",2020,14,803,74,76,"51.5054099403","-0.0983410884509","Southwark Street, Bankside",150
"10946",2020,14,804,69,92,"51.5346677396","-0.125078652873","Good's Way, King's Cross",161
"10947",2020,14,806,104,105,"51.5372405623","-0.124807385707","Handyside Street, King's Cross",209
"10948",2020,14,807,252,246,"51.5212","-0.20888818","Bevington Road West, North Kensington",498
"10949",2020,14,809,51,42,"51.5162778834","-0.118272991635","Lincoln's Inn Fields, Holborn",93
"10950",2020,14,810,52,54,"51.5067252868","-0.0988072461627","Tate Modern, Bankside",106
"10951",2020,14,811,306,287,"51.5057030357","-0.0277727426235","Westferry Circus, Canary Wharf",593
"10952",2020,14,812,168,151,"51.5487311915","-0.0226065549321","Here East North, Queen Elizabeth Olympic Park",319
"10953",2020,14,813,44,53,"51.4878074485","-0.122759625866","New Spring Gardens Walk, Vauxhall",97
"10954",2020,14,814,162,155,"51.4714330677","-0.123670735702","Clapham Road, Lingham Street, Stockwell",317
"10955",2020,14,815,277,286,"51.5000891978","-0.116628700672","Lambeth Palace Road, Waterloo",563
"10956",2020,14,816,81,69,"51.5465327935","-0.0205975904647","Here East South, Queen Elizabeth Olympic Park",150
"10957",2020,14,817,192,201,"51.4813354746","-0.138212295869","Riverlight South, Nine Elms",393
"10958",2020,14,818,289,295,"51.501513","-0.12382322","Westminster Pier, Westminster",584
"10959",2020,14,819,63,60,"51.50621","-0.114842","Belvedere Road 2, South Bank",123
"10960",2020,14,820,80,68,"51.492807","-0.091938","Victory Place, Walworth",148
"10961",2020,14,821,391,390,"51.4835074867","-0.147714557371","Battersea Power Station, Battersea Park",781
"10962",2020,14,826,110,113,"51.496863","-0.1429434","Allington Street, Victoria",223
"10963",2020,14,827,158,155,"51.479601","-0.11147178","Cranmer Road, Stockwell",313
"10964",2020,14,828,124,136,"51.473874","-0.11258096","Normandy Road, Stockwell",260
"10965",2020,14,829,78,78,"51.469217","-0.11268674","Wynne Road, Stockwell",156
"10966",2020,14,830,61,88,"51.469202","-0.11902256","Sidney Road, Stockwell",149
"10967",2020,14,831,104,105,"51.466232","-0.11317995","St John's Crescent, Brixton",209
"10968",2020,14,832,243,255,"51.464019","-0.11578197","Ferndale Road, Brixton",498
"10969",2020,14,833,358,364,"51.460232","-0.11537509","Saltoun Road, Brixton",722
"10970",2020,14,834,258,266,"51.477966","-0.14785703","Gas Holders, Battersea Park",524
"10971",2020,14,835,50,45,"51.516785","-0.10494775","Farringdon Street, Holborn",95
"10972",2020,14,836,90,90,"51.541596","-0.12544145","York Way, Kings Cross",180
"10973",2020,14,838,54,53,"51.518093","-0.0914017","Fore Street Avenue, Guildhall",107
"10974",2020,14,839,139,127,"51.508033","-0.10682363","Sea Containers, South Bank",266
"10975",2020,15,1,109,103,"51.52916347","-0.109970527","River Street , Clerkenwell",212
"10976",2020,15,2,261,282,"51.49960695","-0.197574246","Phillimore Gardens, Kensington",543
"10977",2020,15,3,33,41,"51.52128377","-0.084605692","Christopher Street, Liverpool Street",74
"10978",2020,15,4,83,67,"51.53005939","-0.120973687","St. Chad's Street, King's Cross",150
"10979",2020,15,5,152,169,"51.49313","-0.156876","Sedding Street, Sloane Square",321
"10980",2020,15,6,126,118,"51.51811784","-0.144228881","Broadcasting House, Marylebone",244
"10981",2020,15,7,224,211,"51.53430039","-0.1680743","Charlbert Street, St. John's Wood",435
"10982",2020,15,8,366,377,"51.529857","-0.18348604","Maida Vale, Maida Vale",743
"10983",2020,15,9,201,190,"51.5073853","-0.096440751","New Globe Walk, Bankside",391
"10984",2020,15,10,130,130,"51.50597426","-0.092754157","Park Street, Bankside",260
"10985",2020,15,11,215,202,"51.52395143","-0.122502346","Brunswick Square, Bloomsbury",417
"10986",2020,15,12,98,82,"51.52168078","-0.130431727","Malet Street, Bloomsbury",180
"10987",2020,15,13,88,81,"51.51991453","-0.136039674","Scala Street, Fitzrovia",169
"10988",2020,15,14,215,201,"51.52994371","-0.123616824","Belgrove Street , King's Cross",416
"10989",2020,15,15,103,98,"51.51772703","-0.127854211","Great Russell Street, Bloomsbury",201
"10990",2020,15,16,129,125,"51.52635795","-0.125979294","Cartwright Gardens , Bloomsbury",254
"10991",2020,15,17,174,185,"51.5216612","-0.109006325","Hatton Wall, Holborn",359
"10992",2020,15,18,192,170,"51.51477076","-0.12221963","Drury Lane, Covent Garden",362
"10993",2020,15,19,32,24,"51.52505093","-0.131161087","Taviton Street, Bloomsbury",56
"10994",2020,15,20,25,23,"51.527326","-0.13605286","Drummond Street , Euston",48
"10995",2020,15,21,43,32,"51.53007835","-0.13884627","Hampstead Road (Cartmel), Euston",75
"10996",2020,15,22,175,180,"51.5222641","-0.114079481","Northington Street , Holborn",355
"10997",2020,15,23,63,57,"51.51943538","-0.119123345","Red Lion Square, Holborn",120
"10998",2020,15,24,119,105,"51.51908011","-0.124678402","British Museum, Bloomsbury",224
"10999",2020,15,25,87,68,"51.5288338","-0.132250369","Doric Way , Somers Town",155
"11000",2020,15,26,89,93,"51.52728093","-0.11829517","Ampton Street , Clerkenwell",182
"11001",2020,15,27,82,77,"51.51382102","-0.107927706","Bouverie Street, Temple",159
"11002",2020,15,28,311,295,"51.52351808","-0.143613641","Bolsover Street, Fitzrovia",606
"11003",2020,15,29,219,214,"51.513735","-0.193487","Hereford Road, Bayswater",433
"11004",2020,15,30,133,127,"51.52915444","-0.093421615","Windsor Terrace, Hoxton",260
"11005",2020,15,31,86,144,"51.52953709","-0.083353323","Fanshaw Street, Hoxton",230
"11006",2020,15,32,192,194,"51.52469624","-0.084439283","Leonard Circus , Shoreditch",386
"11007",2020,15,33,75,71,"51.5156","-0.070056","Central House, Aldgate",146
"11008",2020,15,34,101,103,"51.5341235","-0.129386874","Pancras Road, King's Cross",204
"11009",2020,15,36,549,560,"51.50173726","-0.184980612","De Vere Gardens, Kensington",1109
"11010",2020,15,37,193,193,"51.49159394","-0.192369256","Penywern Road, Earl's Court",386
"11011",2020,15,38,122,120,"51.4973875","-0.197245586","Abingdon Villas, Kensington",242
"11012",2020,15,39,204,204,"51.5263778","-0.078130921","Shoreditch High Street, Shoreditch",408
"11013",2020,15,40,151,169,"51.52127071","-0.0755789","Commercial Street, Shoreditch",320
"11014",2020,15,41,24,24,"51.520955","-0.083493552","Pindar Street, Liverpool Street",48
"11015",2020,15,42,220,200,"51.53099181","-0.093903825","Wenlock Road , Hoxton",420
"11016",2020,15,43,222,209,"51.52026","-0.157183945","Crawford Street, Marylebone",431
"11017",2020,15,44,84,84,"51.51073687","-0.144165239","Bruton Street, Mayfair",168
"11018",2020,15,45,88,78,"51.522511","-0.162298","Boston Place, Marylebone",166
"11019",2020,15,47,491,482,"51.52334476","-0.183846408","Warwick Avenue Station, Maida Vale",973
"11020",2020,15,48,165,170,"51.51248445","-0.099141408","Godliman Street, St. Paul's",335
"11021",2020,15,49,116,106,"51.50706909","-0.145904427","Curzon Street, Mayfair",222
"11022",2020,15,50,94,85,"51.52867339","-0.087459376","East Road, Hoxton",179
"11023",2020,15,51,73,82,"51.52671796","-0.104298194","Finsbury Library , Finsbury",155
"11024",2020,15,52,148,144,"51.52295439","-0.094934859","Roscoe Street, St. Luke's",292
"11025",2020,15,53,82,69,"51.5099923","-0.143495266","Grafton Street, Mayfair",151
"11026",2020,15,54,161,148,"51.52174785","-0.094475072","Golden Lane, Barbican",309
"11027",2020,15,55,94,92,"51.51707521","-0.086685542","Finsbury Circus, Liverpool Street",186
"11028",2020,15,56,158,147,"51.52058381","-0.154701411","Paddington Street, Marylebone",305
"11029",2020,15,57,167,158,"51.52334672","-0.120202614","Guilford Street , Bloomsbury",325
"11030",2020,15,58,130,127,"51.52452699","-0.079248081","New Inn Yard, Shoreditch",257
"11031",2020,15,60,131,132,"51.52644828","-0.172190727","Lisson Grove, St. John's Wood",263
"11032",2020,15,61,117,128,"51.49738251","-0.089446947","Great Dover Street, The Borough",245
"11033",2020,15,62,158,150,"51.4907579","-0.106323685","Cotton Garden Estate, Kennington",308
"11034",2020,15,63,96,94,"51.53089041","-0.089782579","Murray Grove , Hoxton",190
"11035",2020,15,64,152,162,"51.50946212","-0.124749274","William IV Street, Strand",314
"11036",2020,15,65,82,80,NA,NA,NA,162
"11037",2020,15,66,161,156,"51.51795029","-0.108657431","Holborn Circus, Holborn",317
"11038",2020,15,67,78,82,"51.51882555","-0.108028472","Hatton Garden, Holborn",160
"11039",2020,15,68,194,178,"51.52059681","-0.116688468","Theobald's Road , Holborn",372
"11040",2020,15,69,49,41,"51.5262363","-0.134407652","Euston Road, Euston",90
"11041",2020,15,70,57,52,"51.53136059","-0.117069978","Calshot Street , King's Cross",109
"11042",2020,15,71,240,184,"51.5154186","-0.098850915","Newgate Street , St. Paul's",424
"11043",2020,15,72,111,128,"51.52352001","-0.108340165","Farringdon Lane, Clerkenwell",239
"11044",2020,15,73,169,173,"51.52572618","-0.088486188","Old Street Station, St. Luke's",342
"11045",2020,15,74,475,478,"51.48591714","-0.124469948","Vauxhall Cross, Vauxhall",953
"11046",2020,15,75,97,92,"51.53219984","-0.105480698","Torrens Street, Angel",189
"11047",2020,15,76,115,106,"51.52559505","-0.144083893","Longford Street, The Regent's Park",221
"11048",2020,15,77,174,182,"51.52341837","-0.124121774","Russell Square Station, Bloomsbury",356
"11049",2020,15,78,96,95,"51.52486887","-0.099489485","Sadlers Sports Centre, Finsbury",191
"11050",2020,15,79,80,79,"51.511726","-0.11385596","Arundel Street, Temple",159
"11051",2020,15,80,169,146,"51.50069361","-0.102091246","Webber Street , Southwark",315
"11052",2020,15,81,140,140,"51.52025302","-0.141327271","Great Titchfield Street, Fitzrovia",280
"11053",2020,15,82,68,65,"51.514274","-0.111257","Chancery Lane, Holborn",133
"11054",2020,15,83,211,216,"51.50963938","-0.131510949","Panton Street, West End",427
"11055",2020,15,84,24,12,"51.51593725","-0.111778348","Breams Buildings, Holborn",36
"11056",2020,15,85,424,423,"51.50064702","-0.078600401","Tanner Street, Bermondsey",847
"11057",2020,15,86,99,100,"51.48947903","-0.115156562","Sancroft Street, Vauxhall",199
"11058",2020,15,87,54,56,"51.51646835","-0.079684557","Devonshire Square, Liverpool Street",110
"11059",2020,15,88,155,152,"51.51858757","-0.132053392","Bayley Street , Bloomsbury",307
"11060",2020,15,89,115,109,"51.5262503","-0.123509611","Tavistock Place, Bloomsbury",224
"11061",2020,15,90,21,11,"51.53301907","-0.139174593","Harrington Square 1, Camden Town",32
"11062",2020,15,91,201,197,"51.49368637","-0.111014912","Walnut Tree Walk, Vauxhall",398
"11063",2020,15,92,110,133,"51.49889832","-0.100440521","Borough Road, Elephant & Castle",243
"11064",2020,15,93,201,200,"51.53440868","-0.109025404","Cloudesley Road, Angel",401
"11065",2020,15,94,291,307,"51.49506109","-0.085814489","Bricklayers Arms, Borough",598
"11066",2020,15,95,197,218,"51.5208417","-0.097340162","Aldersgate Street, Barbican",415
"11067",2020,15,96,99,105,"51.53095071","-0.078505384","Falkirk Street, Hoxton",204
"11068",2020,15,97,245,257,"51.49792478","-0.183834706","Gloucester Road (North), Kensington",502
"11069",2020,15,98,224,190,"51.52554222","-0.138231303","Hampstead Road, Euston",414
"11070",2020,15,99,316,312,"51.51457763","-0.158264483","Old Quebec Street, Marylebone",628
"11071",2020,15,100,203,187,"51.49043573","-0.122806861","Albert Embankment, Vauxhall",390
"11072",2020,15,101,172,178,"51.51155322","-0.0929401","Queen Street 1, Bank",350
"11073",2020,15,102,97,99,"51.51340693","-0.076793375","Jewry Street, Aldgate",196
"11074",2020,15,103,156,151,"51.50472376","-0.192538767","Vicarage Gate, Kensington",307
"11075",2020,15,104,124,112,"51.51159481","-0.077121322","Crosswall, Tower",236
"11076",2020,15,105,260,278,"51.51552971","-0.190240716","Westbourne Grove, Bayswater",538
"11077",2020,15,106,38,32,"51.51410514","-0.147301667","Woodstock Street, Mayfair",70
"11078",2020,15,107,193,199,"51.52600832","-0.096317627","Finsbury Leisure Centre, St. Luke's",392
"11079",2020,15,108,102,111,"51.49812559","-0.132102166","Abbey Orchard Street, Westminster",213
"11080",2020,15,109,168,171,"51.51563144","-0.132328837","Soho Square , Soho",339
"11081",2020,15,110,207,198,"51.53304322","-0.172528678","Wellington Road, St. John's Wood",405
"11082",2020,15,111,567,590,"51.5100172","-0.157275636","Park Lane , Hyde Park",1157
"11083",2020,15,112,45,43,"51.51580998","-0.105270275","Stonecutter Street, Holborn",88
"11084",2020,15,113,190,197,"51.49646288","-0.183289032","Gloucester Road (Central), South Kensington",387
"11085",2020,15,114,579,581,"51.52451738","-0.158963647","Park Road (Baker Street), The Regent's Park",1160
"11086",2020,15,115,223,245,"51.51423368","-0.073537654","Braham Street, Aldgate",468
"11087",2020,15,116,153,152,"51.51449962","-0.141423695","Little Argyll Street, West End",305
"11088",2020,15,117,143,136,"51.49288067","-0.114934001","Lollard Street, Vauxhall",279
"11089",2020,15,118,111,119,"51.49582705","-0.13547809","Rochester Row, Westminster",230
"11090",2020,15,119,208,239,"51.52589324","-0.090847761","Bath Street, St. Luke's",447
"11091",2020,15,120,62,54,"51.51573534","-0.093080779","The Guildhall, Guildhall",116
"11092",2020,15,121,77,69,"51.51891348","-0.156166631","Baker Street, Marylebone",146
"11093",2020,15,122,108,116,"51.52111369","-0.078869751","Norton Folgate, Liverpool Street",224
"11094",2020,15,123,94,94,"51.52836014","-0.104724625","St. John Street, Finsbury",188
"11095",2020,15,125,133,134,"51.50069491","-0.094524319","Borough High Street, The Borough",267
"11096",2020,15,126,70,73,"51.51782144","-0.096496865","Museum of London, Barbican",143
"11097",2020,15,127,57,57,"51.51700801","-0.09388536","Wood Street, Guildhall",114
"11098",2020,15,128,212,223,"51.49536226","-0.185296516","Emperor's Gate, South Kensington",435
"11099",2020,15,129,159,160,"51.5118973","-0.137043852","Golden Square, Soho",319
"11100",2020,15,130,635,636,"51.50950627","-0.075459482","Tower Gardens , Tower",1271
"11101",2020,15,131,117,124,"51.53300545","-0.136792671","Eversholt Street , Camden Town",241
"11102",2020,15,132,315,296,"51.52364804","-0.074754872","Bethnal Green Road, Shoreditch",611
"11103",2020,15,133,345,344,NA,NA,NA,689
"11104",2020,15,134,484,497,"51.504904","-0.06797","Wapping High Street, Wapping",981
"11105",2020,15,135,163,181,"51.52326004","-0.104708922","Clerkenwell Green, Clerkenwell",344
"11106",2020,15,136,168,173,"51.51196176","-0.097441687","Queen Victoria Street, St. Paul's",341
"11107",2020,15,138,218,217,"51.51227622","-0.157436972","Green Street, Mayfair",435
"11108",2020,15,139,132,139,"51.49488108","-0.117974901","Lambeth Road, Vauxhall",271
"11109",2020,15,140,103,103,"51.52096262","-0.085634242","Finsbury Square , Moorgate",206
"11110",2020,15,141,63,64,"51.51530805","-0.147203711","Chapel Place, Marylebone",127
"11111",2020,15,142,160,156,"51.49372451","-0.198286569","West Cromwell Road, Earl's Court",316
"11112",2020,15,143,176,175,"51.4968865","-0.161203828","Pont Street, Knightsbridge",351
"11113",2020,15,144,261,283,"51.48894022","-0.111435796","Kennington Cross, Kennington",544
"11114",2020,15,145,140,135,"51.50074359","-0.202759212","Ilchester Place, Kensington",275
"11115",2020,15,146,173,172,"51.48836528","-0.129361842","Vauxhall Bridge , Pimlico",345
"11116",2020,15,148,204,205,"51.49211134","-0.138364847","Tachbrook Street, Victoria",409
"11117",2020,15,149,260,267,"51.48478899","-0.110683213","Kennington Road Post Office, Oval",527
"11118",2020,15,150,96,98,"51.49705603","-0.168917077","Holy Trinity Brompton, Knightsbridge",194
"11119",2020,15,151,193,186,"51.51213691","-0.201554966","Chepstow Villas, Notting Hill",379
"11120",2020,15,152,251,238,"51.49217002","-0.101536865","Hampton Street, Walworth",489
"11121",2020,15,153,738,738,"51.511933","-0.174411","Bayswater Road, Hyde Park",1476
"11122",2020,15,154,47,46,"51.50379168","-0.11282408","Waterloo Station 3, Waterloo",93
"11123",2020,15,155,155,160,"51.49586666","-0.191933711","Lexham Gardens, Kensington",315
"11124",2020,15,156,125,124,"51.49443626","-0.092921165","New Kent Road, The Borough",249
"11125",2020,15,157,185,225,"51.50039792","-0.193068385","Wright's Lane, Kensington",410
"11126",2020,15,158,186,191,"51.49085368","-0.196170309","Trebovir Road, Earl's Court",377
"11127",2020,15,159,148,153,"51.51461995","-0.137841333","Great Marlborough Street, Soho",301
"11128",2020,15,160,180,166,"51.50663341","-0.131773845","Waterloo Place, St. James's",346
"11129",2020,15,161,109,106,"51.49234577","-0.141334487","Guildhouse Street, Victoria",215
"11130",2020,15,162,107,102,"51.51760685","-0.121328408","Southampton Place, Holborn",209
"11131",2020,15,163,269,274,"51.4931848","-0.167894973","Sloane Avenue, Knightsbridge",543
"11132",2020,15,164,164,161,"51.515607","-0.183118788","Cleveland Gardens, Bayswater",325
"11133",2020,15,165,86,77,"51.517932","-0.183716959","Orsett Terrace, Bayswater",163
"11134",2020,15,166,197,200,"51.50185512","-0.159237081","Seville Street, Knightsbridge",397
"11135",2020,15,167,129,125,"51.49395092","-0.147624377","Eccleston Place, Victoria",254
"11136",2020,15,168,147,156,"51.50040123","-0.195455928","Argyll Road, Kensington",303
"11137",2020,15,169,344,334,"51.51474612","-0.165164288","Porchester Place, Paddington",678
"11138",2020,15,170,98,85,"51.52784273","-0.108068155","Hardwick Street, Clerkenwell",183
"11139",2020,15,171,208,221,"51.4916156","-0.186753859","Collingham Gardens, Earl's Court",429
"11140",2020,15,172,164,188,"51.49121192","-0.173715911","Sumner Place, South Kensington",352
"11141",2020,15,173,54,62,"51.50486","-0.113001","Waterloo Road, South Bank",116
"11142",2020,15,174,72,66,"51.512529","-0.115163","Strand, Strand",138
"11143",2020,15,175,48,42,"51.521668","-0.079608554","Worship Street, Shoreditch",90
"11144",2020,15,176,183,179,"51.51791921","-0.188098863","Gloucester Terrace, Bayswater",362
"11145",2020,15,177,131,120,"51.49616092","-0.140947636","Ashley Place, Victoria",251
"11146",2020,15,178,247,241,"51.48985626","-0.141923621","Warwick Square, Pimlico",488
"11147",2020,15,180,189,194,"51.5129118","-0.153645496","North Audley Street, Mayfair",383
"11148",2020,15,181,129,132,"51.49941247","-0.152317537","Belgrave Square, Belgravia",261
"11149",2020,15,182,114,111,"51.52202903","-0.165842551","Bell Street , Marylebone",225
"11150",2020,15,183,438,419,"51.482362","-0.13612398","Riverlight North, Nine Elms",857
"11151",2020,15,184,236,226,"51.52071513","-0.14521173","Portland Place, Marylebone",462
"11152",2020,15,185,300,310,"51.48805753","-0.140741432","Alderney Street, Pimlico",610
"11153",2020,15,186,151,137,"51.51733558","-0.175810943","South Wharf Road, Paddington",288
"11154",2020,15,187,255,251,"51.49247977","-0.178433004","Queen's Gate (South), South Kensington",506
"11155",2020,15,188,107,106,"51.5165179","-0.164393768","Nutford Place, Marylebone",213
"11156",2020,15,189,99,96,"51.53166681","-0.109914711","Claremont Square, Angel",195
"11157",2020,15,190,221,196,"51.48997562","-0.132845681","Rampayne Street, Pimlico",417
"11158",2020,15,191,399,427,"51.50311799","-0.153520935","Hyde Park Corner, Hyde Park",826
"11159",2020,15,192,313,316,"51.51251523","-0.133201961","Wardour Street, Soho",629
"11160",2020,15,193,117,115,"51.50581776","-0.100186337","Bankside Mix, Bankside",232
"11161",2020,15,194,602,662,"51.50462759","-0.091773776","Hop Exchange, The Borough",1264
"11162",2020,15,195,209,230,"51.50724437","-0.106237501","Milroy Walk, South Bank",439
"11163",2020,15,196,139,121,"51.50368837","-0.098497684","Union Street, The Borough",260
"11164",2020,15,197,79,74,"51.50556905","-0.111606696","Stamford Street, South Bank",153
"11165",2020,15,199,228,218,"51.51048489","-0.082989638","Great Tower Street, Monument",446
"11166",2020,15,200,224,215,"51.51492456","-0.066078037","LMU Commercial Road, Whitechapel",439
"11167",2020,15,201,235,222,"51.5225965","-0.161113413","Dorset Square, Marylebone",457
"11168",2020,15,202,336,342,"51.51236389","-0.06954201","Leman Street, Aldgate",678
"11169",2020,15,203,134,131,"51.51821864","-0.100791005","West Smithfield Rotunda, Farringdon",265
"11170",2020,15,204,99,108,"51.52659961","-0.112432615","Margery Street, Clerkenwell",207
"11171",2020,15,206,196,215,"51.518154","-0.062697","New Road 1 , Whitechapel",411
"11172",2020,15,207,93,88,"51.50135267","-0.153194766","Grosvenor Crescent, Belgravia",181
"11173",2020,15,208,70,58,"51.52505151","-0.166304359","Mallory Street, Marylebone",128
"11174",2020,15,209,128,106,"51.49358391","-0.165101392","Denyer Street, Knightsbridge",234
"11175",2020,15,210,155,156,"51.51681444","-0.151926305","Hinde Street, Marylebone",311
"11176",2020,15,211,176,161,"51.49464523","-0.158105512","Cadogan Place, Knightsbridge",337
"11177",2020,15,212,124,100,"51.50658458","-0.199004026","Campden Hill Road, Notting Hill",224
"11178",2020,15,213,1020,1013,"51.50274025","-0.149569201","Wellington Arch, Hyde Park",2033
"11179",2020,15,214,71,59,"51.52683806","-0.130504336","Endsleigh Gardens, Euston",130
"11180",2020,15,215,53,47,"51.51906932","-0.088285377","Moorfields, Moorgate",100
"11181",2020,15,216,286,263,"51.49094565","-0.181190899","Old Brompton Road, South Kensington",549
"11182",2020,15,217,195,207,"51.51615461","-0.082422399","Wormwood Street, Liverpool Street",402
"11183",2020,15,218,135,125,"51.48971651","-0.170194408","St. Luke's Church, Chelsea",260
"11184",2020,15,219,349,341,"51.49016361","-0.19039362","Bramham Gardens, Earl's Court",690
"11185",2020,15,220,199,213,"51.49066456","-0.166485083","Chelsea Green, Chelsea",412
"11186",2020,15,221,199,206,"51.49481649","-0.13045856","Horseferry Road, Westminster",405
"11187",2020,15,222,479,489,"51.50275704","-0.155349725","Knightsbridge, Hyde Park",968
"11188",2020,15,223,241,238,"51.49148474","-0.090220911","Rodney Road , Walworth",479
"11189",2020,15,224,679,684,"51.51031","-0.18740235","Queensway, Kensington Gardens",1363
"11190",2020,15,225,263,221,"51.50935342","-0.196422","Notting Hill Gate Station, Notting Hill",484
"11191",2020,15,226,96,76,"51.50844614","-0.131961389","Charles II Street, West End",172
"11192",2020,15,227,88,91,"51.52891573","-0.115480888","Great Percy Street, Clerkenwell",179
"11193",2020,15,228,212,207,"51.50742485","-0.134621209","St. James's Square, St. James's",419
"11194",2020,15,229,390,398,"51.50654321","-0.123179697","Whitehall Place, Strand",788
"11195",2020,15,230,96,85,"51.50669284","-0.103137426","Poured Lines, Bankside",181
"11196",2020,15,231,181,185,"51.49396755","-0.17873226","Queen's Gate (Central), South Kensington",366
"11197",2020,15,232,36,32,"51.51501025","-0.112753217","Carey Street, Holborn",68
"11198",2020,15,233,287,293,"51.50777049","-0.130699733","Pall Mall East, West End",580
"11199",2020,15,234,243,256,"51.53450449","-0.106992706","Liverpool Road (N1 Centre), Angel",499
"11200",2020,15,235,205,188,"51.49571828","-0.110889274","Kennington Road  , Vauxhall",393
"11201",2020,15,236,83,94,"51.51838043","-0.073438925","Fashion Street, Whitechapel",177
"11202",2020,15,237,279,279,"51.5097860151","-0.0681619805156","Dock Street, Wapping",558
"11203",2020,15,238,129,128,"51.5233534","-0.175116099","Frampton Street, Paddington",257
"11204",2020,15,239,180,164,"51.52443845","-0.138019439","Warren Street Station, Euston",344
"11205",2020,15,240,23,25,"51.50545935","-0.10569204","Colombo Street, Southwark",48
"11206",2020,15,242,222,217,"51.52200801","-0.151359288","Beaumont Street, Marylebone",439
"11207",2020,15,243,272,273,"51.49096258","-0.139625122","Gloucester Street, Pimlico",545
"11208",2020,15,244,122,123,"51.51611887","-0.128585022","Earnshaw Street , Covent Garden",245
"11209",2020,15,245,147,141,"51.4853572","-0.142207481","Grosvenor Road, Pimlico",288
"11210",2020,15,246,164,178,"51.52285301","-0.099994052","Berry Street, Clerkenwell",342
"11211",2020,15,247,301,297,"51.530529","-0.167515","St. John's Wood Church, The Regent's Park",598
"11212",2020,15,248,360,380,"51.50645179","-0.170279555","Triangle Car Park, Hyde Park",740
"11213",2020,15,249,123,110,"51.49859784","-0.096191134","Harper Road, The Borough",233
"11214",2020,15,250,101,101,"51.489932","-0.162727","Royal Avenue 1, Chelsea",202
"11215",2020,15,251,229,227,"51.518908","-0.079249","Brushfield Street, Liverpool Street",456
"11216",2020,15,252,338,363,"51.5046364","-0.116542278","Jubilee Gardens, South Bank",701
"11217",2020,15,253,342,362,"51.53404294","-0.086379717","Shoreditch Park, Hoxton",704
"11218",2020,15,254,203,186,"51.53051587","-0.106408455","Chadwell Street, Angel",389
"11219",2020,15,255,366,373,"51.52557531","-0.179592915","Clifton Road, Maida Vale",739
"11220",2020,15,256,25,23,"51.51362054","-0.116764211","Houghton Street, Strand",48
"11221",2020,15,257,184,187,"51.52248185","-0.154907218","Westminster University, Marylebone",371
"11222",2020,15,259,203,188,"51.490959","-0.1532331","Bourne Street, Belgravia",391
"11223",2020,15,260,112,110,"51.5136846","-0.135580879","Broadwick Street, Soho",222
"11224",2020,15,261,160,161,"51.5134891","-0.191351186","Princes Square, Bayswater",321
"11225",2020,15,262,144,150,"51.49874469","-0.103132904","LSBU (Borough Road), Elephant & Castle",294
"11226",2020,15,263,50,41,"51.51422502","-0.080660083","St. Mary Axe, Aldgate",91
"11227",2020,15,264,127,139,"51.52644342","-0.109256828","Tysoe Street, Clerkenwell",266
"11228",2020,15,265,138,125,"51.51595344","-0.169249375","Southwick Street, Paddington",263
"11229",2020,15,266,684,713,"51.50102668","-0.180246101","Queen's Gate (North), Kensington",1397
"11230",2020,15,267,106,97,"51.49206037","-0.132224622","Regency Street, Westminster",203
"11231",2020,15,268,134,120,"51.49320445","-0.144132875","Belgrave Road, Victoria",254
"11232",2020,15,269,197,227,"51.50082346","-0.089740764","Empire Square, The Borough",424
"11233",2020,15,270,302,313,"51.4863434","-0.122492418","Kennington Lane Rail Bridge, Vauxhall",615
"11234",2020,15,271,125,134,"51.53583617","-0.156285395","London Zoo,  The Regent's Park",259
"11235",2020,15,272,199,217,"51.50144456","-0.110699309","Baylis Road, Waterloo",416
"11236",2020,15,273,102,90,"51.50613324","-0.114686385","Belvedere Road 1, South Bank",192
"11237",2020,15,274,208,203,"51.49671237","-0.20528437","Warwick Road, Olympia",411
"11238",2020,15,275,96,96,"51.52004497","-0.092176447","Barbican Centre, Barbican",192
"11239",2020,15,276,90,92,"51.50930161","-0.084985356","Lower Thames Street, Monument",182
"11240",2020,15,277,232,239,"51.50315739","-0.191496313","Kensington Church Street, Kensington",471
"11241",2020,15,278,668,702,"51.5034938","-0.07962099","Tooley Street, Bermondsey",1370
"11242",2020,15,279,141,145,"51.51862243","-0.176645823","North Wharf Road, Paddington",286
"11243",2020,15,280,197,189,"51.490083","-0.162418","Royal Avenue 2, Chelsea",386
"11244",2020,15,281,153,155,"51.49580589","-0.127575233","Smith Square, Westminster",308
"11245",2020,15,282,343,327,"51.51906446","-0.059642081","Royal London Hospital, Whitechapel",670
"11246",2020,15,283,23,20,"51.51440928","-0.118478757","Kingsway, Covent Garden",43
"11247",2020,15,284,167,165,"51.49914063","-0.112031483","Lambeth North Station, Waterloo",332
"11248",2020,15,286,161,141,"51.5272947","-0.174653609","St. John's Wood Road, St. John's Wood",302
"11249",2020,15,287,51,44,"51.52367314","-0.128377673","Bedford Way, Bloomsbury",95
"11250",2020,15,288,175,176,"51.49236962","-0.147478734","Elizabeth Bridge, Victoria",351
"11251",2020,15,289,68,53,"51.50923022","-0.151296092","South Audley Street, Mayfair",121
"11252",2020,15,290,184,169,"51.518268","-0.17110323","St Mary's Hospital, Paddington",353
"11253",2020,15,291,301,272,"51.48483991","-0.138089062","Claverton Street, Pimlico",573
"11254",2020,15,292,266,248,"51.49888404","-0.165471605","Montpelier Street, Knightsbridge",514
"11255",2020,15,293,112,97,"51.49815779","-0.209494128","Kensington Olympia Station, Olympia",209
"11256",2020,15,294,290,274,"51.488226","-0.135635511","St. George's Square, Pimlico",564
"11257",2020,15,295,112,89,"51.50029631","-0.092762704","Swan Street, The Borough",201
"11258",2020,15,296,181,186,"51.49363156","-0.190603326","Knaresborough Place, Earl's Court",367
"11259",2020,15,297,62,63,"51.49612799","-0.106000855","Geraldine Street, Elephant & Castle",125
"11260",2020,15,298,529,540,"51.50227992","-0.074189225","Curlew Street, Shad Thames",1069
"11261",2020,15,299,100,95,"51.49398524","-0.136928582","Vincent Square, Westminster",195
"11262",2020,15,300,284,300,"51.505014","-0.17306032","Serpentine Car Park, Hyde Park",584
"11263",2020,15,301,145,139,"51.51475963","-0.148105415","Marylebone Lane, Marylebone",284
"11264",2020,15,302,367,373,"51.466907","-0.216573","Putney Pier, Wandsworth",740
"11265",2020,15,303,247,327,"51.50295379","-0.158456089","Albert Gate, Hyde Park",574
"11266",2020,15,306,107,102,"51.51816295","-0.135025698","Rathbone Street, Fitzrovia",209
"11267",2020,15,307,446,454,"51.50990837","-0.187842717","Black Lion Gate, Kensington Gardens",900
"11268",2020,15,308,200,204,"51.49907558","-0.085666316","Long Lane , Bermondsey",404
"11269",2020,15,309,187,195,"51.50963123","-0.119047563","Embankment (Savoy), Strand",382
"11270",2020,15,310,144,119,"51.4908679","-0.116911864","Black Prince Road, Vauxhall",263
"11271",2020,15,311,174,178,"51.51918144","-0.140485596","Foley Street, Fitzrovia",352
"11272",2020,15,312,315,308,"51.53088935","-0.176770502","Grove End Road, St. John's Wood",623
"11273",2020,15,313,111,108,"51.51734403","-0.138072691","Wells Street, Fitzrovia",219
"11274",2020,15,314,133,139,"51.50088934","-0.083159352","Tyers Gate, Bermondsey",272
"11275",2020,15,315,175,188,"51.52536703","-0.153463612","The Tennis Courts, The Regent's Park",363
"11276",2020,15,316,233,257,NA,NA,NA,490
"11277",2020,15,317,30,65,"51.49679128","-0.093913472","Dickens Square, Borough",95
"11278",2020,15,318,123,110,"51.51004801","-0.138846453","Sackville Street, Mayfair",233
"11279",2020,15,319,127,130,"51.52702563","-0.088542771","Baldwin Street, St. Luke's",257
"11280",2020,15,320,193,192,"51.49357351","-0.139956043","Queen Mother Sports Centre, Victoria",385
"11281",2020,15,321,415,411,"51.49785559","-0.081608045","Bermondsey Street, Bermondsey",826
"11282",2020,15,322,113,103,"51.526293","-0.073955","Palissy Street, Shoreditch",216
"11283",2020,15,323,28,24,"51.523196","-0.083067","Clifton Street, Shoreditch",52
"11284",2020,15,324,192,197,"51.49652013","-0.101384068","Ontario Street, Elephant & Castle",389
"11285",2020,15,325,67,70,"51.50908747","-0.129697889","St. Martin's Street, West End",137
"11286",2020,15,326,318,342,"51.53266186","-0.099981142","Graham Street, Angel",660
"11287",2020,15,327,68,51,"51.53095","-0.085603","New North Road 1, Hoxton",119
"11288",2020,15,328,85,92,"51.53114","-0.086016","New North Road 2, Hoxton",177
"11289",2020,15,329,639,641,"51.53589283","-0.160854428","Prince Albert Road, The Regent's Park",1280
"11290",2020,15,330,100,86,"51.51641749","-0.179135079","Eastbourne Mews, Paddington",186
"11291",2020,15,331,147,151,"51.52085887","-0.089887855","Bunhill Row, Moorgate",298
"11292",2020,15,332,120,124,"51.49334336","-0.194757949","Nevern Place, Earl's Court",244
"11293",2020,15,333,253,229,"51.50860544","-0.193764092","Palace Gardens Terrace, Notting Hill",482
"11294",2020,15,334,42,43,"51.505044","-0.115851","Concert Hall Approach 1, South Bank",85
"11295",2020,15,335,89,75,"51.51196803","-0.120718759","Tavistock Street, Covent Garden",164
"11296",2020,15,336,51,47,"51.504942","-0.115533","Concert Hall Approach 2, South Bank",98
"11297",2020,15,337,143,128,"51.51108452","-0.197524944","Pembridge Villas, Notting Hill",271
"11298",2020,15,338,157,160,"51.51175646","-0.119643424","Wellington Street , Strand",317
"11299",2020,15,339,95,77,"51.5333196","-0.1117812","Risinghill Street, Angel",172
"11300",2020,15,340,125,126,"51.51444134","-0.087587447","Bank of England Museum, Bank",251
"11301",2020,15,341,237,242,"51.50810309","-0.12602103","Craven Street, Strand",479
"11302",2020,15,343,70,87,"51.53692216","-0.150181444","London Zoo Car Park, The Regent's Park",157
"11303",2020,15,344,88,77,"51.528246","-0.10102611","Goswell Road (City Uni), Finsbury",165
"11304",2020,15,345,286,280,"51.48802358","-0.166878535","Flood Street, Chelsea",566
"11305",2020,15,347,145,173,"51.50013942","-0.113936001","Lower Marsh, Waterloo",318
"11306",2020,15,348,158,162,"51.51217033","-0.150481272","Grosvenor Square, Mayfair",320
"11307",2020,15,349,77,59,"51.51196","-0.142783033","St. George Street, Mayfair",136
"11308",2020,15,350,184,199,"51.5017154373867","-0.1798541843891","Queen's Gate, Kensington Gardens",383
"11309",2020,15,351,151,151,"51.529423","-0.097122","Macclesfield Rd, St Lukes",302
"11310",2020,15,352,126,133,"51.486965","-0.116625","Vauxhall Street, Vauxhall",259
"11311",2020,15,353,80,78,"51.49459148","-0.134234258","Greycoat Street , Westminster",158
"11312",2020,15,354,193,194,"51.506767","-0.123702","Northumberland Avenue, Strand",387
"11313",2020,15,356,281,279,"51.494412","-0.173881","South Kensington Station, South Kensington",560
"11314",2020,15,357,104,101,"51.520994","-0.139016","Howland Street, Fitzrovia",205
"11315",2020,15,358,49,44,"51.516226","-0.124826","High Holborn , Covent Garden",93
"11316",2020,15,359,49,76,"51.49782999","-0.135440826","Butler Place, Westminster",125
"11317",2020,15,360,108,112,"51.49675303","-0.138733562","Howick Place, Westminster",220
"11318",2020,15,361,45,25,"51.50391973","-0.11342629","Waterloo Station 2, Waterloo",70
"11319",2020,15,362,137,127,"51.536264","-0.133952","Royal College Street, Camden Town",264
"11320",2020,15,363,72,44,"51.5291212008901","-0.171185284853","Lord's, St. John's Wood",116
"11321",2020,15,364,78,77,"51.519656","-0.132339","Alfred Place, Bloomsbury",155
"11322",2020,15,365,105,85,"51.530344","-0.100168","City Road, Angel",190
"11323",2020,15,366,58,51,"51.5109192966489","-0.1511263847351","Millennium Hotel, Mayfair",109
"11324",2020,15,367,178,169,"51.5173721","-0.1642075","Harrowby Street, Marylebone",347
"11325",2020,15,368,219,207,"51.50024195","-0.15934065","Harriet Street, Knightsbridge",426
"11326",2020,15,371,39,34,"51.49775","-0.10988","King Edward Walk, Waterloo",73
"11327",2020,15,372,47,33,"51.515208","-0.117863","Sardinia Street, Holborn",80
"11328",2020,15,373,78,50,"51.49980661","-0.176415994","Prince Consort Road, Knightsbridge",128
"11329",2020,15,374,103,113,"51.50402794","-0.11386436","Waterloo Station 1, Waterloo",216
"11330",2020,15,375,129,127,"51.50194596","-0.194392952","Kensington Town Hall, Kensington",256
"11331",2020,15,376,274,271,"51.49188409","-0.125674815","Millbank Tower, Pimlico",545
"11332",2020,15,377,66,66,"51.50535447","-0.113656543","Waterloo Bridge, South Bank",132
"11333",2020,15,378,75,90,"51.49559291","-0.179077626","Natural History Museum, South Kensington",165
"11334",2020,15,379,250,256,"51.51431171","-0.200838199","Turquoise Island, Notting Hill",506
"11335",2020,15,380,64,48,"51.50686435","-0.150666888","Stanhope Gate, Mayfair",112
"11336",2020,15,381,130,116,"51.51953043","-0.13577731","Charlotte Street, Fitzrovia",246
"11337",2020,15,382,55,58,"51.50935171","-0.14744969","Farm Street, Mayfair",113
"11338",2020,15,383,109,109,"51.51310333","-0.13121385","Frith Street, Soho",218
"11339",2020,15,384,165,163,"51.496481","-0.192404","Marloes Road, Kensington",328
"11340",2020,15,386,226,229,"51.51352755","-0.130110822","Moor Street, Soho",455
"11341",2020,15,387,292,276,"51.49369988","-0.121394101","Fire Brigade Pier, Vauxhall",568
"11342",2020,15,388,148,159,"51.51070161","-0.121723604","Southampton Street, Strand",307
"11343",2020,15,389,30,26,"51.51013066","-0.155757901","Upper Grosvenor Street, Mayfair",56
"11344",2020,15,390,79,67,"51.521776","-0.068856","Buxton Street 1, Shoreditch",146
"11345",2020,15,392,120,129,"51.49942855","-0.179702476","Imperial College, Knightsbridge",249
"11346",2020,15,393,63,69,"51.51733427","-0.103604248","Snow Hill, Farringdon",132
"11347",2020,15,394,127,124,"51.524826","-0.176268","Aberdeen Place, St. John's Wood",251
"11348",2020,15,395,234,229,"51.492462","-0.159919","Cadogan Gardens, Chelsea",463
"11349",2020,15,396,158,152,"51.51809","-0.163609","Shouldham Street, Marylebone",310
"11350",2020,15,397,302,294,"51.51348","-0.17977","Devonshire Terrace, Bayswater",596
"11351",2020,15,398,234,226,"51.502319","-0.200742","Holland Park, Kensington",460
"11352",2020,15,399,185,194,"51.52261762","-0.071653961","Brick Lane Market, Shoreditch",379
"11353",2020,15,400,110,112,"51.517703","-0.154106","George Street, Marylebone",222
"11354",2020,15,401,202,197,"51.528187","-0.075375","Columbia Road, Shoreditch",399
"11355",2020,15,402,111,108,"51.52289229","-0.171681991","Penfold Street, Marylebone",219
"11356",2020,15,403,122,119,"51.51689296","-0.158249929","George Place Mews, Marylebone",241
"11357",2020,15,404,298,300,"51.50204238","-0.184400221","Palace Gate, Kensington Gardens",598
"11358",2020,15,405,360,367,"51.49418566","-0.18267094","Gloucester Road Station, South Kensington",727
"11359",2020,15,409,250,264,"51.493146","-0.099828","Strata, Elephant & Castle",514
"11360",2020,15,410,253,234,"51.519968","-0.169774","Edgware Road Station, Marylebone",487
"11361",2020,15,411,243,256,"51.49337264","-0.09968067","Walworth Road, Elephant & Castle",499
"11362",2020,15,412,112,106,"51.488105","-0.110121","Cleaver Street, Kennington",218
"11363",2020,15,419,500,487,"51.485821","-0.149004","Chelsea Bridge, Pimlico",987
"11364",2020,15,420,73,77,"51.504043","-0.105312","Southwark Station 1, Southwark",150
"11365",2020,15,421,74,68,"51.504044","-0.104778","Southwark Station 2, Southwark",142
"11366",2020,15,423,190,205,"51.49456127","-0.15393398","Eaton Square (South), Belgravia",395
"11367",2020,15,424,176,160,"51.490491","-0.149186","Ebury Bridge, Pimlico",336
"11368",2020,15,425,93,82,"51.533379","-0.139159","Harrington Square 2, Camden Town",175
"11369",2020,15,426,209,189,"51.493072","-0.129925","Vincent Street, Pimlico",398
"11370",2020,15,427,230,212,"51.51397065","-0.09294031","Cheapside, Bank",442
"11371",2020,15,428,404,398,"51.499917","-0.174554","Exhibition Road, Knightsbridge",802
"11372",2020,15,430,129,130,"51.48902","-0.17524","South Parade, Chelsea",259
"11373",2020,15,431,86,75,"51.534474","-0.122203","Crinan Street, King's Cross",161
"11374",2020,15,432,130,113,"51.496957","-0.173894","Exhibition Road Museums, South Kensington",243
"11375",2020,15,433,95,89,"51.524564","-0.116279","Wren Street, Holborn",184
"11376",2020,15,435,187,183,"51.488852","-0.105593","Kennington Station, Kennington",370
"11377",2020,15,436,119,109,"51.51824","-0.11655","Red Lion Street, Holborn",228
"11378",2020,15,437,170,156,"51.488124","-0.120903","Vauxhall Walk, Vauxhall",326
"11379",2020,15,439,46,48,"51.5338","-0.118677","Killick Street, King's Cross",94
"11380",2020,15,440,216,204,"51.483145","-0.113134","Kennington Oval, Oval",420
"11381",2020,15,441,108,97,"51.495656","-0.114605","Sail Street, Vauxhall",205
"11382",2020,15,442,88,100,"51.510101","-0.211358","Walmer Road, Avondale",188
"11383",2020,15,443,163,146,"51.515256","-0.058641","Philpot Street, Whitechapel",309
"11384",2020,15,444,164,159,"51.52568","-0.055312","Bethnal Green Garden, Bethnal Green",323
"11385",2020,15,445,104,88,"51.52388","-0.065076","Cheshire Street, Bethnal Green",192
"11386",2020,15,446,144,147,"51.528936","-0.055894","York Hall, Bethnal Green",291
"11387",2020,15,447,110,115,"51.493381","-0.007542","Jubilee Crescent, Cubitt Town",225
"11388",2020,15,448,232,215,"51.50623","-0.02296","Fisherman's Walk West, Canary Wharf",447
"11389",2020,15,449,306,296,"51.511088","-0.057159","Shadwell Station, Shadwell",602
"11390",2020,15,450,110,90,"51.515975","-0.053177","Jubilee Street, Stepney",200
"11391",2020,15,451,199,201,"51.504719","-0.063531","Hermitage Court, Wapping",400
"11392",2020,15,452,9,9,"51.505697","-0.070542","St. Katharine's Way, Tower",18
"11393",2020,15,453,193,183,"51.508447","-0.055167","Garnet Street, Shadwell",376
"11394",2020,15,454,288,279,"51.487679","-0.021582","Napier Avenue, Millwall",567
"11395",2020,15,455,198,197,"51.49447","-0.014409","East Ferry Road, Cubitt Town",395
"11396",2020,15,456,194,237,"51.538071","-0.144664","Parkway, Camden Town",431
"11397",2020,15,458,254,255,"51.504749","-0.057544","Wapping Lane, Wapping",509
"11398",2020,15,459,265,272,"51.535179","-0.03338","Gunmakers Lane, Old Ford",537
"11399",2020,15,460,215,204,"51.516196","-0.029138","Burdett Road, Mile End",419
"11400",2020,15,461,90,87,"51.516","-0.038775","Aston Street, Stepney",177
"11401",2020,15,462,324,333,"51.541603","-0.138853","Bonny Street, Camden Town",657
"11402",2020,15,463,60,60,"51.534776","-0.071881","Thurtle Road, Haggerston",120
"11403",2020,15,464,55,53,"51.51417","-0.052099","St. Mary & St. Michael Church, Stepney",108
"11404",2020,15,465,147,150,"51.53558","-0.08249","Pitfield Street North,Hoxton",297
"11405",2020,15,466,103,107,"51.534464","-0.076341","Whiston Road, Haggerston",210
"11406",2020,15,467,122,118,"51.523538","-0.030556","Southern Grove, Bow",240
"11407",2020,15,468,88,88,"51.521564","-0.022694","Cantrell Road, Bow",176
"11408",2020,15,469,154,147,"51.513757","-0.020467","Lindfield Street, Poplar",301
"11409",2020,15,470,144,127,"51.530535","-0.025492","Mostyn Grove, Bow",271
"11410",2020,15,471,98,103,"51.533283","-0.028155","Hewison Street, Old Ford",201
"11411",2020,15,472,48,40,"51.529452","-0.027616","Malmesbury Road, Bow",88
"11412",2020,15,473,74,72,"51.496137","-0.019355","Millharbour, Millwall",146
"11413",2020,15,475,289,294,"51.499041","-0.020157","Lightermans Road, Millwall",583
"11414",2020,15,476,160,137,"51.489096","-0.009205","Stebondale Street, Cubitt Town",297
"11415",2020,15,477,189,195,"51.49109","-0.018716","Spindrift Avenue, Millwall",384
"11416",2020,15,478,255,266,"51.521889","-0.04667","Stepney Green Station, Stepney",521
"11417",2020,15,479,190,185,"51.527152","-0.058005","Pott Street, Bethnal Green",375
"11418",2020,15,480,500,494,"51.5128711","-0.0389866","Flamborough Street, Limehouse",994
"11419",2020,15,481,475,474,"51.487129","-0.009001","Saunders Ness Road, Cubitt Town",949
"11420",2020,15,483,183,176,"51.51328","-0.047784","Albert Gardens, Stepney",359
"11421",2020,15,484,161,162,"51.528828","-0.013258","Bromley High Street, Bow",323
"11422",2020,15,485,204,201,"51.531127","-0.048017","Old Ford Road, Bethnal Green",405
"11423",2020,15,486,197,213,"51.525645","-0.069543","Granby Street, Shoreditch",410
"11424",2020,15,487,177,178,"51.511811","-0.025626","Canton Street, Poplar",355
"11425",2020,15,488,196,185,"51.506946","-0.058681","Reardon Street, Wapping",381
"11426",2020,15,489,186,194,"51.513074","-0.064094","Christian Street, Whitechapel",380
"11427",2020,15,490,108,96,"51.508622","-0.065006","Pennington Street, Wapping",204
"11428",2020,15,491,152,147,"51.522507","-0.041378","Queen Mary's, Mile End",299
"11429",2020,15,492,210,193,"51.525501","-0.032267204","Maplin Street, Mile End",403
"11430",2020,15,494,30,23,"51.50196","-0.016251","South Quay East, Canary Wharf",53
"11431",2020,15,495,353,329,"51.528169","-0.018703","Bow Church Station, Bow",682
"11432",2020,15,496,215,206,"51.52512","-0.015578","Devons Road, Bow",421
"11433",2020,15,497,156,164,"51.526149","-0.027396845","Merchant Street, Bow",320
"11434",2020,15,498,147,141,"51.527058","-0.025296","Bow Road Station, Bow",288
"11435",2020,15,499,245,237,"51.519265","-0.021345","Furze Green, Bow",482
"11436",2020,15,500,263,283,"51.519806","-0.055731","Ansell House, Stepney",546
"11437",2020,15,501,155,149,"51.522561","-0.054883","Cephas Street, Bethnal Green",304
"11438",2020,15,502,327,314,"51.53341","-0.049591815","Bonner Gate, Victoria Park",641
"11439",2020,15,503,251,255,"51.520893","-0.051394","Cleveland Way, Stepney",506
"11440",2020,15,504,145,149,"51.496454","-0.009506","St. John's Park, Cubitt Town",294
"11441",2020,15,505,167,162,"51.520398","-0.026768","Ackroyd Drive, Bow",329
"11442",2020,15,506,150,165,"51.517475","-0.075855","Bell Lane, Liverpool Street",315
"11443",2020,15,507,67,69,"51.528692","-0.059091","Clarkson Street, Bethnal Green",136
"11444",2020,15,508,153,152,"51.519362","-0.074431","Fournier Street, Whitechapel",305
"11445",2020,15,509,28,30,"51.517842","-0.090075","Fore Street, Guildhall",58
"11446",2020,15,510,437,475,"51.509303","-0.025996","Westferry DLR, Limehouse",912
"11447",2020,15,511,322,331,"51.511066","-0.053558","Sutton Street, Shadwell",653
"11448",2020,15,512,181,198,"51.532091","-0.06142","Pritchard's Road, Bethnal Green",379
"11449",2020,15,513,182,179,"51.5142228","-0.055656","Watney Market, Stepney",361
"11450",2020,15,514,144,140,"51.516204","-0.155525","Portman Square, Marylebone",284
"11451",2020,15,515,104,93,"51.500088","-0.211316","Russell Gardens, Olympia",197
"11452",2020,15,516,172,179,"51.5112","-0.014438","Chrisp Street Market, Poplar",351
"11453",2020,15,517,131,140,"51.532513","-0.033085","Ford Road, Old Ford",271
"11454",2020,15,518,159,144,"51.528224","-0.037471","Antill Road, Mile End",303
"11455",2020,15,519,66,65,"51.518811","-0.011662","Teviot Street, Poplar",131
"11456",2020,15,520,137,129,"51.526041","-0.047218","Bancroft Road, Bethnal Green",266
"11457",2020,15,521,222,227,"51.534137","-0.037366","Driffield Road, Old Ford",449
"11458",2020,15,522,215,225,"51.525941","-0.036017","Clinton Road, Mile End",440
"11459",2020,15,523,117,103,"51.51549","-0.013475","Langdon Park, Poplar",220
"11460",2020,15,524,226,191,"51.511654","-0.179668","Lancaster Gate , Bayswater",417
"11461",2020,15,526,138,136,"51.503143","-0.008428","Lancaster Drive, Blackwall",274
"11462",2020,15,527,130,149,"51.503802","-0.215808","Hansard Mews, Holland Park",279
"11463",2020,15,528,28,29,"51.507326","-0.145827","Clarges Street, Mayfair",57
"11464",2020,15,529,106,116,"51.486892","-0.170983","Manresa Road, Chelsea",222
"11465",2020,15,530,164,161,"51.508896","-0.012413","Newby Place, Poplar",325
"11466",2020,15,531,266,259,"51.530326","-0.042744","Twig Folly Bridge, Mile End",525
"11467",2020,15,532,125,214,"51.50357","-0.020068","Jubilee Plaza, Canary Wharf",339
"11468",2020,15,533,113,111,"51.528222","-0.069743","Wellington Row, Bethnal Green",224
"11469",2020,15,534,240,255,"51.531864","-0.066035","Goldsmith's Row, Haggerston",495
"11470",2020,15,535,254,254,"51.537349","-0.147154","Gloucester Avenue, Camden Town",508
"11471",2020,15,536,100,94,"51.53385","-0.06992","Queensbridge Road, Haggerston",194
"11472",2020,15,537,207,204,"51.51793","-0.067937","Old Montague Street, Whitechapel",411
"11473",2020,15,538,189,187,"51.508981","-0.00699","Naval Row, Blackwall",376
"11474",2020,15,540,241,243,"51.528302","-0.144466","Albany Street, The Regent's Park",484
"11475",2020,15,541,347,358,"51.506613","-0.142844","Green Park Station, Mayfair",705
"11476",2020,15,542,239,244,"51.514115","-0.033828","Salmon Lane, Limehouse",483
"11477",2020,15,543,71,51,"51.509591","-0.204666","Lansdowne Walk, Ladbroke Grove",122
"11478",2020,15,544,107,115,"51.526153","-0.102208","Percival Street, Finsbury",222
"11479",2020,15,545,126,135,"51.539957","-0.145246","Arlington Road, Camden Town",261
"11480",2020,15,546,103,100,"51.517428","-0.107987","New Fetter Lane, Holborn",203
"11481",2020,15,547,376,372,"51.509474","-0.002275","East India DLR, Blackwall",748
"11482",2020,15,548,63,53,"51.498386","-0.107913","Westminster Bridge Road, Elephant & Castle",116
"11483",2020,15,549,161,135,"51.49605","-0.104193","Gaywood  Street, Elephant & Castle",296
"11484",2020,15,550,74,71,"51.521564","-0.039264","Harford Street, Mile End",145
"11485",2020,15,551,116,97,"51.505772","-0.016460175","Import Dock, Canary Wharf",213
"11486",2020,15,552,105,123,"51.511542","-0.056667","Watney Street, Shadwell",228
"11487",2020,15,553,628,611,"51.535678","-0.062546","Regent's Row , Haggerston",1239
"11488",2020,15,554,71,69,"51.513548","-0.005659","Aberfeldy Street, Poplar",140
"11489",2020,15,556,85,81,"51.502661","-0.021596","Heron Quays DLR, Canary Wharf",166
"11490",2020,15,557,109,100,"51.51601","-0.0985","King Edward Street, St Pauls",209
"11491",2020,15,558,191,181,"51.493978","-0.127554","Page Street, Westminster",372
"11492",2020,15,559,171,159,"51.501391","-0.205991","Abbotsbury Road, Holland Park",330
"11493",2020,15,560,97,80,"51.511624","-0.205921","Ladbroke Grove Central, Ladbroke Grove",177
"11494",2020,15,561,125,120,"51.518369","-0.043371","Rectory Square, Stepney",245
"11495",2020,15,562,86,86,"51.51746","-0.12335","Bury Place, Holborn",172
"11496",2020,15,563,150,157,"51.499286","-0.009152","Preston's Road, Cubitt Town",307
"11497",2020,15,564,645,659,"51.509943","-0.117619","Somerset House, Strand",1304
"11498",2020,15,565,72,68,"51.521905","-0.063386","Selby Street, Whitechapel",140
"11499",2020,15,566,176,184,"51.509158","-0.224103","Westfield Ariel Way, White City",360
"11500",2020,15,568,352,361,"51.51616","-0.18697","Bishop's Bridge Road West, Bayswater",713
"11501",2020,15,569,153,118,"51.53213","-0.08299","Pitfield Street Central, Hoxton",271
"11502",2020,15,570,222,226,"51.503083","-0.017676","Upper Bank Street, Canary Wharf",448
"11503",2020,15,571,70,89,"51.506256","-0.218337","Westfield Southern Terrace ,Shepherd's Bush",159
"11504",2020,15,572,262,257,"51.539099","-0.141728","Greenland Road, Camden Town",519
"11505",2020,15,573,382,369,"51.485587","-0.18119","Limerston Street, West Chelsea",751
"11506",2020,15,574,96,121,"51.53356","-0.09315","Eagle Wharf Road, Hoxton",217
"11507",2020,15,576,194,202,"51.497304","-0.022793","Alpha Grove, Millwall",396
"11508",2020,15,577,186,193,"51.528869","-0.047548","Globe Town Market, Bethnal Green",379
"11509",2020,15,578,17,40,"51.527607","-0.057133","Hollybush Gardens, Bethnal Green",57
"11510",2020,15,579,368,361,"51.511246","-0.093051","Queen Street 2, Bank",729
"11511",2020,15,580,237,215,"51.48692917","-0.102996299","Doddington Grove, Kennington",452
"11512",2020,15,581,189,187,"51.519167","-0.147983","New Cavendish Street, Marylebone",376
"11513",2020,15,583,390,400,"51.497622","-0.125978","Abingdon Green, Westminster",790
"11514",2020,15,584,166,180,"51.51244","-0.19096","Ilchester Gardens, Bayswater",346
"11515",2020,15,586,111,95,"51.490645","-0.014582","Mudchute DLR, Cubitt Town",206
"11516",2020,15,587,224,222,"51.50964","-0.08497","Monument Street, Monument",446
"11517",2020,15,588,80,80,"51.52959","-0.0801","Hoxton Street, Hoxton",160
"11518",2020,15,589,370,407,"51.487196","-0.179369","Drayton Gardens, West Chelsea",777
"11519",2020,15,590,116,110,"51.53256","-0.16862","Greenberry Street, St.John's Wood",226
"11520",2020,15,592,108,101,"51.5171","-0.18377","Bishop's Bridge Road East, Bayswater",209
"11521",2020,15,593,49,59,"51.531066","-0.11934","Northdown Street, King's Cross",108
"11522",2020,15,594,54,47,"51.513875","-0.117774","Kingsway Southbound, Strand",101
"11523",2020,15,595,176,165,"51.493267","-0.21985","Hammersmith Road, Hammersmith",341
"11524",2020,15,596,237,245,"51.472817","-0.199783","Parson's Green , Parson's Green",482
"11525",2020,15,597,205,203,"51.473471","-0.20782","Fulham Park Road, Fulham",408
"11526",2020,15,598,216,227,"51.494499","-0.228188","Southerton Road, Hammersmith",443
"11527",2020,15,599,128,132,"51.485743","-0.223616","Manbre Road, Hammersmith",260
"11528",2020,15,600,371,370,"51.481747","-0.124642","South Lambeth Road, Vauxhall",741
"11529",2020,15,601,206,203,"51.514767","-0.225787","BBC White City, White City",409
"11530",2020,15,602,236,239,"51.472993","-0.133972","Union Grove, Wandsworth Road",475
"11531",2020,15,603,253,256,"51.477839","-0.116493","Caldwell Street, Stockwell",509
"11532",2020,15,604,94,83,"51.538792","-0.138535","St Martins Close, Camden Town",177
"11533",2020,15,605,145,147,"51.520331","-0.163667","Seymour Place, Marylebone",292
"11534",2020,15,606,53,64,"51.504199","-0.210941","Addison Road, Holland Park",117
"11535",2020,15,607,230,242,"51.468814","-0.210279","Putney Bridge Station, Fulham",472
"11536",2020,15,608,29,25,"51.491093","-0.216493","Colet Gardens, Hammersmith",54
"11537",2020,15,609,207,207,"51.46512358","-0.157788279","Sugden Road, Clapham",414
"11538",2020,15,610,337,331,"51.48256792","-0.172078187","Danvers Street, West Chelsea",668
"11539",2020,15,611,225,227,"51.50646524","-0.208486599","Princedale Road , Holland Park",452
"11540",2020,15,612,275,285,"51.46925984","-0.141812513","Wandsworth Rd, Isley Court, Wandsworth Road",560
"11541",2020,15,613,312,302,"51.50403821","-0.217400093","Woodstock Grove, Shepherd's Bush",614
"11542",2020,15,614,86,84,"51.47817208","-0.144690541","Bradmead, Battersea Park",170
"11543",2020,15,615,262,251,"51.4768851","-0.215895601","Finlay Street, Fulham",513
"11544",2020,15,616,207,204,"51.48102131","-0.209973497","Aintree Street, Fulham",411
"11545",2020,15,617,96,86,"51.47107905","-0.207842908","Elysium Place, Fulham",182
"11546",2020,15,618,246,246,"51.47625965","-0.193254007","Eel Brook Common, Walham Green",492
"11547",2020,15,619,164,175,"51.4737636","-0.197010096","Irene Road, Parsons Green",339
"11548",2020,15,620,172,170,"51.47518024","-0.167160736","Surrey Lane, Battersea",342
"11549",2020,15,621,189,197,"51.46086446","-0.187427294","Wandsworth Town Station, Wandsworth",386
"11550",2020,15,622,203,217,"51.50748124","-0.205535908","Lansdowne Road, Ladbroke Grove",420
"11551",2020,15,623,39,42,"51.46193072","-0.180791784","Nantes Close, Wandsworth",81
"11552",2020,15,624,186,194,"51.4729184","-0.132102704","Courland Grove, Wandsworth Road",380
"11553",2020,15,625,910,912,"51.47761941","-0.149551631","Queen's Circus, Battersea Park",1822
"11554",2020,15,626,224,221,"51.48438657","-0.20481514","Normand Park, West Kensington",445
"11555",2020,15,627,70,76,"51.4687905","-0.158230901","Holden Street, Battersea",146
"11556",2020,15,628,297,300,"51.46881971","-0.184318843","William Morris Way, Sands End",597
"11557",2020,15,629,67,84,"51.45995384","-0.190184054","Morie Street, Wandsworth",151
"11558",2020,15,630,221,238,"51.47073264","-0.126994068","Clarence Walk, Stockwell",459
"11559",2020,15,631,177,161,"51.4795017","-0.141770709","Battersea Park Road, Nine Elms",338
"11560",2020,15,632,90,92,"51.47053858","-0.163041605","Sheepcote Lane, Battersea",182
"11561",2020,15,633,243,255,"51.48959104","-0.209378594","Vereker Road, West Kensington",498
"11562",2020,15,634,131,126,"51.49434708","-0.215804559","Brook Green South, Brook Green",257
"11563",2020,15,635,144,151,"51.48606206","-0.214428378","Greyhound Road, Hammersmith",295
"11564",2020,15,636,105,93,"51.46706414","-0.193502076","South Park, Sands End",198
"11565",2020,15,637,179,169,"51.45787019","-0.174691623","Spencer Park, Wandsworth Common",348
"11566",2020,15,638,212,221,"51.46663393","-0.169821175","Falcon Road, Clapham Junction",433
"11567",2020,15,639,175,181,"51.48357068","-0.202038682","Coomer Place, West Kensington",356
"11568",2020,15,640,210,230,"51.47286577","-0.148059277","Silverthorne Road, Battersea",440
"11569",2020,15,641,177,190,"51.49824168","-0.117495865","Archbishop's Park, Waterloo",367
"11570",2020,15,642,98,100,"51.46916161","-0.174485792","Fawcett Close, Battersea",198
"11571",2020,15,643,158,154,"51.5190427","-0.204764421","All Saints' Road, Portobello",312
"11572",2020,15,644,190,199,"51.48373225","-0.223852256","Rainville Road, Hammersmith",389
"11573",2020,15,645,116,107,"51.50173215","-0.100292412","Great Suffolk Street, The Borough",223
"11574",2020,15,646,261,282,"51.49886563","-0.137424571","Buckingham Gate, Westminster",543
"11575",2020,15,647,178,183,"51.50035306","-0.217515071","Richmond Way, Shepherd's Bush",361
"11576",2020,15,648,115,113,"51.46904022","-0.19627483","Peterborough Road, Sands End",228
"11577",2020,15,649,178,200,"51.48180515","-0.18027465","World's End Place, West Chelsea",378
"11578",2020,15,650,221,226,"51.51687069","-0.213872396","St. Mark's Road, North Kensington",447
"11579",2020,15,651,170,147,"51.48089844","-0.183853573","Thorndike Close, West Chelsea",317
"11580",2020,15,652,71,75,"51.51148696","-0.218190203","Evesham Street, Avondale",146
"11581",2020,15,653,212,218,"51.47084722","-0.17070367","Simpson Street, Clapham Junction",430
"11582",2020,15,654,197,197,"51.48267821","-0.117661574","Ashmole Estate, Oval",394
"11583",2020,15,655,131,127,"51.48294452","-0.219346128","Crabtree Lane, Fulham",258
"11584",2020,15,656,90,81,"51.46841875","-0.199135704","Broomhouse Lane, Parsons Green",171
"11585",2020,15,657,198,188,"51.4996806","-0.221791552","Blythe Road West, Shepherd's Bush",386
"11586",2020,15,658,675,670,"51.47729232","-0.16478637","Ethelburga Estate, Battersea Park",1345
"11587",2020,15,659,169,148,"51.511934","-0.10307894","Blackfriars Station, St. Paul's",317
"11588",2020,15,660,96,113,"51.49087074","-0.206029743","West Kensington Station, West Kensington",209
"11589",2020,15,661,346,353,"51.51632095","-0.202608612","All Saints Church, Portobello",699
"11590",2020,15,662,236,228,"51.48498496","-0.167919869","Phene Street, Chelsea",464
"11591",2020,15,663,107,108,"51.51323001","-0.211593602","Clarendon Road, Avondale",215
"11592",2020,15,664,295,291,"51.474376","-0.155442787","Austin Road, Battersea Park",586
"11593",2020,15,665,152,158,"51.46108367","-0.191722864","Smugglers Way, Wandsworth",310
"11594",2020,15,666,228,209,"51.49610093","-0.208158259","Olympia Way, Olympia",437
"11595",2020,15,667,216,227,"51.5015946","-0.222293381","Shepherd's Bush Road North, Shepherd's Bush",443
"11596",2020,15,668,410,436,"51.49422354","-0.236769936","Ravenscourt Park Station, Hammersmith",846
"11597",2020,15,669,142,156,"51.47614939","-0.1232585","Teversham Lane, Stockwell",298
"11598",2020,15,670,180,200,"51.46718562","-0.152248582","Ashley Crescent, Battersea",380
"11599",2020,15,671,181,178,"51.475089","-0.201968","Parsons Green Station, Parsons Green",359
"11600",2020,15,673,243,253,"51.46517078","-0.18038939","Hibbert Street, Battersea",496
"11601",2020,15,674,162,155,"51.53546778","-0.11619105","Carnegie Street, King's Cross",317
"11602",2020,15,675,180,196,"51.46348914","-0.182126248","Usk Road, Clapham Junction",376
"11603",2020,15,676,222,230,"51.47787084","-0.126874471","Hartington Road, Stockwell",452
"11604",2020,15,677,131,120,"51.46866929","-0.146544642","Heath Road, Battersea",251
"11605",2020,15,678,66,79,"51.46231278","-0.211468596","Esmond Street, Putney",145
"11606",2020,15,679,104,99,"51.47453545","-0.170210533","Orbel Street, Battersea",203
"11607",2020,15,680,241,237,"51.47768469","-0.170329317","Westbridge Road, Battersea",478
"11608",2020,15,681,228,235,"51.47303687","-0.214749808","Bishop's Avenue, Fulham",463
"11609",2020,15,682,415,424,"51.48810829","-0.22660621","Crisp Road, Hammersmith",839
"11610",2020,15,683,214,204,"51.46506424","-0.163750945","Dorothy Road, Clapham Junction",418
"11611",2020,15,684,348,351,"51.45475251","-0.195197203","Neville Gill Close, Wandsworth",699
"11612",2020,15,685,174,194,"51.46067005","-0.198735357","Osiers Road, Wandsworth",368
"11613",2020,15,686,115,102,"51.48814438","-0.222456468","Beryl Road, Hammersmith",217
"11614",2020,15,687,166,169,"51.49760804","-0.21145598","Maclise Road, Olympia",335
"11615",2020,15,688,81,92,"51.46095151","-0.20066766","Northfields, Wandsworth",173
"11616",2020,15,689,80,81,"51.45922541","-0.180884959","Spanish Road, Clapham Junction",161
"11617",2020,15,690,97,90,"51.47047503","-0.152130083","Stanley Grove, Battersea",187
"11618",2020,15,691,250,284,"51.47946386","-0.195777222","Erin Close, Walham Green",534
"11619",2020,15,692,321,322,"51.54211855","-0.028941601","Cadogan Close, Victoria Park",643
"11620",2020,15,693,157,168,"51.464786","-0.215618902","Felsham Road, Putney",325
"11621",2020,15,694,237,229,"51.46071722","-0.216526155","Putney Rail Station, Putney",466
"11622",2020,15,695,489,495,"51.53638435","-0.102757578","Islington Green, Angel",984
"11623",2020,15,696,112,93,"51.48728535","-0.217995921","Charing Cross Hospital, Hammersmith",205
"11624",2020,15,697,164,159,"51.53639219","-0.112721065","Charlotte Terrace, Angel",323
"11625",2020,15,698,204,180,"51.53908372","-0.070329419","Shoreditch Court, Haggerston",384
"11626",2020,15,699,100,82,"51.5366541","-0.07023031","Belford House, Haggerston",182
"11627",2020,15,700,191,174,"51.47696496","-0.174347066","Battersea Church Road, Battersea",365
"11628",2020,15,701,353,361,"51.47287627","-0.176267008","Vicarage Crescent, Battersea",714
"11629",2020,15,702,158,158,"51.52868155","-0.065550321","Durant Street, Bethnal Green",316
"11630",2020,15,703,100,90,"51.51505991","-0.10534448","St. Bride Street, Holborn",190
"11631",2020,15,704,116,102,"51.45682071","-0.202802098","Mexfield Road, East Putney",218
"11632",2020,15,705,160,166,NA,NA,NA,326
"11633",2020,15,706,124,135,"51.50215353","-0.083632928","Snowsfields, London Bridge",259
"11634",2020,15,707,122,125,"51.49021762","-0.215087092","Barons Court Station, West Kensington",247
"11635",2020,15,708,166,176,"51.46161068","-0.21614583","Disraeli Road, Putney",342
"11636",2020,15,709,108,121,"51.46321128","-0.215550761","Montserrat Road , Putney",229
"11637",2020,15,710,405,418,"51.47439218","-0.163347594","Albert Bridge Road, Battersea Park",823
"11638",2020,15,711,122,125,"51.48335692","-0.216305546","Everington Street, Fulham",247
"11639",2020,15,712,243,226,"51.51854104","-0.034903714","Mile End Stadium, Mile End",469
"11640",2020,15,713,247,258,"51.54100708","-0.14326094","Hawley Crescent, Camden Town",505
"11641",2020,15,714,74,62,"51.47311696","-0.137235175","Stewart's Road, Wandsworth Road",136
"11642",2020,15,715,116,104,"51.51563007","-0.049067243","Aylward Street, Stepney",220
"11643",2020,15,716,152,146,"51.51542791","-0.02356501","Stainsby Road , Poplar",298
"11644",2020,15,717,359,361,"51.53658514","-0.075885686","Dunston Road , Haggerston",720
"11645",2020,15,718,163,195,"51.53571683","-0.060291813","Ada Street, Hackney Central",358
"11646",2020,15,719,361,393,"51.53642464","-0.054162264","Victoria Park Road, Hackney Central",754
"11647",2020,15,720,180,182,"51.48724429","-0.205279052","Star Road, West Kensington",362
"11648",2020,15,721,169,179,"51.53603947","-0.026262677","Wendon Street, Old Ford",348
"11649",2020,15,722,93,95,"51.52458353","-0.058631453","Finnis Street, Bethnal Green",188
"11650",2020,15,723,333,331,"51.46822047","-0.190346493","Stephendale Road, Sands End",664
"11651",2020,15,724,145,134,"51.45799126","-0.184806157","Alma Road, Wandsworth",279
"11652",2020,15,725,270,279,"51.491327","-0.096518684","Walworth Square, Walworth",549
"11653",2020,15,726,177,181,"51.47505096","-0.150908371","Alfreda Street, Battersea Park",358
"11654",2020,15,727,287,286,"51.47569809","-0.20587627","Chesilton Road, Fulham",573
"11655",2020,15,728,156,160,"51.46199911","-0.206240805","Putney Bridge Road, East Putney",316
"11656",2020,15,729,205,200,"51.47893931","-0.208485293","St. Peter's Terrace, Fulham",405
"11657",2020,15,730,264,270,"51.49208492","-0.229116862","Bridge Avenue, Hammersmith",534
"11658",2020,15,731,129,134,"51.47727637","-0.189210466","Michael Road, Walham Green",263
"11659",2020,15,732,349,352,"51.50630441","-0.087262995","Duke Street Hill, London Bridge",701
"11660",2020,15,733,93,92,"51.50542628","-0.150817316","Park Lane, Mayfair",185
"11661",2020,15,734,139,145,"51.46230566","-0.175407201","Plough Terrace, Clapham Junction",284
"11662",2020,15,735,72,83,"51.46489445","-0.17302926","Grant Road East, Clapham Junction",155
"11663",2020,15,736,84,83,"51.50659035","-0.216104479","Queensdale Road, Shepherd's Bush",167
"11664",2020,15,737,331,377,"51.47993289","-0.19411695","Fulham Broadway, Walham Green",708
"11665",2020,15,738,154,143,"51.47514228","-0.187278987","Imperial Road, Sands End",297
"11666",2020,15,739,224,217,"51.48176572","-0.185273723","Hortensia Road, West Brompton",441
"11667",2020,15,740,94,102,"51.51092871","-0.214594781","Sirdar Road, Avondale",196
"11668",2020,15,741,70,56,"51.5129814","-0.219486603","Freston Road, Avondale",126
"11669",2020,15,742,214,231,"51.51510818","-0.208565479","Blenheim Crescent, Ladbroke Grove",445
"11670",2020,15,743,85,89,"51.46079243","-0.212607684","Oxford Road, Putney",174
"11671",2020,15,744,79,94,"51.46745485","-0.172293499","Ingrave Street, Clapham Junction",173
"11672",2020,15,745,126,115,"51.47816972","-0.18243547","Upcerne Road, West Chelsea",241
"11673",2020,15,746,232,235,"51.4795738","-0.17903854","Lots Road, West Chelsea",467
"11674",2020,15,747,171,166,"51.48796408","-0.161765173","Ormonde Gate, Chelsea",337
"11675",2020,15,748,213,206,"51.53727795","-0.079201849","Hertford Road, De Beauvoir Town",419
"11676",2020,15,749,340,366,"51.53932857","-0.074284675","Haggerston Road, Haggerston",706
"11677",2020,15,750,78,82,"51.4710956","-0.157850096","Culvert Road, Battersea",160
"11678",2020,15,751,49,45,"51.51612862","-0.120909408","Newton Street, Covent Garden",94
"11679",2020,15,754,56,63,"51.5129006","-0.214762686","Grenfell Road, Avondale",119
"11680",2020,15,755,261,248,"51.48512191","-0.174971902","The Vale, Chelsea",509
"11681",2020,15,756,285,284,"51.47515398","-0.159169801","Prince of Wales Drive, Battersea Park",569
"11682",2020,15,757,325,324,"51.48795853","-0.187404506","Harcourt Terrace, West Brompton",649
"11683",2020,15,758,218,217,"51.51787005","-0.201005397","Westbourne Park Road, Portobello",435
"11684",2020,15,759,69,69,"51.52456169","-0.165668686","Broadley Terrace, Marylebone",138
"11685",2020,15,760,73,73,"51.52526975","-0.163795009","Rossmore Road, Marylebone",146
"11686",2020,15,761,92,86,"51.48321729","-0.211860644","Humbolt Road, Fulham",178
"11687",2020,15,762,655,677,"51.50070305","-0.129698963","Storey's Gate, Westminster",1332
"11688",2020,15,763,208,204,"51.52059714","-0.032566533","Mile End Park Leisure Centre, Mile End",412
"11689",2020,15,764,186,200,"51.46239255","-0.16829214","St. John's Road, Clapham Junction",386
"11690",2020,15,765,112,114,"51.46760141","-0.20682737","Ranelagh Gardens, Fulham",226
"11691",2020,15,766,219,229,"51.45752945","-0.192165613","Ram Street, Wandsworth",448
"11692",2020,15,767,71,77,"51.45705988","-0.200806304","Santos Road, Wandsworth",148
"11693",2020,15,768,492,513,"51.46134382","-0.159322467","Clapham Common North Side, Clapham Common",1005
"11694",2020,15,769,202,203,"51.473611","-0.191803","Sandilands Road, Walham Green",405
"11695",2020,15,770,192,191,"51.491026","-0.209121","Gwendwr Road, West Kensington",383
"11696",2020,15,771,79,91,"51.509224","-0.216016","Rifle Place, Avondale",170
"11697",2020,15,772,333,340,"51.47250956","-0.122831913","Binfield Road, Stockwell",673
"11698",2020,15,773,134,120,"51.511891","-0.107349","Tallis Street, Temple",254
"11699",2020,15,774,140,116,"51.470131","-0.20464","Hurlingham Park, Parsons Green",256
"11700",2020,15,775,132,145,"51.496664","-0.223868","Little Brook Green, Brook Green",277
"11701",2020,15,776,236,242,"51.460333","-0.167029","Abyssinia Close, Clapham Junction",478
"11702",2020,15,777,129,122,"51.4619230679","-0.165297856693","Limburg Road, Clapham Junction",251
"11703",2020,15,779,101,101,"51.514449","-0.077178979","Houndsditch, Aldgate",202
"11704",2020,15,780,442,438,"51.474665","-0.18316517","Imperial Wharf Station, Sands End",880
"11705",2020,15,781,97,71,"51.495898","-0.173009","Victoria & Albert Museum, South Kensington",168
"11706",2020,15,782,249,243,"51.483911","-0.19760944","Halford Road, West Kensington",492
"11707",2020,15,783,235,238,"51.5403115","-0.021630359","Monier Road, Hackney Wick",473
"11708",2020,15,784,499,525,"51.546326","-0.00993526","East Village, Queen Elizabeth Olympic Park",1024
"11709",2020,15,785,651,641,"51.54094","-0.010510565","Aquatic Centre, Queen Elizabeth Olympic Park",1292
"11710",2020,15,786,529,524,"51.549369","-0.015717614","Lee Valley VeloPark, Queen Elizabeth Olympic Park",1053
"11711",2020,15,787,420,435,"51.546805","-0.01469126","Timber Lodge, Queen Elizabeth Olympic Park",855
"11712",2020,15,789,674,674,"51.538718","-0.011889482","Podium, Queen Elizabeth Olympic Park",1348
"11713",2020,15,790,226,230,"51.541793","-0.00481","Stratford Station, Stratford",456
"11714",2020,15,792,121,112,"51.505461","-0.10454093","Blackfriars Road, Southwark",233
"11715",2020,15,793,92,98,"51.528279","-0.11955857","Cromer Street, Bloomsbury",190
"11716",2020,15,795,45,39,"51.527068","-0.13186102","Euston Square Gardens, Euston",84
"11717",2020,15,796,109,105,"51.524","-0.12640984","Coram Street, Bloomsbury",214
"11718",2020,15,797,64,59,"51.5293","-0.12827903","Ossulston Street, Somers Town",123
"11719",2020,15,798,87,69,"51.5301998755","-0.122299440803","Birkenhead Street, King's Cross",156
"11720",2020,15,799,96,84,"51.4976984561","-0.137598896295","Kings Gate House, Westminster",180
"11721",2020,15,801,96,92,"51.5052241745","-0.0980318118664","Lavington Street, Bankside",188
"11722",2020,15,802,236,255,"51.4765900593","-0.118256789081","Albert Square, Stockwell",491
"11723",2020,15,803,83,86,"51.5054099403","-0.0983410884509","Southwark Street, Bankside",169
"11724",2020,15,804,77,145,"51.5346677396","-0.125078652873","Good's Way, King's Cross",222
"11725",2020,15,806,160,171,"51.5372405623","-0.124807385707","Handyside Street, King's Cross",331
"11726",2020,15,807,438,432,"51.5212","-0.20888818","Bevington Road West, North Kensington",870
"11727",2020,15,809,66,59,"51.5162778834","-0.118272991635","Lincoln's Inn Fields, Holborn",125
"11728",2020,15,810,103,93,"51.5067252868","-0.0988072461627","Tate Modern, Bankside",196
"11729",2020,15,811,486,489,"51.5057030357","-0.0277727426235","Westferry Circus, Canary Wharf",975
"11730",2020,15,812,276,280,"51.5487311915","-0.0226065549321","Here East North, Queen Elizabeth Olympic Park",556
"11731",2020,15,813,38,86,"51.4878074485","-0.122759625866","New Spring Gardens Walk, Vauxhall",124
"11732",2020,15,814,198,203,"51.4714330677","-0.123670735702","Clapham Road, Lingham Street, Stockwell",401
"11733",2020,15,815,438,425,"51.5000891978","-0.116628700672","Lambeth Palace Road, Waterloo",863
"11734",2020,15,816,109,115,"51.5465327935","-0.0205975904647","Here East South, Queen Elizabeth Olympic Park",224
"11735",2020,15,817,324,326,"51.4813354746","-0.138212295869","Riverlight South, Nine Elms",650
"11736",2020,15,818,46,50,"51.501513","-0.12382322","Westminster Pier, Westminster",96
"11737",2020,15,819,98,89,"51.50621","-0.114842","Belvedere Road 2, South Bank",187
"11738",2020,15,820,144,151,"51.492807","-0.091938","Victory Place, Walworth",295
"11739",2020,15,821,741,707,"51.4835074867","-0.147714557371","Battersea Power Station, Battersea Park",1448
"11740",2020,15,826,149,153,"51.496863","-0.1429434","Allington Street, Victoria",302
"11741",2020,15,827,256,252,"51.479601","-0.11147178","Cranmer Road, Stockwell",508
"11742",2020,15,828,189,196,"51.473874","-0.11258096","Normandy Road, Stockwell",385
"11743",2020,15,829,120,120,"51.469217","-0.11268674","Wynne Road, Stockwell",240
"11744",2020,15,830,186,191,"51.469202","-0.11902256","Sidney Road, Stockwell",377
"11745",2020,15,831,194,221,"51.466232","-0.11317995","St John's Crescent, Brixton",415
"11746",2020,15,832,350,368,"51.464019","-0.11578197","Ferndale Road, Brixton",718
"11747",2020,15,833,539,569,"51.460232","-0.11537509","Saltoun Road, Brixton",1108
"11748",2020,15,834,419,423,"51.477966","-0.14785703","Gas Holders, Battersea Park",842
"11749",2020,15,835,80,78,"51.516785","-0.10494775","Farringdon Street, Holborn",158
"11750",2020,15,836,217,215,"51.541596","-0.12544145","York Way, Kings Cross",432
"11751",2020,15,838,71,65,"51.518093","-0.0914017","Fore Street Avenue, Guildhall",136
"11752",2020,15,839,198,203,"51.508033","-0.10682363","Sea Containers, South Bank",401
"11753",2020,16,1,124,95,"51.52916347","-0.109970527","River Street , Clerkenwell",219
"11754",2020,16,2,239,269,"51.49960695","-0.197574246","Phillimore Gardens, Kensington",508
"11755",2020,16,3,42,37,"51.52128377","-0.084605692","Christopher Street, Liverpool Street",79
"11756",2020,16,4,59,63,"51.53005939","-0.120973687","St. Chad's Street, King's Cross",122
"11757",2020,16,5,188,174,"51.49313","-0.156876","Sedding Street, Sloane Square",362
"11758",2020,16,6,161,145,"51.51811784","-0.144228881","Broadcasting House, Marylebone",306
"11759",2020,16,7,176,177,"51.53430039","-0.1680743","Charlbert Street, St. John's Wood",353
"11760",2020,16,8,408,423,"51.529857","-0.18348604","Maida Vale, Maida Vale",831
"11761",2020,16,9,167,143,"51.5073853","-0.096440751","New Globe Walk, Bankside",310
"11762",2020,16,10,76,78,"51.50597426","-0.092754157","Park Street, Bankside",154
"11763",2020,16,11,143,143,"51.52395143","-0.122502346","Brunswick Square, Bloomsbury",286
"11764",2020,16,12,101,82,"51.52168078","-0.130431727","Malet Street, Bloomsbury",183
"11765",2020,16,13,66,67,"51.51991453","-0.136039674","Scala Street, Fitzrovia",133
"11766",2020,16,14,226,220,"51.52994371","-0.123616824","Belgrove Street , King's Cross",446
"11767",2020,16,15,87,68,"51.51772703","-0.127854211","Great Russell Street, Bloomsbury",155
"11768",2020,16,16,106,101,"51.52635795","-0.125979294","Cartwright Gardens , Bloomsbury",207
"11769",2020,16,17,168,160,"51.5216612","-0.109006325","Hatton Wall, Holborn",328
"11770",2020,16,18,148,132,"51.51477076","-0.12221963","Drury Lane, Covent Garden",280
"11771",2020,16,19,26,26,"51.52505093","-0.131161087","Taviton Street, Bloomsbury",52
"11772",2020,16,20,13,14,"51.527326","-0.13605286","Drummond Street , Euston",27
"11773",2020,16,21,35,29,"51.53007835","-0.13884627","Hampstead Road (Cartmel), Euston",64
"11774",2020,16,22,183,191,"51.5222641","-0.114079481","Northington Street , Holborn",374
"11775",2020,16,23,68,50,"51.51943538","-0.119123345","Red Lion Square, Holborn",118
"11776",2020,16,24,118,103,"51.51908011","-0.124678402","British Museum, Bloomsbury",221
"11777",2020,16,25,79,48,"51.5288338","-0.132250369","Doric Way , Somers Town",127
"11778",2020,16,26,78,86,"51.52728093","-0.11829517","Ampton Street , Clerkenwell",164
"11779",2020,16,27,70,58,"51.51382102","-0.107927706","Bouverie Street, Temple",128
"11780",2020,16,28,222,213,"51.52351808","-0.143613641","Bolsover Street, Fitzrovia",435
"11781",2020,16,29,212,195,"51.513735","-0.193487","Hereford Road, Bayswater",407
"11782",2020,16,30,114,96,"51.52915444","-0.093421615","Windsor Terrace, Hoxton",210
"11783",2020,16,31,99,144,"51.52953709","-0.083353323","Fanshaw Street, Hoxton",243
"11784",2020,16,32,189,198,"51.52469624","-0.084439283","Leonard Circus , Shoreditch",387
"11785",2020,16,33,131,126,"51.5156","-0.070056","Central House, Aldgate",257
"11786",2020,16,34,114,118,"51.5341235","-0.129386874","Pancras Road, King's Cross",232
"11787",2020,16,36,526,532,"51.50173726","-0.184980612","De Vere Gardens, Kensington",1058
"11788",2020,16,37,172,176,"51.49159394","-0.192369256","Penywern Road, Earl's Court",348
"11789",2020,16,38,135,146,"51.4973875","-0.197245586","Abingdon Villas, Kensington",281
"11790",2020,16,39,224,243,"51.5263778","-0.078130921","Shoreditch High Street, Shoreditch",467
"11791",2020,16,40,147,148,"51.52127071","-0.0755789","Commercial Street, Shoreditch",295
"11792",2020,16,41,23,19,"51.520955","-0.083493552","Pindar Street, Liverpool Street",42
"11793",2020,16,42,150,145,"51.53099181","-0.093903825","Wenlock Road , Hoxton",295
"11794",2020,16,43,187,185,"51.52026","-0.157183945","Crawford Street, Marylebone",372
"11795",2020,16,44,114,114,"51.51073687","-0.144165239","Bruton Street, Mayfair",228
"11796",2020,16,45,67,60,"51.522511","-0.162298","Boston Place, Marylebone",127
"11797",2020,16,47,482,480,"51.52334476","-0.183846408","Warwick Avenue Station, Maida Vale",962
"11798",2020,16,48,132,148,"51.51248445","-0.099141408","Godliman Street, St. Paul's",280
"11799",2020,16,49,106,106,"51.50706909","-0.145904427","Curzon Street, Mayfair",212
"11800",2020,16,50,94,77,"51.52867339","-0.087459376","East Road, Hoxton",171
"11801",2020,16,51,82,77,"51.52671796","-0.104298194","Finsbury Library , Finsbury",159
"11802",2020,16,52,145,144,"51.52295439","-0.094934859","Roscoe Street, St. Luke's",289
"11803",2020,16,53,57,51,"51.5099923","-0.143495266","Grafton Street, Mayfair",108
"11804",2020,16,54,153,147,"51.52174785","-0.094475072","Golden Lane, Barbican",300
"11805",2020,16,55,104,106,"51.51707521","-0.086685542","Finsbury Circus, Liverpool Street",210
"11806",2020,16,56,157,152,"51.52058381","-0.154701411","Paddington Street, Marylebone",309
"11807",2020,16,57,151,150,"51.52334672","-0.120202614","Guilford Street , Bloomsbury",301
"11808",2020,16,58,109,119,"51.52452699","-0.079248081","New Inn Yard, Shoreditch",228
"11809",2020,16,60,93,81,"51.52644828","-0.172190727","Lisson Grove, St. John's Wood",174
"11810",2020,16,61,128,122,"51.49738251","-0.089446947","Great Dover Street, The Borough",250
"11811",2020,16,62,117,117,"51.4907579","-0.106323685","Cotton Garden Estate, Kennington",234
"11812",2020,16,63,96,110,"51.53089041","-0.089782579","Murray Grove , Hoxton",206
"11813",2020,16,64,134,166,"51.50946212","-0.124749274","William IV Street, Strand",300
"11814",2020,16,65,97,79,NA,NA,NA,176
"11815",2020,16,66,141,144,"51.51795029","-0.108657431","Holborn Circus, Holborn",285
"11816",2020,16,67,49,47,"51.51882555","-0.108028472","Hatton Garden, Holborn",96
"11817",2020,16,68,147,136,"51.52059681","-0.116688468","Theobald's Road , Holborn",283
"11818",2020,16,69,48,39,"51.5262363","-0.134407652","Euston Road, Euston",87
"11819",2020,16,70,50,48,"51.53136059","-0.117069978","Calshot Street , King's Cross",98
"11820",2020,16,71,179,142,"51.5154186","-0.098850915","Newgate Street , St. Paul's",321
"11821",2020,16,72,128,133,"51.52352001","-0.108340165","Farringdon Lane, Clerkenwell",261
"11822",2020,16,73,156,170,"51.52572618","-0.088486188","Old Street Station, St. Luke's",326
"11823",2020,16,74,444,445,"51.48591714","-0.124469948","Vauxhall Cross, Vauxhall",889
"11824",2020,16,75,108,109,"51.53219984","-0.105480698","Torrens Street, Angel",217
"11825",2020,16,76,109,93,"51.52559505","-0.144083893","Longford Street, The Regent's Park",202
"11826",2020,16,77,174,164,"51.52341837","-0.124121774","Russell Square Station, Bloomsbury",338
"11827",2020,16,78,103,98,"51.52486887","-0.099489485","Sadlers Sports Centre, Finsbury",201
"11828",2020,16,79,62,73,"51.511726","-0.11385596","Arundel Street, Temple",135
"11829",2020,16,80,153,158,"51.50069361","-0.102091246","Webber Street , Southwark",311
"11830",2020,16,81,145,145,"51.52025302","-0.141327271","Great Titchfield Street, Fitzrovia",290
"11831",2020,16,82,60,58,"51.514274","-0.111257","Chancery Lane, Holborn",118
"11832",2020,16,83,169,187,"51.50963938","-0.131510949","Panton Street, West End",356
"11833",2020,16,84,24,19,"51.51593725","-0.111778348","Breams Buildings, Holborn",43
"11834",2020,16,85,309,314,"51.50064702","-0.078600401","Tanner Street, Bermondsey",623
"11835",2020,16,86,116,120,"51.48947903","-0.115156562","Sancroft Street, Vauxhall",236
"11836",2020,16,87,81,78,"51.51646835","-0.079684557","Devonshire Square, Liverpool Street",159
"11837",2020,16,88,160,163,"51.51858757","-0.132053392","Bayley Street , Bloomsbury",323
"11838",2020,16,89,113,117,"51.5262503","-0.123509611","Tavistock Place, Bloomsbury",230
"11839",2020,16,90,16,19,"51.53301907","-0.139174593","Harrington Square 1, Camden Town",35
"11840",2020,16,91,178,184,"51.49368637","-0.111014912","Walnut Tree Walk, Vauxhall",362
"11841",2020,16,92,104,100,"51.49889832","-0.100440521","Borough Road, Elephant & Castle",204
"11842",2020,16,93,192,200,"51.53440868","-0.109025404","Cloudesley Road, Angel",392
"11843",2020,16,94,319,311,"51.49506109","-0.085814489","Bricklayers Arms, Borough",630
"11844",2020,16,95,197,200,"51.5208417","-0.097340162","Aldersgate Street, Barbican",397
"11845",2020,16,96,91,92,"51.53095071","-0.078505384","Falkirk Street, Hoxton",183
"11846",2020,16,97,257,253,"51.49792478","-0.183834706","Gloucester Road (North), Kensington",510
"11847",2020,16,98,199,197,"51.52554222","-0.138231303","Hampstead Road, Euston",396
"11848",2020,16,99,319,321,"51.51457763","-0.158264483","Old Quebec Street, Marylebone",640
"11849",2020,16,100,218,184,"51.49043573","-0.122806861","Albert Embankment, Vauxhall",402
"11850",2020,16,101,204,186,"51.51155322","-0.0929401","Queen Street 1, Bank",390
"11851",2020,16,102,118,114,"51.51340693","-0.076793375","Jewry Street, Aldgate",232
"11852",2020,16,103,155,156,"51.50472376","-0.192538767","Vicarage Gate, Kensington",311
"11853",2020,16,104,138,120,"51.51159481","-0.077121322","Crosswall, Tower",258
"11854",2020,16,105,267,276,"51.51552971","-0.190240716","Westbourne Grove, Bayswater",543
"11855",2020,16,106,57,57,"51.51410514","-0.147301667","Woodstock Street, Mayfair",114
"11856",2020,16,107,159,176,"51.52600832","-0.096317627","Finsbury Leisure Centre, St. Luke's",335
"11857",2020,16,108,141,132,"51.49812559","-0.132102166","Abbey Orchard Street, Westminster",273
"11858",2020,16,109,213,197,"51.51563144","-0.132328837","Soho Square , Soho",410
"11859",2020,16,110,200,198,"51.53304322","-0.172528678","Wellington Road, St. John's Wood",398
"11860",2020,16,111,493,517,"51.5100172","-0.157275636","Park Lane , Hyde Park",1010
"11861",2020,16,112,64,65,"51.51580998","-0.105270275","Stonecutter Street, Holborn",129
"11862",2020,16,113,216,237,"51.49646288","-0.183289032","Gloucester Road (Central), South Kensington",453
"11863",2020,16,114,590,573,"51.52451738","-0.158963647","Park Road (Baker Street), The Regent's Park",1163
"11864",2020,16,115,231,236,"51.51423368","-0.073537654","Braham Street, Aldgate",467
"11865",2020,16,116,207,201,"51.51449962","-0.141423695","Little Argyll Street, West End",408
"11866",2020,16,117,135,136,"51.49288067","-0.114934001","Lollard Street, Vauxhall",271
"11867",2020,16,118,41,76,"51.49582705","-0.13547809","Rochester Row, Westminster",117
"11868",2020,16,119,219,220,"51.52589324","-0.090847761","Bath Street, St. Luke's",439
"11869",2020,16,120,53,43,"51.51573534","-0.093080779","The Guildhall, Guildhall",96
"11870",2020,16,121,85,82,"51.51891348","-0.156166631","Baker Street, Marylebone",167
"11871",2020,16,122,130,119,"51.52111369","-0.078869751","Norton Folgate, Liverpool Street",249
"11872",2020,16,123,100,90,"51.52836014","-0.104724625","St. John Street, Finsbury",190
"11873",2020,16,125,182,173,"51.50069491","-0.094524319","Borough High Street, The Borough",355
"11874",2020,16,126,68,67,"51.51782144","-0.096496865","Museum of London, Barbican",135
"11875",2020,16,127,59,57,"51.51700801","-0.09388536","Wood Street, Guildhall",116
"11876",2020,16,128,213,211,"51.49536226","-0.185296516","Emperor's Gate, South Kensington",424
"11877",2020,16,129,170,156,"51.5118973","-0.137043852","Golden Square, Soho",326
"11878",2020,16,130,474,498,"51.50950627","-0.075459482","Tower Gardens , Tower",972
"11879",2020,16,131,99,90,"51.53300545","-0.136792671","Eversholt Street , Camden Town",189
"11880",2020,16,132,232,293,"51.52364804","-0.074754872","Bethnal Green Road, Shoreditch",525
"11881",2020,16,133,384,388,NA,NA,NA,772
"11882",2020,16,134,426,415,"51.504904","-0.06797","Wapping High Street, Wapping",841
"11883",2020,16,135,167,192,"51.52326004","-0.104708922","Clerkenwell Green, Clerkenwell",359
"11884",2020,16,136,201,194,"51.51196176","-0.097441687","Queen Victoria Street, St. Paul's",395
"11885",2020,16,138,180,194,"51.51227622","-0.157436972","Green Street, Mayfair",374
"11886",2020,16,139,144,134,"51.49488108","-0.117974901","Lambeth Road, Vauxhall",278
"11887",2020,16,140,81,91,"51.52096262","-0.085634242","Finsbury Square , Moorgate",172
"11888",2020,16,141,107,92,"51.51530805","-0.147203711","Chapel Place, Marylebone",199
"11889",2020,16,142,147,163,"51.49372451","-0.198286569","West Cromwell Road, Earl's Court",310
"11890",2020,16,143,187,195,"51.4968865","-0.161203828","Pont Street, Knightsbridge",382
"11891",2020,16,144,274,269,"51.48894022","-0.111435796","Kennington Cross, Kennington",543
"11892",2020,16,145,158,146,"51.50074359","-0.202759212","Ilchester Place, Kensington",304
"11893",2020,16,146,187,186,"51.48836528","-0.129361842","Vauxhall Bridge , Pimlico",373
"11894",2020,16,148,198,197,"51.49211134","-0.138364847","Tachbrook Street, Victoria",395
"11895",2020,16,149,278,289,"51.48478899","-0.110683213","Kennington Road Post Office, Oval",567
"11896",2020,16,150,103,98,"51.49705603","-0.168917077","Holy Trinity Brompton, Knightsbridge",201
"11897",2020,16,151,188,165,"51.51213691","-0.201554966","Chepstow Villas, Notting Hill",353
"11898",2020,16,152,250,254,"51.49217002","-0.101536865","Hampton Street, Walworth",504
"11899",2020,16,153,577,577,"51.511933","-0.174411","Bayswater Road, Hyde Park",1154
"11900",2020,16,154,56,51,"51.50379168","-0.11282408","Waterloo Station 3, Waterloo",107
"11901",2020,16,155,118,131,"51.49586666","-0.191933711","Lexham Gardens, Kensington",249
"11902",2020,16,156,155,173,"51.49443626","-0.092921165","New Kent Road, The Borough",328
"11903",2020,16,157,163,205,"51.50039792","-0.193068385","Wright's Lane, Kensington",368
"11904",2020,16,158,223,201,"51.49085368","-0.196170309","Trebovir Road, Earl's Court",424
"11905",2020,16,159,171,162,"51.51461995","-0.137841333","Great Marlborough Street, Soho",333
"11906",2020,16,160,184,184,"51.50663341","-0.131773845","Waterloo Place, St. James's",368
"11907",2020,16,161,106,113,"51.49234577","-0.141334487","Guildhouse Street, Victoria",219
"11908",2020,16,162,103,88,"51.51760685","-0.121328408","Southampton Place, Holborn",191
"11909",2020,16,163,256,274,"51.4931848","-0.167894973","Sloane Avenue, Knightsbridge",530
"11910",2020,16,164,152,149,"51.515607","-0.183118788","Cleveland Gardens, Bayswater",301
"11911",2020,16,165,71,55,"51.517932","-0.183716959","Orsett Terrace, Bayswater",126
"11912",2020,16,166,288,273,"51.50185512","-0.159237081","Seville Street, Knightsbridge",561
"11913",2020,16,167,118,109,"51.49395092","-0.147624377","Eccleston Place, Victoria",227
"11914",2020,16,168,137,145,"51.50040123","-0.195455928","Argyll Road, Kensington",282
"11915",2020,16,169,359,383,"51.51474612","-0.165164288","Porchester Place, Paddington",742
"11916",2020,16,170,42,45,"51.52784273","-0.108068155","Hardwick Street, Clerkenwell",87
"11917",2020,16,171,217,207,"51.4916156","-0.186753859","Collingham Gardens, Earl's Court",424
"11918",2020,16,172,183,180,"51.49121192","-0.173715911","Sumner Place, South Kensington",363
"11919",2020,16,173,62,59,"51.50486","-0.113001","Waterloo Road, South Bank",121
"11920",2020,16,174,57,53,"51.512529","-0.115163","Strand, Strand",110
"11921",2020,16,175,41,44,"51.521668","-0.079608554","Worship Street, Shoreditch",85
"11922",2020,16,176,169,158,"51.51791921","-0.188098863","Gloucester Terrace, Bayswater",327
"11923",2020,16,177,113,111,"51.49616092","-0.140947636","Ashley Place, Victoria",224
"11924",2020,16,178,231,217,"51.48985626","-0.141923621","Warwick Square, Pimlico",448
"11925",2020,16,180,183,198,"51.5129118","-0.153645496","North Audley Street, Mayfair",381
"11926",2020,16,181,156,157,"51.49941247","-0.152317537","Belgrave Square, Belgravia",313
"11927",2020,16,182,131,129,"51.52202903","-0.165842551","Bell Street , Marylebone",260
"11928",2020,16,183,407,420,"51.482362","-0.13612398","Riverlight North, Nine Elms",827
"11929",2020,16,184,147,132,"51.52071513","-0.14521173","Portland Place, Marylebone",279
"11930",2020,16,185,274,282,"51.48805753","-0.140741432","Alderney Street, Pimlico",556
"11931",2020,16,186,160,151,"51.51733558","-0.175810943","South Wharf Road, Paddington",311
"11932",2020,16,187,259,276,"51.49247977","-0.178433004","Queen's Gate (South), South Kensington",535
"11933",2020,16,188,69,73,"51.5165179","-0.164393768","Nutford Place, Marylebone",142
"11934",2020,16,189,104,84,"51.53166681","-0.109914711","Claremont Square, Angel",188
"11935",2020,16,190,229,221,"51.48997562","-0.132845681","Rampayne Street, Pimlico",450
"11936",2020,16,191,531,502,"51.50311799","-0.153520935","Hyde Park Corner, Hyde Park",1033
"11937",2020,16,192,268,274,"51.51251523","-0.133201961","Wardour Street, Soho",542
"11938",2020,16,193,97,107,"51.50581776","-0.100186337","Bankside Mix, Bankside",204
"11939",2020,16,194,543,588,"51.50462759","-0.091773776","Hop Exchange, The Borough",1131
"11940",2020,16,195,228,232,"51.50724437","-0.106237501","Milroy Walk, South Bank",460
"11941",2020,16,196,79,85,"51.50368837","-0.098497684","Union Street, The Borough",164
"11942",2020,16,197,84,67,"51.50556905","-0.111606696","Stamford Street, South Bank",151
"11943",2020,16,199,179,191,"51.51048489","-0.082989638","Great Tower Street, Monument",370
"11944",2020,16,200,188,181,"51.51492456","-0.066078037","LMU Commercial Road, Whitechapel",369
"11945",2020,16,201,165,162,"51.5225965","-0.161113413","Dorset Square, Marylebone",327
"11946",2020,16,202,260,284,"51.51236389","-0.06954201","Leman Street, Aldgate",544
"11947",2020,16,203,162,151,"51.51821864","-0.100791005","West Smithfield Rotunda, Farringdon",313
"11948",2020,16,204,59,72,"51.52659961","-0.112432615","Margery Street, Clerkenwell",131
"11949",2020,16,206,202,197,"51.518154","-0.062697","New Road 1 , Whitechapel",399
"11950",2020,16,207,123,97,"51.50135267","-0.153194766","Grosvenor Crescent, Belgravia",220
"11951",2020,16,208,76,68,"51.52505151","-0.166304359","Mallory Street, Marylebone",144
"11952",2020,16,209,103,96,"51.49358391","-0.165101392","Denyer Street, Knightsbridge",199
"11953",2020,16,210,144,142,"51.51681444","-0.151926305","Hinde Street, Marylebone",286
"11954",2020,16,211,156,153,"51.49464523","-0.158105512","Cadogan Place, Knightsbridge",309
"11955",2020,16,212,151,111,"51.50658458","-0.199004026","Campden Hill Road, Notting Hill",262
"11956",2020,16,213,976,1000,"51.50274025","-0.149569201","Wellington Arch, Hyde Park",1976
"11957",2020,16,214,63,53,"51.52683806","-0.130504336","Endsleigh Gardens, Euston",116
"11958",2020,16,215,50,55,"51.51906932","-0.088285377","Moorfields, Moorgate",105
"11959",2020,16,216,143,136,"51.49094565","-0.181190899","Old Brompton Road, South Kensington",279
"11960",2020,16,217,162,176,"51.51615461","-0.082422399","Wormwood Street, Liverpool Street",338
"11961",2020,16,218,241,225,"51.48971651","-0.170194408","St. Luke's Church, Chelsea",466
"11962",2020,16,219,320,326,"51.49016361","-0.19039362","Bramham Gardens, Earl's Court",646
"11963",2020,16,220,200,182,"51.49066456","-0.166485083","Chelsea Green, Chelsea",382
"11964",2020,16,221,147,157,"51.49481649","-0.13045856","Horseferry Road, Westminster",304
"11965",2020,16,222,401,414,"51.50275704","-0.155349725","Knightsbridge, Hyde Park",815
"11966",2020,16,223,242,239,"51.49148474","-0.090220911","Rodney Road , Walworth",481
"11967",2020,16,224,560,544,"51.51031","-0.18740235","Queensway, Kensington Gardens",1104
"11968",2020,16,225,240,215,"51.50935342","-0.196422","Notting Hill Gate Station, Notting Hill",455
"11969",2020,16,226,102,105,"51.50844614","-0.131961389","Charles II Street, West End",207
"11970",2020,16,227,83,96,"51.52891573","-0.115480888","Great Percy Street, Clerkenwell",179
"11971",2020,16,228,180,189,"51.50742485","-0.134621209","St. James's Square, St. James's",369
"11972",2020,16,229,400,418,"51.50654321","-0.123179697","Whitehall Place, Strand",818
"11973",2020,16,230,61,59,"51.50669284","-0.103137426","Poured Lines, Bankside",120
"11974",2020,16,231,175,171,"51.49396755","-0.17873226","Queen's Gate (Central), South Kensington",346
"11975",2020,16,232,24,22,"51.51501025","-0.112753217","Carey Street, Holborn",46
"11976",2020,16,233,267,348,"51.50777049","-0.130699733","Pall Mall East, West End",615
"11977",2020,16,234,281,282,"51.53450449","-0.106992706","Liverpool Road (N1 Centre), Angel",563
"11978",2020,16,235,167,171,"51.49571828","-0.110889274","Kennington Road  , Vauxhall",338
"11979",2020,16,236,72,54,"51.51838043","-0.073438925","Fashion Street, Whitechapel",126
"11980",2020,16,237,235,215,"51.5097860151","-0.0681619805156","Dock Street, Wapping",450
"11981",2020,16,238,163,133,"51.5233534","-0.175116099","Frampton Street, Paddington",296
"11982",2020,16,239,177,152,"51.52443845","-0.138019439","Warren Street Station, Euston",329
"11983",2020,16,240,20,29,"51.50545935","-0.10569204","Colombo Street, Southwark",49
"11984",2020,16,242,185,182,"51.52200801","-0.151359288","Beaumont Street, Marylebone",367
"11985",2020,16,243,233,210,"51.49096258","-0.139625122","Gloucester Street, Pimlico",443
"11986",2020,16,244,112,106,"51.51611887","-0.128585022","Earnshaw Street , Covent Garden",218
"11987",2020,16,245,169,159,"51.4853572","-0.142207481","Grosvenor Road, Pimlico",328
"11988",2020,16,246,178,174,"51.52285301","-0.099994052","Berry Street, Clerkenwell",352
"11989",2020,16,247,258,253,"51.530529","-0.167515","St. John's Wood Church, The Regent's Park",511
"11990",2020,16,248,437,435,"51.50645179","-0.170279555","Triangle Car Park, Hyde Park",872
"11991",2020,16,249,109,76,"51.49859784","-0.096191134","Harper Road, The Borough",185
"11992",2020,16,250,95,88,"51.489932","-0.162727","Royal Avenue 1, Chelsea",183
"11993",2020,16,251,220,222,"51.518908","-0.079249","Brushfield Street, Liverpool Street",442
"11994",2020,16,252,262,262,"51.5046364","-0.116542278","Jubilee Gardens, South Bank",524
"11995",2020,16,253,338,324,"51.53404294","-0.086379717","Shoreditch Park, Hoxton",662
"11996",2020,16,254,179,182,"51.53051587","-0.106408455","Chadwell Street, Angel",361
"11997",2020,16,255,285,303,"51.52557531","-0.179592915","Clifton Road, Maida Vale",588
"11998",2020,16,256,34,36,"51.51362054","-0.116764211","Houghton Street, Strand",70
"11999",2020,16,257,140,125,"51.52248185","-0.154907218","Westminster University, Marylebone",265
"12000",2020,16,259,201,197,"51.490959","-0.1532331","Bourne Street, Belgravia",398
"12001",2020,16,260,95,81,"51.5136846","-0.135580879","Broadwick Street, Soho",176
"12002",2020,16,261,141,120,"51.5134891","-0.191351186","Princes Square, Bayswater",261
"12003",2020,16,262,136,114,"51.49874469","-0.103132904","LSBU (Borough Road), Elephant & Castle",250
"12004",2020,16,263,41,48,"51.51422502","-0.080660083","St. Mary Axe, Aldgate",89
"12005",2020,16,264,143,155,"51.52644342","-0.109256828","Tysoe Street, Clerkenwell",298
"12006",2020,16,265,153,140,"51.51595344","-0.169249375","Southwick Street, Paddington",293
"12007",2020,16,266,531,567,"51.50102668","-0.180246101","Queen's Gate (North), Kensington",1098
"12008",2020,16,267,164,164,"51.49206037","-0.132224622","Regency Street, Westminster",328
"12009",2020,16,268,128,126,"51.49320445","-0.144132875","Belgrave Road, Victoria",254
"12010",2020,16,269,202,204,"51.50082346","-0.089740764","Empire Square, The Borough",406
"12011",2020,16,270,261,268,"51.4863434","-0.122492418","Kennington Lane Rail Bridge, Vauxhall",529
"12012",2020,16,271,84,102,"51.53583617","-0.156285395","London Zoo,  The Regent's Park",186
"12013",2020,16,272,198,230,"51.50144456","-0.110699309","Baylis Road, Waterloo",428
"12014",2020,16,273,119,103,"51.50613324","-0.114686385","Belvedere Road 1, South Bank",222
"12015",2020,16,274,177,176,"51.49671237","-0.20528437","Warwick Road, Olympia",353
"12016",2020,16,275,84,83,"51.52004497","-0.092176447","Barbican Centre, Barbican",167
"12017",2020,16,276,84,82,"51.50930161","-0.084985356","Lower Thames Street, Monument",166
"12018",2020,16,277,232,225,"51.50315739","-0.191496313","Kensington Church Street, Kensington",457
"12019",2020,16,278,548,566,"51.5034938","-0.07962099","Tooley Street, Bermondsey",1114
"12020",2020,16,279,118,107,"51.51862243","-0.176645823","North Wharf Road, Paddington",225
"12021",2020,16,280,178,175,"51.490083","-0.162418","Royal Avenue 2, Chelsea",353
"12022",2020,16,281,132,146,"51.49580589","-0.127575233","Smith Square, Westminster",278
"12023",2020,16,282,332,315,"51.51906446","-0.059642081","Royal London Hospital, Whitechapel",647
"12024",2020,16,283,33,27,"51.51440928","-0.118478757","Kingsway, Covent Garden",60
"12025",2020,16,284,165,175,"51.49914063","-0.112031483","Lambeth North Station, Waterloo",340
"12026",2020,16,286,112,98,"51.5272947","-0.174653609","St. John's Wood Road, St. John's Wood",210
"12027",2020,16,287,47,45,"51.52367314","-0.128377673","Bedford Way, Bloomsbury",92
"12028",2020,16,288,178,165,"51.49236962","-0.147478734","Elizabeth Bridge, Victoria",343
"12029",2020,16,289,76,75,"51.50923022","-0.151296092","South Audley Street, Mayfair",151
"12030",2020,16,290,195,210,"51.518268","-0.17110323","St Mary's Hospital, Paddington",405
"12031",2020,16,291,235,226,"51.48483991","-0.138089062","Claverton Street, Pimlico",461
"12032",2020,16,292,237,250,"51.49888404","-0.165471605","Montpelier Street, Knightsbridge",487
"12033",2020,16,293,83,75,"51.49815779","-0.209494128","Kensington Olympia Station, Olympia",158
"12034",2020,16,294,280,259,"51.488226","-0.135635511","St. George's Square, Pimlico",539
"12035",2020,16,295,112,90,"51.50029631","-0.092762704","Swan Street, The Borough",202
"12036",2020,16,296,194,191,"51.49363156","-0.190603326","Knaresborough Place, Earl's Court",385
"12037",2020,16,297,67,59,"51.49612799","-0.106000855","Geraldine Street, Elephant & Castle",126
"12038",2020,16,298,529,515,"51.50227992","-0.074189225","Curlew Street, Shad Thames",1044
"12039",2020,16,299,87,72,"51.49398524","-0.136928582","Vincent Square, Westminster",159
"12040",2020,16,300,537,525,"51.505014","-0.17306032","Serpentine Car Park, Hyde Park",1062
"12041",2020,16,301,160,158,"51.51475963","-0.148105415","Marylebone Lane, Marylebone",318
"12042",2020,16,302,363,374,"51.466907","-0.216573","Putney Pier, Wandsworth",737
"12043",2020,16,303,397,365,"51.50295379","-0.158456089","Albert Gate, Hyde Park",762
"12044",2020,16,306,93,102,"51.51816295","-0.135025698","Rathbone Street, Fitzrovia",195
"12045",2020,16,307,641,639,"51.50990837","-0.187842717","Black Lion Gate, Kensington Gardens",1280
"12046",2020,16,308,161,151,"51.49907558","-0.085666316","Long Lane , Bermondsey",312
"12047",2020,16,309,198,207,"51.50963123","-0.119047563","Embankment (Savoy), Strand",405
"12048",2020,16,310,112,104,"51.4908679","-0.116911864","Black Prince Road, Vauxhall",216
"12049",2020,16,311,137,137,"51.51918144","-0.140485596","Foley Street, Fitzrovia",274
"12050",2020,16,312,279,267,"51.53088935","-0.176770502","Grove End Road, St. John's Wood",546
"12051",2020,16,313,110,89,"51.51734403","-0.138072691","Wells Street, Fitzrovia",199
"12052",2020,16,314,109,108,"51.50088934","-0.083159352","Tyers Gate, Bermondsey",217
"12053",2020,16,315,139,123,"51.52536703","-0.153463612","The Tennis Courts, The Regent's Park",262
"12054",2020,16,316,230,236,NA,NA,NA,466
"12055",2020,16,317,39,78,"51.49679128","-0.093913472","Dickens Square, Borough",117
"12056",2020,16,318,134,140,"51.51004801","-0.138846453","Sackville Street, Mayfair",274
"12057",2020,16,319,136,143,"51.52702563","-0.088542771","Baldwin Street, St. Luke's",279
"12058",2020,16,320,199,192,"51.49357351","-0.139956043","Queen Mother Sports Centre, Victoria",391
"12059",2020,16,321,412,404,"51.49785559","-0.081608045","Bermondsey Street, Bermondsey",816
"12060",2020,16,322,105,96,"51.526293","-0.073955","Palissy Street, Shoreditch",201
"12061",2020,16,323,38,31,"51.523196","-0.083067","Clifton Street, Shoreditch",69
"12062",2020,16,324,147,150,"51.49652013","-0.101384068","Ontario Street, Elephant & Castle",297
"12063",2020,16,325,87,82,"51.50908747","-0.129697889","St. Martin's Street, West End",169
"12064",2020,16,326,303,305,"51.53266186","-0.099981142","Graham Street, Angel",608
"12065",2020,16,327,77,64,"51.53095","-0.085603","New North Road 1, Hoxton",141
"12066",2020,16,328,72,65,"51.53114","-0.086016","New North Road 2, Hoxton",137
"12067",2020,16,329,581,600,"51.53589283","-0.160854428","Prince Albert Road, The Regent's Park",1181
"12068",2020,16,330,112,91,"51.51641749","-0.179135079","Eastbourne Mews, Paddington",203
"12069",2020,16,331,123,152,"51.52085887","-0.089887855","Bunhill Row, Moorgate",275
"12070",2020,16,332,131,130,"51.49334336","-0.194757949","Nevern Place, Earl's Court",261
"12071",2020,16,333,198,186,"51.50860544","-0.193764092","Palace Gardens Terrace, Notting Hill",384
"12072",2020,16,334,70,75,"51.505044","-0.115851","Concert Hall Approach 1, South Bank",145
"12073",2020,16,335,76,86,"51.51196803","-0.120718759","Tavistock Street, Covent Garden",162
"12074",2020,16,336,61,51,"51.504942","-0.115533","Concert Hall Approach 2, South Bank",112
"12075",2020,16,337,157,148,"51.51108452","-0.197524944","Pembridge Villas, Notting Hill",305
"12076",2020,16,338,128,124,"51.51175646","-0.119643424","Wellington Street , Strand",252
"12077",2020,16,339,67,54,"51.5333196","-0.1117812","Risinghill Street, Angel",121
"12078",2020,16,340,119,116,"51.51444134","-0.087587447","Bank of England Museum, Bank",235
"12079",2020,16,341,256,260,"51.50810309","-0.12602103","Craven Street, Strand",516
"12080",2020,16,343,98,100,"51.53692216","-0.150181444","London Zoo Car Park, The Regent's Park",198
"12081",2020,16,344,71,68,"51.528246","-0.10102611","Goswell Road (City Uni), Finsbury",139
"12082",2020,16,345,259,296,"51.48802358","-0.166878535","Flood Street, Chelsea",555
"12083",2020,16,347,144,140,"51.50013942","-0.113936001","Lower Marsh, Waterloo",284
"12084",2020,16,348,136,128,"51.51217033","-0.150481272","Grosvenor Square, Mayfair",264
"12085",2020,16,349,67,59,"51.51196","-0.142783033","St. George Street, Mayfair",126
"12086",2020,16,350,224,220,"51.5017154373867","-0.1798541843891","Queen's Gate, Kensington Gardens",444
"12087",2020,16,351,138,146,"51.529423","-0.097122","Macclesfield Rd, St Lukes",284
"12088",2020,16,352,130,134,"51.486965","-0.116625","Vauxhall Street, Vauxhall",264
"12089",2020,16,353,94,99,"51.49459148","-0.134234258","Greycoat Street , Westminster",193
"12090",2020,16,354,174,172,"51.506767","-0.123702","Northumberland Avenue, Strand",346
"12091",2020,16,356,238,257,"51.494412","-0.173881","South Kensington Station, South Kensington",495
"12092",2020,16,357,131,132,"51.520994","-0.139016","Howland Street, Fitzrovia",263
"12093",2020,16,358,54,52,"51.516226","-0.124826","High Holborn , Covent Garden",106
"12094",2020,16,359,65,63,"51.49782999","-0.135440826","Butler Place, Westminster",128
"12095",2020,16,360,124,132,"51.49675303","-0.138733562","Howick Place, Westminster",256
"12096",2020,16,361,38,17,"51.50391973","-0.11342629","Waterloo Station 2, Waterloo",55
"12097",2020,16,362,116,115,"51.536264","-0.133952","Royal College Street, Camden Town",231
"12098",2020,16,363,59,53,"51.5291212008901","-0.171185284853","Lord's, St. John's Wood",112
"12099",2020,16,364,59,53,"51.519656","-0.132339","Alfred Place, Bloomsbury",112
"12100",2020,16,365,107,104,"51.530344","-0.100168","City Road, Angel",211
"12101",2020,16,366,74,57,"51.5109192966489","-0.1511263847351","Millennium Hotel, Mayfair",131
"12102",2020,16,367,181,184,"51.5173721","-0.1642075","Harrowby Street, Marylebone",365
"12103",2020,16,368,185,178,"51.50024195","-0.15934065","Harriet Street, Knightsbridge",363
"12104",2020,16,371,43,43,"51.49775","-0.10988","King Edward Walk, Waterloo",86
"12105",2020,16,372,24,18,"51.515208","-0.117863","Sardinia Street, Holborn",42
"12106",2020,16,373,36,28,"51.49980661","-0.176415994","Prince Consort Road, Knightsbridge",64
"12107",2020,16,374,105,128,"51.50402794","-0.11386436","Waterloo Station 1, Waterloo",233
"12108",2020,16,375,121,107,"51.50194596","-0.194392952","Kensington Town Hall, Kensington",228
"12109",2020,16,376,223,223,"51.49188409","-0.125674815","Millbank Tower, Pimlico",446
"12110",2020,16,377,67,57,"51.50535447","-0.113656543","Waterloo Bridge, South Bank",124
"12111",2020,16,378,87,95,"51.49559291","-0.179077626","Natural History Museum, South Kensington",182
"12112",2020,16,379,239,235,"51.51431171","-0.200838199","Turquoise Island, Notting Hill",474
"12113",2020,16,380,58,43,"51.50686435","-0.150666888","Stanhope Gate, Mayfair",101
"12114",2020,16,381,126,119,"51.51953043","-0.13577731","Charlotte Street, Fitzrovia",245
"12115",2020,16,382,83,64,"51.50935171","-0.14744969","Farm Street, Mayfair",147
"12116",2020,16,383,114,111,"51.51310333","-0.13121385","Frith Street, Soho",225
"12117",2020,16,384,160,160,"51.496481","-0.192404","Marloes Road, Kensington",320
"12118",2020,16,386,220,222,"51.51352755","-0.130110822","Moor Street, Soho",442
"12119",2020,16,387,277,283,"51.49369988","-0.121394101","Fire Brigade Pier, Vauxhall",560
"12120",2020,16,388,181,186,"51.51070161","-0.121723604","Southampton Street, Strand",367
"12121",2020,16,389,63,58,"51.51013066","-0.155757901","Upper Grosvenor Street, Mayfair",121
"12122",2020,16,390,77,67,"51.521776","-0.068856","Buxton Street 1, Shoreditch",144
"12123",2020,16,392,156,142,"51.49942855","-0.179702476","Imperial College, Knightsbridge",298
"12124",2020,16,393,74,82,"51.51733427","-0.103604248","Snow Hill, Farringdon",156
"12125",2020,16,394,125,120,"51.524826","-0.176268","Aberdeen Place, St. John's Wood",245
"12126",2020,16,395,215,210,"51.492462","-0.159919","Cadogan Gardens, Chelsea",425
"12127",2020,16,396,127,113,"51.51809","-0.163609","Shouldham Street, Marylebone",240
"12128",2020,16,397,288,279,"51.51348","-0.17977","Devonshire Terrace, Bayswater",567
"12129",2020,16,398,225,231,"51.502319","-0.200742","Holland Park, Kensington",456
"12130",2020,16,399,133,148,"51.52261762","-0.071653961","Brick Lane Market, Shoreditch",281
"12131",2020,16,400,132,129,"51.517703","-0.154106","George Street, Marylebone",261
"12132",2020,16,401,208,200,"51.528187","-0.075375","Columbia Road, Shoreditch",408
"12133",2020,16,402,105,98,"51.52289229","-0.171681991","Penfold Street, Marylebone",203
"12134",2020,16,403,113,98,"51.51689296","-0.158249929","George Place Mews, Marylebone",211
"12135",2020,16,404,204,202,"51.50204238","-0.184400221","Palace Gate, Kensington Gardens",406
"12136",2020,16,405,329,336,"51.49418566","-0.18267094","Gloucester Road Station, South Kensington",665
"12137",2020,16,409,246,270,"51.493146","-0.099828","Strata, Elephant & Castle",516
"12138",2020,16,410,242,243,"51.519968","-0.169774","Edgware Road Station, Marylebone",485
"12139",2020,16,411,227,238,"51.49337264","-0.09968067","Walworth Road, Elephant & Castle",465
"12140",2020,16,412,124,133,"51.488105","-0.110121","Cleaver Street, Kennington",257
"12141",2020,16,419,460,464,"51.485821","-0.149004","Chelsea Bridge, Pimlico",924
"12142",2020,16,420,73,75,"51.504043","-0.105312","Southwark Station 1, Southwark",148
"12143",2020,16,421,97,73,"51.504044","-0.104778","Southwark Station 2, Southwark",170
"12144",2020,16,423,184,161,"51.49456127","-0.15393398","Eaton Square (South), Belgravia",345
"12145",2020,16,424,197,165,"51.490491","-0.149186","Ebury Bridge, Pimlico",362
"12146",2020,16,425,99,104,"51.533379","-0.139159","Harrington Square 2, Camden Town",203
"12147",2020,16,426,167,159,"51.493072","-0.129925","Vincent Street, Pimlico",326
"12148",2020,16,427,272,265,"51.51397065","-0.09294031","Cheapside, Bank",537
"12149",2020,16,428,344,339,"51.499917","-0.174554","Exhibition Road, Knightsbridge",683
"12150",2020,16,430,98,108,"51.48902","-0.17524","South Parade, Chelsea",206
"12151",2020,16,431,62,59,"51.534474","-0.122203","Crinan Street, King's Cross",121
"12152",2020,16,432,102,99,"51.496957","-0.173894","Exhibition Road Museums, South Kensington",201
"12153",2020,16,433,89,92,"51.524564","-0.116279","Wren Street, Holborn",181
"12154",2020,16,435,167,168,"51.488852","-0.105593","Kennington Station, Kennington",335
"12155",2020,16,436,119,135,"51.51824","-0.11655","Red Lion Street, Holborn",254
"12156",2020,16,437,140,133,"51.488124","-0.120903","Vauxhall Walk, Vauxhall",273
"12157",2020,16,439,53,43,"51.5338","-0.118677","Killick Street, King's Cross",96
"12158",2020,16,440,210,209,"51.483145","-0.113134","Kennington Oval, Oval",419
"12159",2020,16,441,106,117,"51.495656","-0.114605","Sail Street, Vauxhall",223
"12160",2020,16,442,108,104,"51.510101","-0.211358","Walmer Road, Avondale",212
"12161",2020,16,443,186,180,"51.515256","-0.058641","Philpot Street, Whitechapel",366
"12162",2020,16,444,116,113,"51.52568","-0.055312","Bethnal Green Garden, Bethnal Green",229
"12163",2020,16,445,96,102,"51.52388","-0.065076","Cheshire Street, Bethnal Green",198
"12164",2020,16,446,146,114,"51.528936","-0.055894","York Hall, Bethnal Green",260
"12165",2020,16,447,120,96,"51.493381","-0.007542","Jubilee Crescent, Cubitt Town",216
"12166",2020,16,448,211,226,"51.50623","-0.02296","Fisherman's Walk West, Canary Wharf",437
"12167",2020,16,449,259,284,"51.511088","-0.057159","Shadwell Station, Shadwell",543
"12168",2020,16,450,119,108,"51.515975","-0.053177","Jubilee Street, Stepney",227
"12169",2020,16,451,173,174,"51.504719","-0.063531","Hermitage Court, Wapping",347
"12170",2020,16,452,97,91,"51.505697","-0.070542","St. Katharine's Way, Tower",188
"12171",2020,16,453,170,173,"51.508447","-0.055167","Garnet Street, Shadwell",343
"12172",2020,16,454,217,223,"51.487679","-0.021582","Napier Avenue, Millwall",440
"12173",2020,16,455,193,192,"51.49447","-0.014409","East Ferry Road, Cubitt Town",385
"12174",2020,16,456,185,242,"51.538071","-0.144664","Parkway, Camden Town",427
"12175",2020,16,458,219,214,"51.504749","-0.057544","Wapping Lane, Wapping",433
"12176",2020,16,459,222,225,"51.535179","-0.03338","Gunmakers Lane, Old Ford",447
"12177",2020,16,460,231,230,"51.516196","-0.029138","Burdett Road, Mile End",461
"12178",2020,16,461,96,88,"51.516","-0.038775","Aston Street, Stepney",184
"12179",2020,16,462,314,330,"51.541603","-0.138853","Bonny Street, Camden Town",644
"12180",2020,16,463,62,73,"51.534776","-0.071881","Thurtle Road, Haggerston",135
"12181",2020,16,464,50,40,"51.51417","-0.052099","St. Mary & St. Michael Church, Stepney",90
"12182",2020,16,465,161,162,"51.53558","-0.08249","Pitfield Street North,Hoxton",323
"12183",2020,16,466,128,132,"51.534464","-0.076341","Whiston Road, Haggerston",260
"12184",2020,16,467,98,97,"51.523538","-0.030556","Southern Grove, Bow",195
"12185",2020,16,468,73,69,"51.521564","-0.022694","Cantrell Road, Bow",142
"12186",2020,16,469,129,130,"51.513757","-0.020467","Lindfield Street, Poplar",259
"12187",2020,16,470,133,135,"51.530535","-0.025492","Mostyn Grove, Bow",268
"12188",2020,16,471,90,118,"51.533283","-0.028155","Hewison Street, Old Ford",208
"12189",2020,16,472,32,32,"51.529452","-0.027616","Malmesbury Road, Bow",64
"12190",2020,16,473,100,99,"51.496137","-0.019355","Millharbour, Millwall",199
"12191",2020,16,475,220,203,"51.499041","-0.020157","Lightermans Road, Millwall",423
"12192",2020,16,476,122,128,"51.489096","-0.009205","Stebondale Street, Cubitt Town",250
"12193",2020,16,477,171,184,"51.49109","-0.018716","Spindrift Avenue, Millwall",355
"12194",2020,16,478,221,224,"51.521889","-0.04667","Stepney Green Station, Stepney",445
"12195",2020,16,479,212,219,"51.527152","-0.058005","Pott Street, Bethnal Green",431
"12196",2020,16,480,440,469,"51.5128711","-0.0389866","Flamborough Street, Limehouse",909
"12197",2020,16,481,351,359,"51.487129","-0.009001","Saunders Ness Road, Cubitt Town",710
"12198",2020,16,483,185,165,"51.51328","-0.047784","Albert Gardens, Stepney",350
"12199",2020,16,484,137,134,"51.528828","-0.013258","Bromley High Street, Bow",271
"12200",2020,16,485,214,218,"51.531127","-0.048017","Old Ford Road, Bethnal Green",432
"12201",2020,16,486,220,217,"51.525645","-0.069543","Granby Street, Shoreditch",437
"12202",2020,16,487,136,133,"51.511811","-0.025626","Canton Street, Poplar",269
"12203",2020,16,488,179,169,"51.506946","-0.058681","Reardon Street, Wapping",348
"12204",2020,16,489,186,179,"51.513074","-0.064094","Christian Street, Whitechapel",365
"12205",2020,16,490,82,85,"51.508622","-0.065006","Pennington Street, Wapping",167
"12206",2020,16,491,118,122,"51.522507","-0.041378","Queen Mary's, Mile End",240
"12207",2020,16,492,192,182,"51.525501","-0.032267204","Maplin Street, Mile End",374
"12208",2020,16,494,32,32,"51.50196","-0.016251","South Quay East, Canary Wharf",64
"12209",2020,16,495,298,311,"51.528169","-0.018703","Bow Church Station, Bow",609
"12210",2020,16,496,205,177,"51.52512","-0.015578","Devons Road, Bow",382
"12211",2020,16,497,93,84,"51.526149","-0.027396845","Merchant Street, Bow",177
"12212",2020,16,498,171,147,"51.527058","-0.025296","Bow Road Station, Bow",318
"12213",2020,16,499,219,216,"51.519265","-0.021345","Furze Green, Bow",435
"12214",2020,16,500,255,265,"51.519806","-0.055731","Ansell House, Stepney",520
"12215",2020,16,501,116,117,"51.522561","-0.054883","Cephas Street, Bethnal Green",233
"12216",2020,16,502,241,264,"51.53341","-0.049591815","Bonner Gate, Victoria Park",505
"12217",2020,16,503,283,282,"51.520893","-0.051394","Cleveland Way, Stepney",565
"12218",2020,16,504,135,121,"51.496454","-0.009506","St. John's Park, Cubitt Town",256
"12219",2020,16,505,129,117,"51.520398","-0.026768","Ackroyd Drive, Bow",246
"12220",2020,16,506,119,129,"51.517475","-0.075855","Bell Lane, Liverpool Street",248
"12221",2020,16,507,78,66,"51.528692","-0.059091","Clarkson Street, Bethnal Green",144
"12222",2020,16,508,108,114,"51.519362","-0.074431","Fournier Street, Whitechapel",222
"12223",2020,16,509,28,23,"51.517842","-0.090075","Fore Street, Guildhall",51
"12224",2020,16,510,292,336,"51.509303","-0.025996","Westferry DLR, Limehouse",628
"12225",2020,16,511,271,271,"51.511066","-0.053558","Sutton Street, Shadwell",542
"12226",2020,16,512,155,178,"51.532091","-0.06142","Pritchard's Road, Bethnal Green",333
"12227",2020,16,513,144,154,"51.5142228","-0.055656","Watney Market, Stepney",298
"12228",2020,16,514,133,129,"51.516204","-0.155525","Portman Square, Marylebone",262
"12229",2020,16,515,97,92,"51.500088","-0.211316","Russell Gardens, Olympia",189
"12230",2020,16,516,170,163,"51.5112","-0.014438","Chrisp Street Market, Poplar",333
"12231",2020,16,517,142,148,"51.532513","-0.033085","Ford Road, Old Ford",290
"12232",2020,16,518,155,151,"51.528224","-0.037471","Antill Road, Mile End",306
"12233",2020,16,519,52,52,"51.518811","-0.011662","Teviot Street, Poplar",104
"12234",2020,16,520,120,101,"51.526041","-0.047218","Bancroft Road, Bethnal Green",221
"12235",2020,16,521,186,209,"51.534137","-0.037366","Driffield Road, Old Ford",395
"12236",2020,16,522,218,234,"51.525941","-0.036017","Clinton Road, Mile End",452
"12237",2020,16,523,124,130,"51.51549","-0.013475","Langdon Park, Poplar",254
"12238",2020,16,524,208,193,"51.511654","-0.179668","Lancaster Gate , Bayswater",401
"12239",2020,16,526,122,119,"51.503143","-0.008428","Lancaster Drive, Blackwall",241
"12240",2020,16,527,153,140,"51.503802","-0.215808","Hansard Mews, Holland Park",293
"12241",2020,16,528,22,22,"51.507326","-0.145827","Clarges Street, Mayfair",44
"12242",2020,16,529,126,123,"51.486892","-0.170983","Manresa Road, Chelsea",249
"12243",2020,16,530,167,166,"51.508896","-0.012413","Newby Place, Poplar",333
"12244",2020,16,531,232,213,"51.530326","-0.042744","Twig Folly Bridge, Mile End",445
"12245",2020,16,532,99,177,"51.50357","-0.020068","Jubilee Plaza, Canary Wharf",276
"12246",2020,16,533,119,117,"51.528222","-0.069743","Wellington Row, Bethnal Green",236
"12247",2020,16,534,209,227,"51.531864","-0.066035","Goldsmith's Row, Haggerston",436
"12248",2020,16,535,299,314,"51.537349","-0.147154","Gloucester Avenue, Camden Town",613
"12249",2020,16,536,84,86,"51.53385","-0.06992","Queensbridge Road, Haggerston",170
"12250",2020,16,537,158,177,"51.51793","-0.067937","Old Montague Street, Whitechapel",335
"12251",2020,16,538,137,157,"51.508981","-0.00699","Naval Row, Blackwall",294
"12252",2020,16,540,250,254,"51.528302","-0.144466","Albany Street, The Regent's Park",504
"12253",2020,16,541,340,337,"51.506613","-0.142844","Green Park Station, Mayfair",677
"12254",2020,16,542,261,222,"51.514115","-0.033828","Salmon Lane, Limehouse",483
"12255",2020,16,543,64,59,"51.509591","-0.204666","Lansdowne Walk, Ladbroke Grove",123
"12256",2020,16,544,128,116,"51.526153","-0.102208","Percival Street, Finsbury",244
"12257",2020,16,545,127,118,"51.539957","-0.145246","Arlington Road, Camden Town",245
"12258",2020,16,546,80,69,"51.517428","-0.107987","New Fetter Lane, Holborn",149
"12259",2020,16,547,300,305,"51.509474","-0.002275","East India DLR, Blackwall",605
"12260",2020,16,548,40,44,"51.498386","-0.107913","Westminster Bridge Road, Elephant & Castle",84
"12261",2020,16,549,172,150,"51.49605","-0.104193","Gaywood  Street, Elephant & Castle",322
"12262",2020,16,550,81,76,"51.521564","-0.039264","Harford Street, Mile End",157
"12263",2020,16,551,66,55,"51.505772","-0.016460175","Import Dock, Canary Wharf",121
"12264",2020,16,552,121,118,"51.511542","-0.056667","Watney Street, Shadwell",239
"12265",2020,16,553,502,534,"51.535678","-0.062546","Regent's Row , Haggerston",1036
"12266",2020,16,554,99,95,"51.513548","-0.005659","Aberfeldy Street, Poplar",194
"12267",2020,16,556,104,112,"51.502661","-0.021596","Heron Quays DLR, Canary Wharf",216
"12268",2020,16,557,104,91,"51.51601","-0.0985","King Edward Street, St Pauls",195
"12269",2020,16,558,167,148,"51.493978","-0.127554","Page Street, Westminster",315
"12270",2020,16,559,136,137,"51.501391","-0.205991","Abbotsbury Road, Holland Park",273
"12271",2020,16,560,99,66,"51.511624","-0.205921","Ladbroke Grove Central, Ladbroke Grove",165
"12272",2020,16,561,119,102,"51.518369","-0.043371","Rectory Square, Stepney",221
"12273",2020,16,562,104,79,"51.51746","-0.12335","Bury Place, Holborn",183
"12274",2020,16,563,129,136,"51.499286","-0.009152","Preston's Road, Cubitt Town",265
"12275",2020,16,564,538,547,"51.509943","-0.117619","Somerset House, Strand",1085
"12276",2020,16,565,58,53,"51.521905","-0.063386","Selby Street, Whitechapel",111
"12277",2020,16,566,152,161,"51.509158","-0.224103","Westfield Ariel Way, White City",313
"12278",2020,16,568,304,320,"51.51616","-0.18697","Bishop's Bridge Road West, Bayswater",624
"12279",2020,16,569,134,117,"51.53213","-0.08299","Pitfield Street Central, Hoxton",251
"12280",2020,16,570,168,173,"51.503083","-0.017676","Upper Bank Street, Canary Wharf",341
"12281",2020,16,571,78,92,"51.506256","-0.218337","Westfield Southern Terrace ,Shepherd's Bush",170
"12282",2020,16,572,262,270,"51.539099","-0.141728","Greenland Road, Camden Town",532
"12283",2020,16,573,346,357,"51.485587","-0.18119","Limerston Street, West Chelsea",703
"12284",2020,16,574,221,205,"51.53356","-0.09315","Eagle Wharf Road, Hoxton",426
"12285",2020,16,576,163,173,"51.497304","-0.022793","Alpha Grove, Millwall",336
"12286",2020,16,577,189,179,"51.528869","-0.047548","Globe Town Market, Bethnal Green",368
"12287",2020,16,578,20,51,"51.527607","-0.057133","Hollybush Gardens, Bethnal Green",71
"12288",2020,16,579,273,288,"51.511246","-0.093051","Queen Street 2, Bank",561
"12289",2020,16,580,242,249,"51.48692917","-0.102996299","Doddington Grove, Kennington",491
"12290",2020,16,581,211,187,"51.519167","-0.147983","New Cavendish Street, Marylebone",398
"12291",2020,16,583,313,349,"51.497622","-0.125978","Abingdon Green, Westminster",662
"12292",2020,16,584,177,158,"51.51244","-0.19096","Ilchester Gardens, Bayswater",335
"12293",2020,16,586,90,75,"51.490645","-0.014582","Mudchute DLR, Cubitt Town",165
"12294",2020,16,587,202,218,"51.50964","-0.08497","Monument Street, Monument",420
"12295",2020,16,588,85,72,"51.52959","-0.0801","Hoxton Street, Hoxton",157
"12296",2020,16,589,378,397,"51.487196","-0.179369","Drayton Gardens, West Chelsea",775
"12297",2020,16,590,102,80,"51.53256","-0.16862","Greenberry Street, St.John's Wood",182
"12298",2020,16,592,109,92,"51.5171","-0.18377","Bishop's Bridge Road East, Bayswater",201
"12299",2020,16,593,36,51,"51.531066","-0.11934","Northdown Street, King's Cross",87
"12300",2020,16,594,36,37,"51.513875","-0.117774","Kingsway Southbound, Strand",73
"12301",2020,16,595,139,151,"51.493267","-0.21985","Hammersmith Road, Hammersmith",290
"12302",2020,16,596,257,257,"51.472817","-0.199783","Parson's Green , Parson's Green",514
"12303",2020,16,597,202,186,"51.473471","-0.20782","Fulham Park Road, Fulham",388
"12304",2020,16,598,252,285,"51.494499","-0.228188","Southerton Road, Hammersmith",537
"12305",2020,16,599,107,125,"51.485743","-0.223616","Manbre Road, Hammersmith",232
"12306",2020,16,600,407,394,"51.481747","-0.124642","South Lambeth Road, Vauxhall",801
"12307",2020,16,601,227,238,"51.514767","-0.225787","BBC White City, White City",465
"12308",2020,16,602,218,234,"51.472993","-0.133972","Union Grove, Wandsworth Road",452
"12309",2020,16,603,264,288,"51.477839","-0.116493","Caldwell Street, Stockwell",552
"12310",2020,16,604,66,69,"51.538792","-0.138535","St Martins Close, Camden Town",135
"12311",2020,16,605,130,128,"51.520331","-0.163667","Seymour Place, Marylebone",258
"12312",2020,16,606,68,80,"51.504199","-0.210941","Addison Road, Holland Park",148
"12313",2020,16,607,180,184,"51.468814","-0.210279","Putney Bridge Station, Fulham",364
"12314",2020,16,608,32,36,"51.491093","-0.216493","Colet Gardens, Hammersmith",68
"12315",2020,16,609,185,167,"51.46512358","-0.157788279","Sugden Road, Clapham",352
"12316",2020,16,610,327,316,"51.48256792","-0.172078187","Danvers Street, West Chelsea",643
"12317",2020,16,611,198,196,"51.50646524","-0.208486599","Princedale Road , Holland Park",394
"12318",2020,16,612,246,246,"51.46925984","-0.141812513","Wandsworth Rd, Isley Court, Wandsworth Road",492
"12319",2020,16,613,272,272,"51.50403821","-0.217400093","Woodstock Grove, Shepherd's Bush",544
"12320",2020,16,614,104,107,"51.47817208","-0.144690541","Bradmead, Battersea Park",211
"12321",2020,16,615,263,233,"51.4768851","-0.215895601","Finlay Street, Fulham",496
"12322",2020,16,616,153,152,"51.48102131","-0.209973497","Aintree Street, Fulham",305
"12323",2020,16,617,116,107,"51.47107905","-0.207842908","Elysium Place, Fulham",223
"12324",2020,16,618,213,221,"51.47625965","-0.193254007","Eel Brook Common, Walham Green",434
"12325",2020,16,619,180,173,"51.4737636","-0.197010096","Irene Road, Parsons Green",353
"12326",2020,16,620,132,157,"51.47518024","-0.167160736","Surrey Lane, Battersea",289
"12327",2020,16,621,159,184,"51.46086446","-0.187427294","Wandsworth Town Station, Wandsworth",343
"12328",2020,16,622,215,235,"51.50748124","-0.205535908","Lansdowne Road, Ladbroke Grove",450
"12329",2020,16,623,87,77,"51.46193072","-0.180791784","Nantes Close, Wandsworth",164
"12330",2020,16,624,253,228,"51.4729184","-0.132102704","Courland Grove, Wandsworth Road",481
"12331",2020,16,625,645,666,"51.47761941","-0.149551631","Queen's Circus, Battersea Park",1311
"12332",2020,16,626,257,252,"51.48438657","-0.20481514","Normand Park, West Kensington",509
"12333",2020,16,627,93,72,"51.4687905","-0.158230901","Holden Street, Battersea",165
"12334",2020,16,628,211,198,"51.46881971","-0.184318843","William Morris Way, Sands End",409
"12335",2020,16,629,58,79,"51.45995384","-0.190184054","Morie Street, Wandsworth",137
"12336",2020,16,630,213,202,"51.47073264","-0.126994068","Clarence Walk, Stockwell",415
"12337",2020,16,631,174,177,"51.4795017","-0.141770709","Battersea Park Road, Nine Elms",351
"12338",2020,16,632,118,126,"51.47053858","-0.163041605","Sheepcote Lane, Battersea",244
"12339",2020,16,633,264,252,"51.48959104","-0.209378594","Vereker Road, West Kensington",516
"12340",2020,16,634,110,110,"51.49434708","-0.215804559","Brook Green South, Brook Green",220
"12341",2020,16,635,145,131,"51.48606206","-0.214428378","Greyhound Road, Hammersmith",276
"12342",2020,16,636,147,123,"51.46706414","-0.193502076","South Park, Sands End",270
"12343",2020,16,637,178,184,"51.45787019","-0.174691623","Spencer Park, Wandsworth Common",362
"12344",2020,16,638,206,216,"51.46663393","-0.169821175","Falcon Road, Clapham Junction",422
"12345",2020,16,639,142,129,"51.48357068","-0.202038682","Coomer Place, West Kensington",271
"12346",2020,16,640,211,211,"51.47286577","-0.148059277","Silverthorne Road, Battersea",422
"12347",2020,16,641,180,187,"51.49824168","-0.117495865","Archbishop's Park, Waterloo",367
"12348",2020,16,642,104,94,"51.46916161","-0.174485792","Fawcett Close, Battersea",198
"12349",2020,16,643,150,154,"51.5190427","-0.204764421","All Saints' Road, Portobello",304
"12350",2020,16,644,150,152,"51.48373225","-0.223852256","Rainville Road, Hammersmith",302
"12351",2020,16,645,80,72,"51.50173215","-0.100292412","Great Suffolk Street, The Borough",152
"12352",2020,16,646,259,257,"51.49886563","-0.137424571","Buckingham Gate, Westminster",516
"12353",2020,16,647,93,120,"51.50035306","-0.217515071","Richmond Way, Shepherd's Bush",213
"12354",2020,16,648,113,123,"51.46904022","-0.19627483","Peterborough Road, Sands End",236
"12355",2020,16,649,230,227,"51.48180515","-0.18027465","World's End Place, West Chelsea",457
"12356",2020,16,650,208,217,"51.51687069","-0.213872396","St. Mark's Road, North Kensington",425
"12357",2020,16,651,140,128,"51.48089844","-0.183853573","Thorndike Close, West Chelsea",268
"12358",2020,16,652,69,73,"51.51148696","-0.218190203","Evesham Street, Avondale",142
"12359",2020,16,653,218,218,"51.47084722","-0.17070367","Simpson Street, Clapham Junction",436
"12360",2020,16,654,219,214,"51.48267821","-0.117661574","Ashmole Estate, Oval",433
"12361",2020,16,655,103,110,"51.48294452","-0.219346128","Crabtree Lane, Fulham",213
"12362",2020,16,656,61,60,"51.46841875","-0.199135704","Broomhouse Lane, Parsons Green",121
"12363",2020,16,657,164,167,"51.4996806","-0.221791552","Blythe Road West, Shepherd's Bush",331
"12364",2020,16,658,605,607,"51.47729232","-0.16478637","Ethelburga Estate, Battersea Park",1212
"12365",2020,16,659,153,123,"51.511934","-0.10307894","Blackfriars Station, St. Paul's",276
"12366",2020,16,660,127,122,"51.49087074","-0.206029743","West Kensington Station, West Kensington",249
"12367",2020,16,661,314,340,"51.51632095","-0.202608612","All Saints Church, Portobello",654
"12368",2020,16,662,263,243,"51.48498496","-0.167919869","Phene Street, Chelsea",506
"12369",2020,16,663,100,112,"51.51323001","-0.211593602","Clarendon Road, Avondale",212
"12370",2020,16,664,209,229,"51.474376","-0.155442787","Austin Road, Battersea Park",438
"12371",2020,16,665,155,165,"51.46108367","-0.191722864","Smugglers Way, Wandsworth",320
"12372",2020,16,666,221,194,"51.49610093","-0.208158259","Olympia Way, Olympia",415
"12373",2020,16,667,232,235,"51.5015946","-0.222293381","Shepherd's Bush Road North, Shepherd's Bush",467
"12374",2020,16,668,362,367,"51.49422354","-0.236769936","Ravenscourt Park Station, Hammersmith",729
"12375",2020,16,669,123,121,"51.47614939","-0.1232585","Teversham Lane, Stockwell",244
"12376",2020,16,670,110,127,"51.46718562","-0.152248582","Ashley Crescent, Battersea",237
"12377",2020,16,671,161,162,"51.475089","-0.201968","Parsons Green Station, Parsons Green",323
"12378",2020,16,673,249,245,"51.46517078","-0.18038939","Hibbert Street, Battersea",494
"12379",2020,16,674,136,129,"51.53546778","-0.11619105","Carnegie Street, King's Cross",265
"12380",2020,16,675,150,165,"51.46348914","-0.182126248","Usk Road, Clapham Junction",315
"12381",2020,16,676,236,215,"51.47787084","-0.126874471","Hartington Road, Stockwell",451
"12382",2020,16,677,160,144,"51.46866929","-0.146544642","Heath Road, Battersea",304
"12383",2020,16,678,63,68,"51.46231278","-0.211468596","Esmond Street, Putney",131
"12384",2020,16,679,80,81,"51.47453545","-0.170210533","Orbel Street, Battersea",161
"12385",2020,16,680,195,233,"51.47768469","-0.170329317","Westbridge Road, Battersea",428
"12386",2020,16,681,155,234,"51.47303687","-0.214749808","Bishop's Avenue, Fulham",389
"12387",2020,16,682,388,433,"51.48810829","-0.22660621","Crisp Road, Hammersmith",821
"12388",2020,16,683,190,211,"51.46506424","-0.163750945","Dorothy Road, Clapham Junction",401
"12389",2020,16,684,295,294,"51.45475251","-0.195197203","Neville Gill Close, Wandsworth",589
"12390",2020,16,685,153,150,"51.46067005","-0.198735357","Osiers Road, Wandsworth",303
"12391",2020,16,686,107,106,"51.48814438","-0.222456468","Beryl Road, Hammersmith",213
"12392",2020,16,687,187,183,"51.49760804","-0.21145598","Maclise Road, Olympia",370
"12393",2020,16,688,132,124,"51.46095151","-0.20066766","Northfields, Wandsworth",256
"12394",2020,16,689,99,75,"51.45922541","-0.180884959","Spanish Road, Clapham Junction",174
"12395",2020,16,690,127,115,"51.47047503","-0.152130083","Stanley Grove, Battersea",242
"12396",2020,16,691,301,318,"51.47946386","-0.195777222","Erin Close, Walham Green",619
"12397",2020,16,692,350,341,"51.54211855","-0.028941601","Cadogan Close, Victoria Park",691
"12398",2020,16,693,142,140,"51.464786","-0.215618902","Felsham Road, Putney",282
"12399",2020,16,694,196,203,"51.46071722","-0.216526155","Putney Rail Station, Putney",399
"12400",2020,16,695,508,524,"51.53638435","-0.102757578","Islington Green, Angel",1032
"12401",2020,16,696,96,78,"51.48728535","-0.217995921","Charing Cross Hospital, Hammersmith",174
"12402",2020,16,697,149,137,"51.53639219","-0.112721065","Charlotte Terrace, Angel",286
"12403",2020,16,698,178,180,"51.53908372","-0.070329419","Shoreditch Court, Haggerston",358
"12404",2020,16,699,91,74,"51.5366541","-0.07023031","Belford House, Haggerston",165
"12405",2020,16,700,180,190,"51.47696496","-0.174347066","Battersea Church Road, Battersea",370
"12406",2020,16,701,295,287,"51.47287627","-0.176267008","Vicarage Crescent, Battersea",582
"12407",2020,16,702,123,128,"51.52868155","-0.065550321","Durant Street, Bethnal Green",251
"12408",2020,16,703,100,98,"51.51505991","-0.10534448","St. Bride Street, Holborn",198
"12409",2020,16,704,111,100,"51.45682071","-0.202802098","Mexfield Road, East Putney",211
"12410",2020,16,705,129,136,NA,NA,NA,265
"12411",2020,16,706,160,164,"51.50215353","-0.083632928","Snowsfields, London Bridge",324
"12412",2020,16,707,139,140,"51.49021762","-0.215087092","Barons Court Station, West Kensington",279
"12413",2020,16,708,113,135,"51.46161068","-0.21614583","Disraeli Road, Putney",248
"12414",2020,16,709,97,106,"51.46321128","-0.215550761","Montserrat Road , Putney",203
"12415",2020,16,710,339,347,"51.47439218","-0.163347594","Albert Bridge Road, Battersea Park",686
"12416",2020,16,711,156,133,"51.48335692","-0.216305546","Everington Street, Fulham",289
"12417",2020,16,712,246,230,"51.51854104","-0.034903714","Mile End Stadium, Mile End",476
"12418",2020,16,713,214,208,"51.54100708","-0.14326094","Hawley Crescent, Camden Town",422
"12419",2020,16,714,125,116,"51.47311696","-0.137235175","Stewart's Road, Wandsworth Road",241
"12420",2020,16,715,121,112,"51.51563007","-0.049067243","Aylward Street, Stepney",233
"12421",2020,16,716,183,183,"51.51542791","-0.02356501","Stainsby Road , Poplar",366
"12422",2020,16,717,323,334,"51.53658514","-0.075885686","Dunston Road , Haggerston",657
"12423",2020,16,718,136,140,"51.53571683","-0.060291813","Ada Street, Hackney Central",276
"12424",2020,16,719,410,382,"51.53642464","-0.054162264","Victoria Park Road, Hackney Central",792
"12425",2020,16,720,159,157,"51.48724429","-0.205279052","Star Road, West Kensington",316
"12426",2020,16,721,157,158,"51.53603947","-0.026262677","Wendon Street, Old Ford",315
"12427",2020,16,722,93,85,"51.52458353","-0.058631453","Finnis Street, Bethnal Green",178
"12428",2020,16,723,341,342,"51.46822047","-0.190346493","Stephendale Road, Sands End",683
"12429",2020,16,724,107,92,"51.45799126","-0.184806157","Alma Road, Wandsworth",199
"12430",2020,16,725,257,259,"51.491327","-0.096518684","Walworth Square, Walworth",516
"12431",2020,16,726,183,200,"51.47505096","-0.150908371","Alfreda Street, Battersea Park",383
"12432",2020,16,727,244,246,"51.47569809","-0.20587627","Chesilton Road, Fulham",490
"12433",2020,16,728,130,112,"51.46199911","-0.206240805","Putney Bridge Road, East Putney",242
"12434",2020,16,729,238,241,"51.47893931","-0.208485293","St. Peter's Terrace, Fulham",479
"12435",2020,16,730,277,289,"51.49208492","-0.229116862","Bridge Avenue, Hammersmith",566
"12436",2020,16,731,114,131,"51.47727637","-0.189210466","Michael Road, Walham Green",245
"12437",2020,16,732,298,309,"51.50630441","-0.087262995","Duke Street Hill, London Bridge",607
"12438",2020,16,733,71,81,"51.50542628","-0.150817316","Park Lane, Mayfair",152
"12439",2020,16,734,157,146,"51.46230566","-0.175407201","Plough Terrace, Clapham Junction",303
"12440",2020,16,735,84,82,"51.46489445","-0.17302926","Grant Road East, Clapham Junction",166
"12441",2020,16,736,94,92,"51.50659035","-0.216104479","Queensdale Road, Shepherd's Bush",186
"12442",2020,16,737,374,414,"51.47993289","-0.19411695","Fulham Broadway, Walham Green",788
"12443",2020,16,738,131,115,"51.47514228","-0.187278987","Imperial Road, Sands End",246
"12444",2020,16,739,191,206,"51.48176572","-0.185273723","Hortensia Road, West Brompton",397
"12445",2020,16,740,58,50,"51.51092871","-0.214594781","Sirdar Road, Avondale",108
"12446",2020,16,741,57,69,"51.5129814","-0.219486603","Freston Road, Avondale",126
"12447",2020,16,742,244,250,"51.51510818","-0.208565479","Blenheim Crescent, Ladbroke Grove",494
"12448",2020,16,743,102,107,"51.46079243","-0.212607684","Oxford Road, Putney",209
"12449",2020,16,744,76,74,"51.46745485","-0.172293499","Ingrave Street, Clapham Junction",150
"12450",2020,16,745,150,125,"51.47816972","-0.18243547","Upcerne Road, West Chelsea",275
"12451",2020,16,746,223,210,"51.4795738","-0.17903854","Lots Road, West Chelsea",433
"12452",2020,16,747,205,201,"51.48796408","-0.161765173","Ormonde Gate, Chelsea",406
"12453",2020,16,748,200,212,"51.53727795","-0.079201849","Hertford Road, De Beauvoir Town",412
"12454",2020,16,749,382,383,"51.53932857","-0.074284675","Haggerston Road, Haggerston",765
"12455",2020,16,750,68,77,"51.4710956","-0.157850096","Culvert Road, Battersea",145
"12456",2020,16,751,33,31,"51.51612862","-0.120909408","Newton Street, Covent Garden",64
"12457",2020,16,754,66,60,"51.5129006","-0.214762686","Grenfell Road, Avondale",126
"12458",2020,16,755,211,249,"51.48512191","-0.174971902","The Vale, Chelsea",460
"12459",2020,16,756,302,316,"51.47515398","-0.159169801","Prince of Wales Drive, Battersea Park",618
"12460",2020,16,757,322,330,"51.48795853","-0.187404506","Harcourt Terrace, West Brompton",652
"12461",2020,16,758,192,219,"51.51787005","-0.201005397","Westbourne Park Road, Portobello",411
"12462",2020,16,759,50,42,"51.52456169","-0.165668686","Broadley Terrace, Marylebone",92
"12463",2020,16,760,68,55,"51.52526975","-0.163795009","Rossmore Road, Marylebone",123
"12464",2020,16,761,114,107,"51.48321729","-0.211860644","Humbolt Road, Fulham",221
"12465",2020,16,762,662,683,"51.50070305","-0.129698963","Storey's Gate, Westminster",1345
"12466",2020,16,763,196,212,"51.52059714","-0.032566533","Mile End Park Leisure Centre, Mile End",408
"12467",2020,16,764,181,224,"51.46239255","-0.16829214","St. John's Road, Clapham Junction",405
"12468",2020,16,765,126,103,"51.46760141","-0.20682737","Ranelagh Gardens, Fulham",229
"12469",2020,16,766,193,196,"51.45752945","-0.192165613","Ram Street, Wandsworth",389
"12470",2020,16,767,49,51,"51.45705988","-0.200806304","Santos Road, Wandsworth",100
"12471",2020,16,768,657,674,"51.46134382","-0.159322467","Clapham Common North Side, Clapham Common",1331
"12472",2020,16,769,162,163,"51.473611","-0.191803","Sandilands Road, Walham Green",325
"12473",2020,16,770,170,153,"51.491026","-0.209121","Gwendwr Road, West Kensington",323
"12474",2020,16,771,111,115,"51.509224","-0.216016","Rifle Place, Avondale",226
"12475",2020,16,772,329,355,"51.47250956","-0.122831913","Binfield Road, Stockwell",684
"12476",2020,16,773,123,122,"51.511891","-0.107349","Tallis Street, Temple",245
"12477",2020,16,774,98,95,"51.470131","-0.20464","Hurlingham Park, Parsons Green",193
"12478",2020,16,775,151,150,"51.496664","-0.223868","Little Brook Green, Brook Green",301
"12479",2020,16,776,195,206,"51.460333","-0.167029","Abyssinia Close, Clapham Junction",401
"12480",2020,16,777,82,100,"51.4619230679","-0.165297856693","Limburg Road, Clapham Junction",182
"12481",2020,16,779,98,103,"51.514449","-0.077178979","Houndsditch, Aldgate",201
"12482",2020,16,780,350,357,"51.474665","-0.18316517","Imperial Wharf Station, Sands End",707
"12483",2020,16,781,107,88,"51.495898","-0.173009","Victoria & Albert Museum, South Kensington",195
"12484",2020,16,782,230,224,"51.483911","-0.19760944","Halford Road, West Kensington",454
"12485",2020,16,783,222,225,"51.5403115","-0.021630359","Monier Road, Hackney Wick",447
"12486",2020,16,784,380,372,"51.546326","-0.00993526","East Village, Queen Elizabeth Olympic Park",752
"12487",2020,16,785,463,469,"51.54094","-0.010510565","Aquatic Centre, Queen Elizabeth Olympic Park",932
"12488",2020,16,786,427,419,"51.549369","-0.015717614","Lee Valley VeloPark, Queen Elizabeth Olympic Park",846
"12489",2020,16,787,515,525,"51.546805","-0.01469126","Timber Lodge, Queen Elizabeth Olympic Park",1040
"12490",2020,16,789,540,558,"51.538718","-0.011889482","Podium, Queen Elizabeth Olympic Park",1098
"12491",2020,16,790,193,212,"51.541793","-0.00481","Stratford Station, Stratford",405
"12492",2020,16,792,121,123,"51.505461","-0.10454093","Blackfriars Road, Southwark",244
"12493",2020,16,793,96,95,"51.528279","-0.11955857","Cromer Street, Bloomsbury",191
"12494",2020,16,795,42,37,"51.527068","-0.13186102","Euston Square Gardens, Euston",79
"12495",2020,16,796,102,94,"51.524","-0.12640984","Coram Street, Bloomsbury",196
"12496",2020,16,797,81,75,"51.5293","-0.12827903","Ossulston Street, Somers Town",156
"12497",2020,16,798,76,70,"51.5301998755","-0.122299440803","Birkenhead Street, King's Cross",146
"12498",2020,16,799,84,82,"51.4976984561","-0.137598896295","Kings Gate House, Westminster",166
"12499",2020,16,801,92,101,"51.5052241745","-0.0980318118664","Lavington Street, Bankside",193
"12500",2020,16,802,234,241,"51.4765900593","-0.118256789081","Albert Square, Stockwell",475
"12501",2020,16,803,87,102,"51.5054099403","-0.0983410884509","Southwark Street, Bankside",189
"12502",2020,16,804,207,220,"51.5346677396","-0.125078652873","Good's Way, King's Cross",427
"12503",2020,16,806,159,150,"51.5372405623","-0.124807385707","Handyside Street, King's Cross",309
"12504",2020,16,807,386,389,"51.5212","-0.20888818","Bevington Road West, North Kensington",775
"12505",2020,16,809,65,66,"51.5162778834","-0.118272991635","Lincoln's Inn Fields, Holborn",131
"12506",2020,16,810,73,80,"51.5067252868","-0.0988072461627","Tate Modern, Bankside",153
"12507",2020,16,811,438,439,"51.5057030357","-0.0277727426235","Westferry Circus, Canary Wharf",877
"12508",2020,16,812,187,187,"51.5487311915","-0.0226065549321","Here East North, Queen Elizabeth Olympic Park",374
"12509",2020,16,813,39,101,"51.4878074485","-0.122759625866","New Spring Gardens Walk, Vauxhall",140
"12510",2020,16,814,287,280,"51.4714330677","-0.123670735702","Clapham Road, Lingham Street, Stockwell",567
"12511",2020,16,815,415,427,"51.5000891978","-0.116628700672","Lambeth Palace Road, Waterloo",842
"12512",2020,16,816,75,65,"51.5465327935","-0.0205975904647","Here East South, Queen Elizabeth Olympic Park",140
"12513",2020,16,817,282,276,"51.4813354746","-0.138212295869","Riverlight South, Nine Elms",558
"12514",2020,16,819,70,70,"51.50621","-0.114842","Belvedere Road 2, South Bank",140
"12515",2020,16,820,130,135,"51.492807","-0.091938","Victory Place, Walworth",265
"12516",2020,16,821,614,627,"51.4835074867","-0.147714557371","Battersea Power Station, Battersea Park",1241
"12517",2020,16,826,116,122,"51.496863","-0.1429434","Allington Street, Victoria",238
"12518",2020,16,827,286,279,"51.479601","-0.11147178","Cranmer Road, Stockwell",565
"12519",2020,16,828,193,220,"51.473874","-0.11258096","Normandy Road, Stockwell",413
"12520",2020,16,829,147,141,"51.469217","-0.11268674","Wynne Road, Stockwell",288
"12521",2020,16,830,210,217,"51.469202","-0.11902256","Sidney Road, Stockwell",427
"12522",2020,16,831,134,154,"51.466232","-0.11317995","St John's Crescent, Brixton",288
"12523",2020,16,832,359,372,"51.464019","-0.11578197","Ferndale Road, Brixton",731
"12524",2020,16,833,604,591,"51.460232","-0.11537509","Saltoun Road, Brixton",1195
"12525",2020,16,834,435,447,"51.477966","-0.14785703","Gas Holders, Battersea Park",882
"12526",2020,16,835,91,75,"51.516785","-0.10494775","Farringdon Street, Holborn",166
"12527",2020,16,836,185,171,"51.541596","-0.12544145","York Way, Kings Cross",356
"12528",2020,16,838,66,64,"51.518093","-0.0914017","Fore Street Avenue, Guildhall",130
"12529",2020,16,839,161,158,"51.508033","-0.10682363","Sea Containers, South Bank",319
"12530",2020,17,1,130,109,"51.52916347","-0.109970527","River Street , Clerkenwell",239
"12531",2020,17,2,348,390,"51.49960695","-0.197574246","Phillimore Gardens, Kensington",738
"12532",2020,17,3,38,29,"51.52128377","-0.084605692","Christopher Street, Liverpool Street",67
"12533",2020,17,4,86,85,"51.53005939","-0.120973687","St. Chad's Street, King's Cross",171
"12534",2020,17,5,225,224,"51.49313","-0.156876","Sedding Street, Sloane Square",449
"12535",2020,17,6,165,144,"51.51811784","-0.144228881","Broadcasting House, Marylebone",309
"12536",2020,17,7,325,315,"51.53430039","-0.1680743","Charlbert Street, St. John's Wood",640
"12537",2020,17,8,569,565,"51.529857","-0.18348604","Maida Vale, Maida Vale",1134
"12538",2020,17,9,224,232,"51.5073853","-0.096440751","New Globe Walk, Bankside",456
"12539",2020,17,10,126,118,"51.50597426","-0.092754157","Park Street, Bankside",244
"12540",2020,17,11,193,189,"51.52395143","-0.122502346","Brunswick Square, Bloomsbury",382
"12541",2020,17,12,121,111,"51.52168078","-0.130431727","Malet Street, Bloomsbury",232
"12542",2020,17,13,92,97,"51.51991453","-0.136039674","Scala Street, Fitzrovia",189
"12543",2020,17,14,264,299,"51.52994371","-0.123616824","Belgrove Street , King's Cross",563
"12544",2020,17,15,99,96,"51.51772703","-0.127854211","Great Russell Street, Bloomsbury",195
"12545",2020,17,16,159,151,"51.52635795","-0.125979294","Cartwright Gardens , Bloomsbury",310
"12546",2020,17,17,216,221,"51.5216612","-0.109006325","Hatton Wall, Holborn",437
"12547",2020,17,18,239,252,"51.51477076","-0.12221963","Drury Lane, Covent Garden",491
"12548",2020,17,19,21,29,"51.52505093","-0.131161087","Taviton Street, Bloomsbury",50
"12549",2020,17,20,24,26,"51.527326","-0.13605286","Drummond Street , Euston",50
"12550",2020,17,21,80,79,"51.53007835","-0.13884627","Hampstead Road (Cartmel), Euston",159
"12551",2020,17,22,221,239,"51.5222641","-0.114079481","Northington Street , Holborn",460
"12552",2020,17,23,71,67,"51.51943538","-0.119123345","Red Lion Square, Holborn",138
"12553",2020,17,24,138,121,"51.51908011","-0.124678402","British Museum, Bloomsbury",259
"12554",2020,17,25,113,89,"51.5288338","-0.132250369","Doric Way , Somers Town",202
"12555",2020,17,26,120,109,"51.52728093","-0.11829517","Ampton Street , Clerkenwell",229
"12556",2020,17,27,74,79,"51.51382102","-0.107927706","Bouverie Street, Temple",153
"12557",2020,17,28,357,359,"51.52351808","-0.143613641","Bolsover Street, Fitzrovia",716
"12558",2020,17,29,246,256,"51.513735","-0.193487","Hereford Road, Bayswater",502
"12559",2020,17,30,122,127,"51.52915444","-0.093421615","Windsor Terrace, Hoxton",249
"12560",2020,17,31,170,214,"51.52953709","-0.083353323","Fanshaw Street, Hoxton",384
"12561",2020,17,32,223,208,"51.52469624","-0.084439283","Leonard Circus , Shoreditch",431
"12562",2020,17,33,158,168,"51.5156","-0.070056","Central House, Aldgate",326
"12563",2020,17,34,125,110,"51.5341235","-0.129386874","Pancras Road, King's Cross",235
"12564",2020,17,36,607,601,"51.50173726","-0.184980612","De Vere Gardens, Kensington",1208
"12565",2020,17,37,226,236,"51.49159394","-0.192369256","Penywern Road, Earl's Court",462
"12566",2020,17,38,190,192,"51.4973875","-0.197245586","Abingdon Villas, Kensington",382
"12567",2020,17,39,259,272,"51.5263778","-0.078130921","Shoreditch High Street, Shoreditch",531
"12568",2020,17,40,201,202,"51.52127071","-0.0755789","Commercial Street, Shoreditch",403
"12569",2020,17,41,35,26,"51.520955","-0.083493552","Pindar Street, Liverpool Street",61
"12570",2020,17,42,192,169,"51.53099181","-0.093903825","Wenlock Road , Hoxton",361
"12571",2020,17,43,255,240,"51.52026","-0.157183945","Crawford Street, Marylebone",495
"12572",2020,17,44,122,127,"51.51073687","-0.144165239","Bruton Street, Mayfair",249
"12573",2020,17,45,121,102,"51.522511","-0.162298","Boston Place, Marylebone",223
"12574",2020,17,47,599,617,"51.52334476","-0.183846408","Warwick Avenue Station, Maida Vale",1216
"12575",2020,17,48,234,233,"51.51248445","-0.099141408","Godliman Street, St. Paul's",467
"12576",2020,17,49,152,147,"51.50706909","-0.145904427","Curzon Street, Mayfair",299
"12577",2020,17,50,103,111,"51.52867339","-0.087459376","East Road, Hoxton",214
"12578",2020,17,51,115,103,"51.52671796","-0.104298194","Finsbury Library , Finsbury",218
"12579",2020,17,52,175,170,"51.52295439","-0.094934859","Roscoe Street, St. Luke's",345
"12580",2020,17,53,71,70,"51.5099923","-0.143495266","Grafton Street, Mayfair",141
"12581",2020,17,54,148,150,"51.52174785","-0.094475072","Golden Lane, Barbican",298
"12582",2020,17,55,131,120,"51.51707521","-0.086685542","Finsbury Circus, Liverpool Street",251
"12583",2020,17,56,178,173,"51.52058381","-0.154701411","Paddington Street, Marylebone",351
"12584",2020,17,57,206,191,"51.52334672","-0.120202614","Guilford Street , Bloomsbury",397
"12585",2020,17,58,144,148,"51.52452699","-0.079248081","New Inn Yard, Shoreditch",292
"12586",2020,17,60,141,141,"51.52644828","-0.172190727","Lisson Grove, St. John's Wood",282
"12587",2020,17,61,159,166,"51.49738251","-0.089446947","Great Dover Street, The Borough",325
"12588",2020,17,62,187,164,"51.4907579","-0.106323685","Cotton Garden Estate, Kennington",351
"12589",2020,17,63,133,122,"51.53089041","-0.089782579","Murray Grove , Hoxton",255
"12590",2020,17,64,206,221,"51.50946212","-0.124749274","William IV Street, Strand",427
"12591",2020,17,65,124,107,NA,NA,NA,231
"12592",2020,17,66,202,194,"51.51795029","-0.108657431","Holborn Circus, Holborn",396
"12593",2020,17,67,78,73,"51.51882555","-0.108028472","Hatton Garden, Holborn",151
"12594",2020,17,68,184,186,"51.52059681","-0.116688468","Theobald's Road , Holborn",370
"12595",2020,17,69,78,71,"51.5262363","-0.134407652","Euston Road, Euston",149
"12596",2020,17,70,91,88,"51.53136059","-0.117069978","Calshot Street , King's Cross",179
"12597",2020,17,71,243,213,"51.5154186","-0.098850915","Newgate Street , St. Paul's",456
"12598",2020,17,72,134,138,"51.52352001","-0.108340165","Farringdon Lane, Clerkenwell",272
"12599",2020,17,73,236,231,"51.52572618","-0.088486188","Old Street Station, St. Luke's",467
"12600",2020,17,74,617,614,"51.48591714","-0.124469948","Vauxhall Cross, Vauxhall",1231
"12601",2020,17,75,134,142,"51.53219984","-0.105480698","Torrens Street, Angel",276
"12602",2020,17,76,180,154,"51.52559505","-0.144083893","Longford Street, The Regent's Park",334
"12603",2020,17,77,224,215,"51.52341837","-0.124121774","Russell Square Station, Bloomsbury",439
"12604",2020,17,78,168,164,"51.52486887","-0.099489485","Sadlers Sports Centre, Finsbury",332
"12605",2020,17,79,110,108,"51.511726","-0.11385596","Arundel Street, Temple",218
"12606",2020,17,80,207,157,"51.50069361","-0.102091246","Webber Street , Southwark",364
"12607",2020,17,81,212,196,"51.52025302","-0.141327271","Great Titchfield Street, Fitzrovia",408
"12608",2020,17,82,93,76,"51.514274","-0.111257","Chancery Lane, Holborn",169
"12609",2020,17,83,271,281,"51.50963938","-0.131510949","Panton Street, West End",552
"12610",2020,17,84,48,31,"51.51593725","-0.111778348","Breams Buildings, Holborn",79
"12611",2020,17,85,423,437,"51.50064702","-0.078600401","Tanner Street, Bermondsey",860
"12612",2020,17,86,124,118,"51.48947903","-0.115156562","Sancroft Street, Vauxhall",242
"12613",2020,17,87,59,59,"51.51646835","-0.079684557","Devonshire Square, Liverpool Street",118
"12614",2020,17,88,226,223,"51.51858757","-0.132053392","Bayley Street , Bloomsbury",449
"12615",2020,17,89,165,147,"51.5262503","-0.123509611","Tavistock Place, Bloomsbury",312
"12616",2020,17,90,58,39,"51.53301907","-0.139174593","Harrington Square 1, Camden Town",97
"12617",2020,17,91,228,211,"51.49368637","-0.111014912","Walnut Tree Walk, Vauxhall",439
"12618",2020,17,92,130,145,"51.49889832","-0.100440521","Borough Road, Elephant & Castle",275
"12619",2020,17,93,251,250,"51.53440868","-0.109025404","Cloudesley Road, Angel",501
"12620",2020,17,94,407,422,"51.49506109","-0.085814489","Bricklayers Arms, Borough",829
"12621",2020,17,95,240,257,"51.5208417","-0.097340162","Aldersgate Street, Barbican",497
"12622",2020,17,96,142,133,"51.53095071","-0.078505384","Falkirk Street, Hoxton",275
"12623",2020,17,97,350,357,"51.49792478","-0.183834706","Gloucester Road (North), Kensington",707
"12624",2020,17,98,250,239,"51.52554222","-0.138231303","Hampstead Road, Euston",489
"12625",2020,17,99,401,408,"51.51457763","-0.158264483","Old Quebec Street, Marylebone",809
"12626",2020,17,100,282,281,"51.49043573","-0.122806861","Albert Embankment, Vauxhall",563
"12627",2020,17,101,250,244,"51.51155322","-0.0929401","Queen Street 1, Bank",494
"12628",2020,17,102,114,112,"51.51340693","-0.076793375","Jewry Street, Aldgate",226
"12629",2020,17,103,178,180,"51.50472376","-0.192538767","Vicarage Gate, Kensington",358
"12630",2020,17,104,144,135,"51.51159481","-0.077121322","Crosswall, Tower",279
"12631",2020,17,105,311,326,"51.51552971","-0.190240716","Westbourne Grove, Bayswater",637
"12632",2020,17,106,99,89,"51.51410514","-0.147301667","Woodstock Street, Mayfair",188
"12633",2020,17,107,230,234,"51.52600832","-0.096317627","Finsbury Leisure Centre, St. Luke's",464
"12634",2020,17,108,167,174,"51.49812559","-0.132102166","Abbey Orchard Street, Westminster",341
"12635",2020,17,109,281,267,"51.51563144","-0.132328837","Soho Square , Soho",548
"12636",2020,17,110,279,267,"51.53304322","-0.172528678","Wellington Road, St. John's Wood",546
"12637",2020,17,111,736,744,"51.5100172","-0.157275636","Park Lane , Hyde Park",1480
"12638",2020,17,112,50,46,"51.51580998","-0.105270275","Stonecutter Street, Holborn",96
"12639",2020,17,113,310,310,"51.49646288","-0.183289032","Gloucester Road (Central), South Kensington",620
"12640",2020,17,114,646,654,"51.52451738","-0.158963647","Park Road (Baker Street), The Regent's Park",1300
"12641",2020,17,115,317,304,"51.51423368","-0.073537654","Braham Street, Aldgate",621
"12642",2020,17,116,253,246,"51.51449962","-0.141423695","Little Argyll Street, West End",499
"12643",2020,17,117,151,153,"51.49288067","-0.114934001","Lollard Street, Vauxhall",304
"12644",2020,17,118,60,111,"51.49582705","-0.13547809","Rochester Row, Westminster",171
"12645",2020,17,119,266,278,"51.52589324","-0.090847761","Bath Street, St. Luke's",544
"12646",2020,17,120,73,66,"51.51573534","-0.093080779","The Guildhall, Guildhall",139
"12647",2020,17,121,96,70,"51.51891348","-0.156166631","Baker Street, Marylebone",166
"12648",2020,17,122,115,106,"51.52111369","-0.078869751","Norton Folgate, Liverpool Street",221
"12649",2020,17,123,97,92,"51.52836014","-0.104724625","St. John Street, Finsbury",189
"12650",2020,17,125,241,240,"51.50069491","-0.094524319","Borough High Street, The Borough",481
"12651",2020,17,126,90,91,"51.51782144","-0.096496865","Museum of London, Barbican",181
"12652",2020,17,127,53,50,"51.51700801","-0.09388536","Wood Street, Guildhall",103
"12653",2020,17,128,307,293,"51.49536226","-0.185296516","Emperor's Gate, South Kensington",600
"12654",2020,17,129,233,216,"51.5118973","-0.137043852","Golden Square, Soho",449
"12655",2020,17,130,734,751,"51.50950627","-0.075459482","Tower Gardens , Tower",1485
"12656",2020,17,131,120,122,"51.53300545","-0.136792671","Eversholt Street , Camden Town",242
"12657",2020,17,132,386,374,"51.52364804","-0.074754872","Bethnal Green Road, Shoreditch",760
"12658",2020,17,133,375,377,NA,NA,NA,752
"12659",2020,17,134,520,507,"51.504904","-0.06797","Wapping High Street, Wapping",1027
"12660",2020,17,135,235,243,"51.52326004","-0.104708922","Clerkenwell Green, Clerkenwell",478
"12661",2020,17,136,265,258,"51.51196176","-0.097441687","Queen Victoria Street, St. Paul's",523
"12662",2020,17,138,276,272,"51.51227622","-0.157436972","Green Street, Mayfair",548
"12663",2020,17,139,194,195,"51.49488108","-0.117974901","Lambeth Road, Vauxhall",389
"12664",2020,17,140,120,108,"51.52096262","-0.085634242","Finsbury Square , Moorgate",228
"12665",2020,17,141,110,109,"51.51530805","-0.147203711","Chapel Place, Marylebone",219
"12666",2020,17,142,228,209,"51.49372451","-0.198286569","West Cromwell Road, Earl's Court",437
"12667",2020,17,143,254,250,"51.4968865","-0.161203828","Pont Street, Knightsbridge",504
"12668",2020,17,144,337,323,"51.48894022","-0.111435796","Kennington Cross, Kennington",660
"12669",2020,17,145,168,167,"51.50074359","-0.202759212","Ilchester Place, Kensington",335
"12670",2020,17,146,258,265,"51.48836528","-0.129361842","Vauxhall Bridge , Pimlico",523
"12671",2020,17,148,243,233,"51.49211134","-0.138364847","Tachbrook Street, Victoria",476
"12672",2020,17,149,341,334,"51.48478899","-0.110683213","Kennington Road Post Office, Oval",675
"12673",2020,17,150,151,149,"51.49705603","-0.168917077","Holy Trinity Brompton, Knightsbridge",300
"12674",2020,17,151,197,193,"51.51213691","-0.201554966","Chepstow Villas, Notting Hill",390
"12675",2020,17,152,289,284,"51.49217002","-0.101536865","Hampton Street, Walworth",573
"12676",2020,17,153,1033,1055,"51.511933","-0.174411","Bayswater Road, Hyde Park",2088
"12677",2020,17,154,71,48,"51.50379168","-0.11282408","Waterloo Station 3, Waterloo",119
"12678",2020,17,155,132,158,"51.49586666","-0.191933711","Lexham Gardens, Kensington",290
"12679",2020,17,156,154,150,"51.49443626","-0.092921165","New Kent Road, The Borough",304
"12680",2020,17,157,189,195,"51.50039792","-0.193068385","Wright's Lane, Kensington",384
"12681",2020,17,158,257,239,"51.49085368","-0.196170309","Trebovir Road, Earl's Court",496
"12682",2020,17,159,181,167,"51.51461995","-0.137841333","Great Marlborough Street, Soho",348
"12683",2020,17,160,238,237,"51.50663341","-0.131773845","Waterloo Place, St. James's",475
"12684",2020,17,161,133,119,"51.49234577","-0.141334487","Guildhouse Street, Victoria",252
"12685",2020,17,162,164,161,"51.51760685","-0.121328408","Southampton Place, Holborn",325
"12686",2020,17,163,363,368,"51.4931848","-0.167894973","Sloane Avenue, Knightsbridge",731
"12687",2020,17,164,182,153,"51.515607","-0.183118788","Cleveland Gardens, Bayswater",335
"12688",2020,17,165,2,2,"51.517932","-0.183716959","Orsett Terrace, Bayswater",4
"12689",2020,17,166,317,336,"51.50185512","-0.159237081","Seville Street, Knightsbridge",653
"12690",2020,17,167,174,179,"51.49395092","-0.147624377","Eccleston Place, Victoria",353
"12691",2020,17,168,183,171,"51.50040123","-0.195455928","Argyll Road, Kensington",354
"12692",2020,17,169,414,415,"51.51474612","-0.165164288","Porchester Place, Paddington",829
"12693",2020,17,170,67,71,"51.52784273","-0.108068155","Hardwick Street, Clerkenwell",138
"12694",2020,17,171,286,284,"51.4916156","-0.186753859","Collingham Gardens, Earl's Court",570
"12695",2020,17,172,238,229,"51.49121192","-0.173715911","Sumner Place, South Kensington",467
"12696",2020,17,173,80,74,"51.50486","-0.113001","Waterloo Road, South Bank",154
"12697",2020,17,174,81,85,"51.512529","-0.115163","Strand, Strand",166
"12698",2020,17,175,78,63,"51.521668","-0.079608554","Worship Street, Shoreditch",141
"12699",2020,17,176,208,204,"51.51791921","-0.188098863","Gloucester Terrace, Bayswater",412
"12700",2020,17,177,167,157,"51.49616092","-0.140947636","Ashley Place, Victoria",324
"12701",2020,17,178,316,323,"51.48985626","-0.141923621","Warwick Square, Pimlico",639
"12702",2020,17,180,228,232,"51.5129118","-0.153645496","North Audley Street, Mayfair",460
"12703",2020,17,181,207,197,"51.49941247","-0.152317537","Belgrave Square, Belgravia",404
"12704",2020,17,182,147,137,"51.52202903","-0.165842551","Bell Street , Marylebone",284
"12705",2020,17,183,535,541,"51.482362","-0.13612398","Riverlight North, Nine Elms",1076
"12706",2020,17,184,227,219,"51.52071513","-0.14521173","Portland Place, Marylebone",446
"12707",2020,17,185,332,334,"51.48805753","-0.140741432","Alderney Street, Pimlico",666
"12708",2020,17,186,215,223,"51.51733558","-0.175810943","South Wharf Road, Paddington",438
"12709",2020,17,187,332,326,"51.49247977","-0.178433004","Queen's Gate (South), South Kensington",658
"12710",2020,17,188,78,82,"51.5165179","-0.164393768","Nutford Place, Marylebone",160
"12711",2020,17,189,114,111,"51.53166681","-0.109914711","Claremont Square, Angel",225
"12712",2020,17,190,263,241,"51.48997562","-0.132845681","Rampayne Street, Pimlico",504
"12713",2020,17,191,763,819,"51.50311799","-0.153520935","Hyde Park Corner, Hyde Park",1582
"12714",2020,17,192,385,382,"51.51251523","-0.133201961","Wardour Street, Soho",767
"12715",2020,17,193,132,115,"51.50581776","-0.100186337","Bankside Mix, Bankside",247
"12716",2020,17,194,755,895,"51.50462759","-0.091773776","Hop Exchange, The Borough",1650
"12717",2020,17,195,233,234,"51.50724437","-0.106237501","Milroy Walk, South Bank",467
"12718",2020,17,196,115,116,"51.50368837","-0.098497684","Union Street, The Borough",231
"12719",2020,17,197,109,83,"51.50556905","-0.111606696","Stamford Street, South Bank",192
"12720",2020,17,199,263,252,"51.51048489","-0.082989638","Great Tower Street, Monument",515
"12721",2020,17,200,213,216,"51.51492456","-0.066078037","LMU Commercial Road, Whitechapel",429
"12722",2020,17,201,205,217,"51.5225965","-0.161113413","Dorset Square, Marylebone",422
"12723",2020,17,202,344,337,"51.51236389","-0.06954201","Leman Street, Aldgate",681
"12724",2020,17,203,162,168,"51.51821864","-0.100791005","West Smithfield Rotunda, Farringdon",330
"12725",2020,17,204,129,127,"51.52659961","-0.112432615","Margery Street, Clerkenwell",256
"12726",2020,17,206,229,230,"51.518154","-0.062697","New Road 1 , Whitechapel",459
"12727",2020,17,207,135,148,"51.50135267","-0.153194766","Grosvenor Crescent, Belgravia",283
"12728",2020,17,208,83,69,"51.52505151","-0.166304359","Mallory Street, Marylebone",152
"12729",2020,17,209,112,99,"51.49358391","-0.165101392","Denyer Street, Knightsbridge",211
"12730",2020,17,210,239,223,"51.51681444","-0.151926305","Hinde Street, Marylebone",462
"12731",2020,17,211,250,236,"51.49464523","-0.158105512","Cadogan Place, Knightsbridge",486
"12732",2020,17,212,133,93,"51.50658458","-0.199004026","Campden Hill Road, Notting Hill",226
"12733",2020,17,213,1228,1249,"51.50274025","-0.149569201","Wellington Arch, Hyde Park",2477
"12734",2020,17,214,92,64,"51.52683806","-0.130504336","Endsleigh Gardens, Euston",156
"12735",2020,17,215,76,66,"51.51906932","-0.088285377","Moorfields, Moorgate",142
"12736",2020,17,216,229,228,"51.49094565","-0.181190899","Old Brompton Road, South Kensington",457
"12737",2020,17,217,243,251,"51.51615461","-0.082422399","Wormwood Street, Liverpool Street",494
"12738",2020,17,218,261,262,"51.48971651","-0.170194408","St. Luke's Church, Chelsea",523
"12739",2020,17,219,438,422,"51.49016361","-0.19039362","Bramham Gardens, Earl's Court",860
"12740",2020,17,220,292,272,"51.49066456","-0.166485083","Chelsea Green, Chelsea",564
"12741",2020,17,221,177,196,"51.49481649","-0.13045856","Horseferry Road, Westminster",373
"12742",2020,17,222,370,381,"51.50275704","-0.155349725","Knightsbridge, Hyde Park",751
"12743",2020,17,223,345,364,"51.49148474","-0.090220911","Rodney Road , Walworth",709
"12744",2020,17,224,838,829,"51.51031","-0.18740235","Queensway, Kensington Gardens",1667
"12745",2020,17,225,363,309,"51.50935342","-0.196422","Notting Hill Gate Station, Notting Hill",672
"12746",2020,17,226,107,96,"51.50844614","-0.131961389","Charles II Street, West End",203
"12747",2020,17,227,117,126,"51.52891573","-0.115480888","Great Percy Street, Clerkenwell",243
"12748",2020,17,228,215,221,"51.50742485","-0.134621209","St. James's Square, St. James's",436
"12749",2020,17,229,438,453,"51.50654321","-0.123179697","Whitehall Place, Strand",891
"12750",2020,17,230,76,83,"51.50669284","-0.103137426","Poured Lines, Bankside",159
"12751",2020,17,231,191,203,"51.49396755","-0.17873226","Queen's Gate (Central), South Kensington",394
"12752",2020,17,232,38,36,"51.51501025","-0.112753217","Carey Street, Holborn",74
"12753",2020,17,233,490,509,"51.50777049","-0.130699733","Pall Mall East, West End",999
"12754",2020,17,234,301,305,"51.53450449","-0.106992706","Liverpool Road (N1 Centre), Angel",606
"12755",2020,17,235,201,207,"51.49571828","-0.110889274","Kennington Road  , Vauxhall",408
"12756",2020,17,236,92,86,"51.51838043","-0.073438925","Fashion Street, Whitechapel",178
"12757",2020,17,237,262,259,"51.5097860151","-0.0681619805156","Dock Street, Wapping",521
"12758",2020,17,238,173,161,"51.5233534","-0.175116099","Frampton Street, Paddington",334
"12759",2020,17,239,300,282,"51.52443845","-0.138019439","Warren Street Station, Euston",582
"12760",2020,17,240,45,38,"51.50545935","-0.10569204","Colombo Street, Southwark",83
"12761",2020,17,242,278,266,"51.52200801","-0.151359288","Beaumont Street, Marylebone",544
"12762",2020,17,243,277,266,"51.49096258","-0.139625122","Gloucester Street, Pimlico",543
"12763",2020,17,244,115,115,"51.51611887","-0.128585022","Earnshaw Street , Covent Garden",230
"12764",2020,17,245,237,231,"51.4853572","-0.142207481","Grosvenor Road, Pimlico",468
"12765",2020,17,246,237,247,"51.52285301","-0.099994052","Berry Street, Clerkenwell",484
"12766",2020,17,247,380,376,"51.530529","-0.167515","St. John's Wood Church, The Regent's Park",756
"12767",2020,17,248,614,620,"51.50645179","-0.170279555","Triangle Car Park, Hyde Park",1234
"12768",2020,17,249,155,141,"51.49859784","-0.096191134","Harper Road, The Borough",296
"12769",2020,17,250,123,124,"51.489932","-0.162727","Royal Avenue 1, Chelsea",247
"12770",2020,17,251,305,301,"51.518908","-0.079249","Brushfield Street, Liverpool Street",606
"12771",2020,17,252,403,399,"51.5046364","-0.116542278","Jubilee Gardens, South Bank",802
"12772",2020,17,253,391,376,"51.53404294","-0.086379717","Shoreditch Park, Hoxton",767
"12773",2020,17,254,245,258,"51.53051587","-0.106408455","Chadwell Street, Angel",503
"12774",2020,17,255,334,342,"51.52557531","-0.179592915","Clifton Road, Maida Vale",676
"12775",2020,17,256,40,33,"51.51362054","-0.116764211","Houghton Street, Strand",73
"12776",2020,17,257,216,218,"51.52248185","-0.154907218","Westminster University, Marylebone",434
"12777",2020,17,259,238,234,"51.490959","-0.1532331","Bourne Street, Belgravia",472
"12778",2020,17,260,155,146,"51.5136846","-0.135580879","Broadwick Street, Soho",301
"12779",2020,17,261,147,152,"51.5134891","-0.191351186","Princes Square, Bayswater",299
"12780",2020,17,262,165,168,"51.49874469","-0.103132904","LSBU (Borough Road), Elephant & Castle",333
"12781",2020,17,263,73,69,"51.51422502","-0.080660083","St. Mary Axe, Aldgate",142
"12782",2020,17,264,207,213,"51.52644342","-0.109256828","Tysoe Street, Clerkenwell",420
"12783",2020,17,265,143,145,"51.51595344","-0.169249375","Southwick Street, Paddington",288
"12784",2020,17,266,695,742,"51.50102668","-0.180246101","Queen's Gate (North), Kensington",1437
"12785",2020,17,267,213,213,"51.49206037","-0.132224622","Regency Street, Westminster",426
"12786",2020,17,268,148,128,"51.49320445","-0.144132875","Belgrave Road, Victoria",276
"12787",2020,17,269,284,289,"51.50082346","-0.089740764","Empire Square, The Borough",573
"12788",2020,17,270,380,386,"51.4863434","-0.122492418","Kennington Lane Rail Bridge, Vauxhall",766
"12789",2020,17,271,202,227,"51.53583617","-0.156285395","London Zoo,  The Regent's Park",429
"12790",2020,17,272,223,245,"51.50144456","-0.110699309","Baylis Road, Waterloo",468
"12791",2020,17,273,164,130,"51.50613324","-0.114686385","Belvedere Road 1, South Bank",294
"12792",2020,17,274,216,238,"51.49671237","-0.20528437","Warwick Road, Olympia",454
"12793",2020,17,275,93,94,"51.52004497","-0.092176447","Barbican Centre, Barbican",187
"12794",2020,17,276,97,97,"51.50930161","-0.084985356","Lower Thames Street, Monument",194
"12795",2020,17,277,217,236,"51.50315739","-0.191496313","Kensington Church Street, Kensington",453
"12796",2020,17,278,758,763,"51.5034938","-0.07962099","Tooley Street, Bermondsey",1521
"12797",2020,17,279,158,135,"51.51862243","-0.176645823","North Wharf Road, Paddington",293
"12798",2020,17,280,197,205,"51.490083","-0.162418","Royal Avenue 2, Chelsea",402
"12799",2020,17,281,161,168,"51.49580589","-0.127575233","Smith Square, Westminster",329
"12800",2020,17,282,367,382,"51.51906446","-0.059642081","Royal London Hospital, Whitechapel",749
"12801",2020,17,283,40,41,"51.51440928","-0.118478757","Kingsway, Covent Garden",81
"12802",2020,17,284,157,158,"51.49914063","-0.112031483","Lambeth North Station, Waterloo",315
"12803",2020,17,286,172,165,"51.5272947","-0.174653609","St. John's Wood Road, St. John's Wood",337
"12804",2020,17,287,45,34,"51.52367314","-0.128377673","Bedford Way, Bloomsbury",79
"12805",2020,17,288,275,271,"51.49236962","-0.147478734","Elizabeth Bridge, Victoria",546
"12806",2020,17,289,77,70,"51.50923022","-0.151296092","South Audley Street, Mayfair",147
"12807",2020,17,290,258,268,"51.518268","-0.17110323","St Mary's Hospital, Paddington",526
"12808",2020,17,291,291,295,"51.48483991","-0.138089062","Claverton Street, Pimlico",586
"12809",2020,17,292,341,350,"51.49888404","-0.165471605","Montpelier Street, Knightsbridge",691
"12810",2020,17,293,118,119,"51.49815779","-0.209494128","Kensington Olympia Station, Olympia",237
"12811",2020,17,294,289,287,"51.488226","-0.135635511","St. George's Square, Pimlico",576
"12812",2020,17,295,119,119,"51.50029631","-0.092762704","Swan Street, The Borough",238
"12813",2020,17,296,241,242,"51.49363156","-0.190603326","Knaresborough Place, Earl's Court",483
"12814",2020,17,297,71,58,"51.49612799","-0.106000855","Geraldine Street, Elephant & Castle",129
"12815",2020,17,298,619,631,"51.50227992","-0.074189225","Curlew Street, Shad Thames",1250
"12816",2020,17,299,105,98,"51.49398524","-0.136928582","Vincent Square, Westminster",203
"12817",2020,17,300,508,530,"51.505014","-0.17306032","Serpentine Car Park, Hyde Park",1038
"12818",2020,17,301,203,179,"51.51475963","-0.148105415","Marylebone Lane, Marylebone",382
"12819",2020,17,302,441,463,"51.466907","-0.216573","Putney Pier, Wandsworth",904
"12820",2020,17,303,569,609,"51.50295379","-0.158456089","Albert Gate, Hyde Park",1178
"12821",2020,17,306,106,107,"51.51816295","-0.135025698","Rathbone Street, Fitzrovia",213
"12822",2020,17,307,666,668,"51.50990837","-0.187842717","Black Lion Gate, Kensington Gardens",1334
"12823",2020,17,308,189,195,"51.49907558","-0.085666316","Long Lane , Bermondsey",384
"12824",2020,17,309,454,452,"51.50963123","-0.119047563","Embankment (Savoy), Strand",906
"12825",2020,17,310,188,188,"51.4908679","-0.116911864","Black Prince Road, Vauxhall",376
"12826",2020,17,311,183,182,"51.51918144","-0.140485596","Foley Street, Fitzrovia",365
"12827",2020,17,312,373,366,"51.53088935","-0.176770502","Grove End Road, St. John's Wood",739
"12828",2020,17,313,114,117,"51.51734403","-0.138072691","Wells Street, Fitzrovia",231
"12829",2020,17,314,198,206,"51.50088934","-0.083159352","Tyers Gate, Bermondsey",404
"12830",2020,17,315,303,317,"51.52536703","-0.153463612","The Tennis Courts, The Regent's Park",620
"12831",2020,17,316,256,258,NA,NA,NA,514
"12832",2020,17,317,35,75,"51.49679128","-0.093913472","Dickens Square, Borough",110
"12833",2020,17,318,171,164,"51.51004801","-0.138846453","Sackville Street, Mayfair",335
"12834",2020,17,319,180,175,"51.52702563","-0.088542771","Baldwin Street, St. Luke's",355
"12835",2020,17,320,275,276,"51.49357351","-0.139956043","Queen Mother Sports Centre, Victoria",551
"12836",2020,17,321,475,481,"51.49785559","-0.081608045","Bermondsey Street, Bermondsey",956
"12837",2020,17,322,137,119,"51.526293","-0.073955","Palissy Street, Shoreditch",256
"12838",2020,17,323,36,37,"51.523196","-0.083067","Clifton Street, Shoreditch",73
"12839",2020,17,324,245,253,"51.49652013","-0.101384068","Ontario Street, Elephant & Castle",498
"12840",2020,17,325,66,67,"51.50908747","-0.129697889","St. Martin's Street, West End",133
"12841",2020,17,326,326,320,"51.53266186","-0.099981142","Graham Street, Angel",646
"12842",2020,17,327,72,50,"51.53095","-0.085603","New North Road 1, Hoxton",122
"12843",2020,17,328,112,109,"51.53114","-0.086016","New North Road 2, Hoxton",221
"12844",2020,17,329,789,794,"51.53589283","-0.160854428","Prince Albert Road, The Regent's Park",1583
"12845",2020,17,330,92,90,"51.51641749","-0.179135079","Eastbourne Mews, Paddington",182
"12846",2020,17,331,144,154,"51.52085887","-0.089887855","Bunhill Row, Moorgate",298
"12847",2020,17,332,167,162,"51.49334336","-0.194757949","Nevern Place, Earl's Court",329
"12848",2020,17,333,332,294,"51.50860544","-0.193764092","Palace Gardens Terrace, Notting Hill",626
"12849",2020,17,334,110,102,"51.505044","-0.115851","Concert Hall Approach 1, South Bank",212
"12850",2020,17,335,119,114,"51.51196803","-0.120718759","Tavistock Street, Covent Garden",233
"12851",2020,17,336,88,85,"51.504942","-0.115533","Concert Hall Approach 2, South Bank",173
"12852",2020,17,337,176,157,"51.51108452","-0.197524944","Pembridge Villas, Notting Hill",333
"12853",2020,17,338,215,212,"51.51175646","-0.119643424","Wellington Street , Strand",427
"12854",2020,17,339,72,80,"51.5333196","-0.1117812","Risinghill Street, Angel",152
"12855",2020,17,340,166,171,"51.51444134","-0.087587447","Bank of England Museum, Bank",337
"12856",2020,17,341,363,363,"51.50810309","-0.12602103","Craven Street, Strand",726
"12857",2020,17,343,181,189,"51.53692216","-0.150181444","London Zoo Car Park, The Regent's Park",370
"12858",2020,17,344,112,102,"51.528246","-0.10102611","Goswell Road (City Uni), Finsbury",214
"12859",2020,17,345,322,331,"51.48802358","-0.166878535","Flood Street, Chelsea",653
"12860",2020,17,347,181,213,"51.50013942","-0.113936001","Lower Marsh, Waterloo",394
"12861",2020,17,348,166,178,"51.51217033","-0.150481272","Grosvenor Square, Mayfair",344
"12862",2020,17,349,84,85,"51.51196","-0.142783033","St. George Street, Mayfair",169
"12863",2020,17,350,395,393,"51.5017154373867","-0.1798541843891","Queen's Gate, Kensington Gardens",788
"12864",2020,17,351,190,186,"51.529423","-0.097122","Macclesfield Rd, St Lukes",376
"12865",2020,17,352,146,171,"51.486965","-0.116625","Vauxhall Street, Vauxhall",317
"12866",2020,17,353,101,109,"51.49459148","-0.134234258","Greycoat Street , Westminster",210
"12867",2020,17,354,237,251,"51.506767","-0.123702","Northumberland Avenue, Strand",488
"12868",2020,17,356,361,382,"51.494412","-0.173881","South Kensington Station, South Kensington",743
"12869",2020,17,357,144,117,"51.520994","-0.139016","Howland Street, Fitzrovia",261
"12870",2020,17,358,83,68,"51.516226","-0.124826","High Holborn , Covent Garden",151
"12871",2020,17,359,78,81,"51.49782999","-0.135440826","Butler Place, Westminster",159
"12872",2020,17,360,154,154,"51.49675303","-0.138733562","Howick Place, Westminster",308
"12873",2020,17,361,100,88,"51.50391973","-0.11342629","Waterloo Station 2, Waterloo",188
"12874",2020,17,362,148,152,"51.536264","-0.133952","Royal College Street, Camden Town",300
"12875",2020,17,363,89,76,"51.5291212008901","-0.171185284853","Lord's, St. John's Wood",165
"12876",2020,17,364,94,91,"51.519656","-0.132339","Alfred Place, Bloomsbury",185
"12877",2020,17,365,132,104,"51.530344","-0.100168","City Road, Angel",236
"12878",2020,17,366,68,54,"51.5109192966489","-0.1511263847351","Millennium Hotel, Mayfair",122
"12879",2020,17,367,209,212,"51.5173721","-0.1642075","Harrowby Street, Marylebone",421
"12880",2020,17,368,242,248,"51.50024195","-0.15934065","Harriet Street, Knightsbridge",490
"12881",2020,17,370,57,52,"51.520205","-0.174593","Paddington Green, Paddington",109
"12882",2020,17,371,83,71,"51.49775","-0.10988","King Edward Walk, Waterloo",154
"12883",2020,17,372,30,15,"51.515208","-0.117863","Sardinia Street, Holborn",45
"12884",2020,17,373,56,58,"51.49980661","-0.176415994","Prince Consort Road, Knightsbridge",114
"12885",2020,17,374,128,146,"51.50402794","-0.11386436","Waterloo Station 1, Waterloo",274
"12886",2020,17,375,153,153,"51.50194596","-0.194392952","Kensington Town Hall, Kensington",306
"12887",2020,17,376,259,260,"51.49188409","-0.125674815","Millbank Tower, Pimlico",519
"12888",2020,17,377,120,117,"51.50535447","-0.113656543","Waterloo Bridge, South Bank",237
"12889",2020,17,378,137,153,"51.49559291","-0.179077626","Natural History Museum, South Kensington",290
"12890",2020,17,379,299,292,"51.51431171","-0.200838199","Turquoise Island, Notting Hill",591
"12891",2020,17,380,69,67,"51.50686435","-0.150666888","Stanhope Gate, Mayfair",136
"12892",2020,17,381,159,149,"51.51953043","-0.13577731","Charlotte Street, Fitzrovia",308
"12893",2020,17,382,92,82,"51.50935171","-0.14744969","Farm Street, Mayfair",174
"12894",2020,17,383,124,125,"51.51310333","-0.13121385","Frith Street, Soho",249
"12895",2020,17,384,207,205,"51.496481","-0.192404","Marloes Road, Kensington",412
"12896",2020,17,386,292,300,"51.51352755","-0.130110822","Moor Street, Soho",592
"12897",2020,17,387,349,322,"51.49369988","-0.121394101","Fire Brigade Pier, Vauxhall",671
"12898",2020,17,388,183,184,"51.51070161","-0.121723604","Southampton Street, Strand",367
"12899",2020,17,389,51,46,"51.51013066","-0.155757901","Upper Grosvenor Street, Mayfair",97
"12900",2020,17,390,100,100,"51.521776","-0.068856","Buxton Street 1, Shoreditch",200
"12901",2020,17,392,177,192,"51.49942855","-0.179702476","Imperial College, Knightsbridge",369
"12902",2020,17,393,64,68,"51.51733427","-0.103604248","Snow Hill, Farringdon",132
"12903",2020,17,394,206,198,"51.524826","-0.176268","Aberdeen Place, St. John's Wood",404
"12904",2020,17,395,304,303,"51.492462","-0.159919","Cadogan Gardens, Chelsea",607
"12905",2020,17,396,149,155,"51.51809","-0.163609","Shouldham Street, Marylebone",304
"12906",2020,17,397,345,332,"51.51348","-0.17977","Devonshire Terrace, Bayswater",677
"12907",2020,17,398,304,289,"51.502319","-0.200742","Holland Park, Kensington",593
"12908",2020,17,399,255,247,"51.52261762","-0.071653961","Brick Lane Market, Shoreditch",502
"12909",2020,17,400,125,126,"51.517703","-0.154106","George Street, Marylebone",251
"12910",2020,17,401,266,281,"51.528187","-0.075375","Columbia Road, Shoreditch",547
"12911",2020,17,402,105,106,"51.52289229","-0.171681991","Penfold Street, Marylebone",211
"12912",2020,17,403,178,166,"51.51689296","-0.158249929","George Place Mews, Marylebone",344
"12913",2020,17,404,478,476,"51.50204238","-0.184400221","Palace Gate, Kensington Gardens",954
"12914",2020,17,405,376,387,"51.49418566","-0.18267094","Gloucester Road Station, South Kensington",763
"12915",2020,17,409,336,335,"51.493146","-0.099828","Strata, Elephant & Castle",671
"12916",2020,17,410,300,281,"51.519968","-0.169774","Edgware Road Station, Marylebone",581
"12917",2020,17,411,319,316,"51.49337264","-0.09968067","Walworth Road, Elephant & Castle",635
"12918",2020,17,412,147,149,"51.488105","-0.110121","Cleaver Street, Kennington",296
"12919",2020,17,419,491,484,"51.485821","-0.149004","Chelsea Bridge, Pimlico",975
"12920",2020,17,420,82,87,"51.504043","-0.105312","Southwark Station 1, Southwark",169
"12921",2020,17,421,128,129,"51.504044","-0.104778","Southwark Station 2, Southwark",257
"12922",2020,17,423,255,232,"51.49456127","-0.15393398","Eaton Square (South), Belgravia",487
"12923",2020,17,424,214,200,"51.490491","-0.149186","Ebury Bridge, Pimlico",414
"12924",2020,17,425,175,134,"51.533379","-0.139159","Harrington Square 2, Camden Town",309
"12925",2020,17,426,201,206,"51.493072","-0.129925","Vincent Street, Pimlico",407
"12926",2020,17,427,300,277,"51.51397065","-0.09294031","Cheapside, Bank",577
"12927",2020,17,428,457,473,"51.499917","-0.174554","Exhibition Road, Knightsbridge",930
"12928",2020,17,430,159,163,"51.48902","-0.17524","South Parade, Chelsea",322
"12929",2020,17,431,100,110,"51.534474","-0.122203","Crinan Street, King's Cross",210
"12930",2020,17,432,155,152,"51.496957","-0.173894","Exhibition Road Museums, South Kensington",307
"12931",2020,17,433,102,92,"51.524564","-0.116279","Wren Street, Holborn",194
"12932",2020,17,435,188,192,"51.488852","-0.105593","Kennington Station, Kennington",380
"12933",2020,17,436,45,38,"51.51824","-0.11655","Red Lion Street, Holborn",83
"12934",2020,17,437,236,247,"51.488124","-0.120903","Vauxhall Walk, Vauxhall",483
"12935",2020,17,439,72,61,"51.5338","-0.118677","Killick Street, King's Cross",133
"12936",2020,17,440,292,274,"51.483145","-0.113134","Kennington Oval, Oval",566
"12937",2020,17,441,178,157,"51.495656","-0.114605","Sail Street, Vauxhall",335
"12938",2020,17,442,151,146,"51.510101","-0.211358","Walmer Road, Avondale",297
"12939",2020,17,443,195,178,"51.515256","-0.058641","Philpot Street, Whitechapel",373
"12940",2020,17,444,153,155,"51.52568","-0.055312","Bethnal Green Garden, Bethnal Green",308
"12941",2020,17,445,129,120,"51.52388","-0.065076","Cheshire Street, Bethnal Green",249
"12942",2020,17,446,163,152,"51.528936","-0.055894","York Hall, Bethnal Green",315
"12943",2020,17,447,145,138,"51.493381","-0.007542","Jubilee Crescent, Cubitt Town",283
"12944",2020,17,448,251,246,"51.50623","-0.02296","Fisherman's Walk West, Canary Wharf",497
"12945",2020,17,449,320,331,"51.511088","-0.057159","Shadwell Station, Shadwell",651
"12946",2020,17,450,151,142,"51.515975","-0.053177","Jubilee Street, Stepney",293
"12947",2020,17,451,187,174,"51.504719","-0.063531","Hermitage Court, Wapping",361
"12948",2020,17,452,267,277,"51.505697","-0.070542","St. Katharine's Way, Tower",544
"12949",2020,17,453,243,234,"51.508447","-0.055167","Garnet Street, Shadwell",477
"12950",2020,17,454,222,220,"51.487679","-0.021582","Napier Avenue, Millwall",442
"12951",2020,17,455,186,181,"51.49447","-0.014409","East Ferry Road, Cubitt Town",367
"12952",2020,17,456,200,242,"51.538071","-0.144664","Parkway, Camden Town",442
"12953",2020,17,458,277,267,"51.504749","-0.057544","Wapping Lane, Wapping",544
"12954",2020,17,459,288,298,"51.535179","-0.03338","Gunmakers Lane, Old Ford",586
"12955",2020,17,460,239,245,"51.516196","-0.029138","Burdett Road, Mile End",484
"12956",2020,17,461,105,99,"51.516","-0.038775","Aston Street, Stepney",204
"12957",2020,17,462,453,485,"51.541603","-0.138853","Bonny Street, Camden Town",938
"12958",2020,17,463,95,90,"51.534776","-0.071881","Thurtle Road, Haggerston",185
"12959",2020,17,464,77,58,"51.51417","-0.052099","St. Mary & St. Michael Church, Stepney",135
"12960",2020,17,465,227,207,"51.53558","-0.08249","Pitfield Street North,Hoxton",434
"12961",2020,17,466,172,171,"51.534464","-0.076341","Whiston Road, Haggerston",343
"12962",2020,17,467,158,137,"51.523538","-0.030556","Southern Grove, Bow",295
"12963",2020,17,468,84,65,"51.521564","-0.022694","Cantrell Road, Bow",149
"12964",2020,17,469,176,181,"51.513757","-0.020467","Lindfield Street, Poplar",357
"12965",2020,17,470,195,194,"51.530535","-0.025492","Mostyn Grove, Bow",389
"12966",2020,17,471,167,174,"51.533283","-0.028155","Hewison Street, Old Ford",341
"12967",2020,17,472,72,64,"51.529452","-0.027616","Malmesbury Road, Bow",136
"12968",2020,17,473,85,92,"51.496137","-0.019355","Millharbour, Millwall",177
"12969",2020,17,475,285,296,"51.499041","-0.020157","Lightermans Road, Millwall",581
"12970",2020,17,476,233,254,"51.489096","-0.009205","Stebondale Street, Cubitt Town",487
"12971",2020,17,477,163,163,"51.49109","-0.018716","Spindrift Avenue, Millwall",326
"12972",2020,17,478,305,322,"51.521889","-0.04667","Stepney Green Station, Stepney",627
"12973",2020,17,479,266,272,"51.527152","-0.058005","Pott Street, Bethnal Green",538
"12974",2020,17,480,537,546,"51.5128711","-0.0389866","Flamborough Street, Limehouse",1083
"12975",2020,17,481,445,464,"51.487129","-0.009001","Saunders Ness Road, Cubitt Town",909
"12976",2020,17,483,209,190,"51.51328","-0.047784","Albert Gardens, Stepney",399
"12977",2020,17,484,234,230,"51.528828","-0.013258","Bromley High Street, Bow",464
"12978",2020,17,485,247,253,"51.531127","-0.048017","Old Ford Road, Bethnal Green",500
"12979",2020,17,486,245,247,"51.525645","-0.069543","Granby Street, Shoreditch",492
"12980",2020,17,487,137,135,"51.511811","-0.025626","Canton Street, Poplar",272
"12981",2020,17,488,170,148,"51.506946","-0.058681","Reardon Street, Wapping",318
"12982",2020,17,489,206,190,"51.513074","-0.064094","Christian Street, Whitechapel",396
"12983",2020,17,490,106,101,"51.508622","-0.065006","Pennington Street, Wapping",207
"12984",2020,17,491,136,117,"51.522507","-0.041378","Queen Mary's, Mile End",253
"12985",2020,17,492,273,249,"51.525501","-0.032267204","Maplin Street, Mile End",522
"12986",2020,17,494,39,38,"51.50196","-0.016251","South Quay East, Canary Wharf",77
"12987",2020,17,495,403,391,"51.528169","-0.018703","Bow Church Station, Bow",794
"12988",2020,17,496,249,251,"51.52512","-0.015578","Devons Road, Bow",500
"12989",2020,17,497,141,130,"51.526149","-0.027396845","Merchant Street, Bow",271
"12990",2020,17,498,179,183,"51.527058","-0.025296","Bow Road Station, Bow",362
"12991",2020,17,499,248,247,"51.519265","-0.021345","Furze Green, Bow",495
"12992",2020,17,500,368,353,"51.519806","-0.055731","Ansell House, Stepney",721
"12993",2020,17,501,158,153,"51.522561","-0.054883","Cephas Street, Bethnal Green",311
"12994",2020,17,502,381,389,"51.53341","-0.049591815","Bonner Gate, Victoria Park",770
"12995",2020,17,503,284,314,"51.520893","-0.051394","Cleveland Way, Stepney",598
"12996",2020,17,504,140,139,"51.496454","-0.009506","St. John's Park, Cubitt Town",279
"12997",2020,17,505,167,170,"51.520398","-0.026768","Ackroyd Drive, Bow",337
"12998",2020,17,506,169,170,"51.517475","-0.075855","Bell Lane, Liverpool Street",339
"12999",2020,17,507,120,120,"51.528692","-0.059091","Clarkson Street, Bethnal Green",240
"13000",2020,17,508,151,154,"51.519362","-0.074431","Fournier Street, Whitechapel",305
"13001",2020,17,509,39,37,"51.517842","-0.090075","Fore Street, Guildhall",76
"13002",2020,17,510,523,509,"51.509303","-0.025996","Westferry DLR, Limehouse",1032
"13003",2020,17,511,342,351,"51.511066","-0.053558","Sutton Street, Shadwell",693
"13004",2020,17,512,257,260,"51.532091","-0.06142","Pritchard's Road, Bethnal Green",517
"13005",2020,17,513,184,192,"51.5142228","-0.055656","Watney Market, Stepney",376
"13006",2020,17,514,118,118,"51.516204","-0.155525","Portman Square, Marylebone",236
"13007",2020,17,515,104,100,"51.500088","-0.211316","Russell Gardens, Olympia",204
"13008",2020,17,516,168,171,"51.5112","-0.014438","Chrisp Street Market, Poplar",339
"13009",2020,17,517,123,134,"51.532513","-0.033085","Ford Road, Old Ford",257
"13010",2020,17,518,180,182,"51.528224","-0.037471","Antill Road, Mile End",362
"13011",2020,17,519,82,83,"51.518811","-0.011662","Teviot Street, Poplar",165
"13012",2020,17,520,170,150,"51.526041","-0.047218","Bancroft Road, Bethnal Green",320
"13013",2020,17,521,303,312,"51.534137","-0.037366","Driffield Road, Old Ford",615
"13014",2020,17,522,301,300,"51.525941","-0.036017","Clinton Road, Mile End",601
"13015",2020,17,523,143,137,"51.51549","-0.013475","Langdon Park, Poplar",280
"13016",2020,17,524,264,233,"51.511654","-0.179668","Lancaster Gate , Bayswater",497
"13017",2020,17,526,182,185,"51.503143","-0.008428","Lancaster Drive, Blackwall",367
"13018",2020,17,527,164,189,"51.503802","-0.215808","Hansard Mews, Holland Park",353
"13019",2020,17,528,41,34,"51.507326","-0.145827","Clarges Street, Mayfair",75
"13020",2020,17,529,140,145,"51.486892","-0.170983","Manresa Road, Chelsea",285
"13021",2020,17,530,167,170,"51.508896","-0.012413","Newby Place, Poplar",337
"13022",2020,17,531,297,299,"51.530326","-0.042744","Twig Folly Bridge, Mile End",596
"13023",2020,17,532,170,213,"51.50357","-0.020068","Jubilee Plaza, Canary Wharf",383
"13024",2020,17,533,164,154,"51.528222","-0.069743","Wellington Row, Bethnal Green",318
"13025",2020,17,534,309,302,"51.531864","-0.066035","Goldsmith's Row, Haggerston",611
"13026",2020,17,535,395,396,"51.537349","-0.147154","Gloucester Avenue, Camden Town",791
"13027",2020,17,536,111,99,"51.53385","-0.06992","Queensbridge Road, Haggerston",210
"13028",2020,17,537,209,215,"51.51793","-0.067937","Old Montague Street, Whitechapel",424
"13029",2020,17,538,170,171,"51.508981","-0.00699","Naval Row, Blackwall",341
"13030",2020,17,540,319,303,"51.528302","-0.144466","Albany Street, The Regent's Park",622
"13031",2020,17,541,533,533,"51.506613","-0.142844","Green Park Station, Mayfair",1066
"13032",2020,17,542,278,288,"51.514115","-0.033828","Salmon Lane, Limehouse",566
"13033",2020,17,543,74,58,"51.509591","-0.204666","Lansdowne Walk, Ladbroke Grove",132
"13034",2020,17,544,112,110,"51.526153","-0.102208","Percival Street, Finsbury",222
"13035",2020,17,545,220,225,"51.539957","-0.145246","Arlington Road, Camden Town",445
"13036",2020,17,546,94,90,"51.517428","-0.107987","New Fetter Lane, Holborn",184
"13037",2020,17,547,492,497,"51.509474","-0.002275","East India DLR, Blackwall",989
"13038",2020,17,548,60,72,"51.498386","-0.107913","Westminster Bridge Road, Elephant & Castle",132
"13039",2020,17,549,170,172,"51.49605","-0.104193","Gaywood  Street, Elephant & Castle",342
"13040",2020,17,550,109,98,"51.521564","-0.039264","Harford Street, Mile End",207
"13041",2020,17,551,74,78,"51.505772","-0.016460175","Import Dock, Canary Wharf",152
"13042",2020,17,552,135,116,"51.511542","-0.056667","Watney Street, Shadwell",251
"13043",2020,17,553,824,855,"51.535678","-0.062546","Regent's Row , Haggerston",1679
"13044",2020,17,554,105,107,"51.513548","-0.005659","Aberfeldy Street, Poplar",212
"13045",2020,17,556,154,132,"51.502661","-0.021596","Heron Quays DLR, Canary Wharf",286
"13046",2020,17,557,110,115,"51.51601","-0.0985","King Edward Street, St Pauls",225
"13047",2020,17,558,182,193,"51.493978","-0.127554","Page Street, Westminster",375
"13048",2020,17,559,209,206,"51.501391","-0.205991","Abbotsbury Road, Holland Park",415
"13049",2020,17,560,76,57,"51.511624","-0.205921","Ladbroke Grove Central, Ladbroke Grove",133
"13050",2020,17,561,157,135,"51.518369","-0.043371","Rectory Square, Stepney",292
"13051",2020,17,562,96,81,"51.51746","-0.12335","Bury Place, Holborn",177
"13052",2020,17,563,155,138,"51.499286","-0.009152","Preston's Road, Cubitt Town",293
"13053",2020,17,564,271,305,"51.509943","-0.117619","Somerset House, Strand",576
"13054",2020,17,565,87,85,"51.521905","-0.063386","Selby Street, Whitechapel",172
"13055",2020,17,566,253,260,"51.509158","-0.224103","Westfield Ariel Way, White City",513
"13056",2020,17,568,378,396,"51.51616","-0.18697","Bishop's Bridge Road West, Bayswater",774
"13057",2020,17,569,181,156,"51.53213","-0.08299","Pitfield Street Central, Hoxton",337
"13058",2020,17,570,270,260,"51.503083","-0.017676","Upper Bank Street, Canary Wharf",530
"13059",2020,17,571,118,135,"51.506256","-0.218337","Westfield Southern Terrace ,Shepherd's Bush",253
"13060",2020,17,572,358,370,"51.539099","-0.141728","Greenland Road, Camden Town",728
"13061",2020,17,573,425,475,"51.485587","-0.18119","Limerston Street, West Chelsea",900
"13062",2020,17,574,237,222,"51.53356","-0.09315","Eagle Wharf Road, Hoxton",459
"13063",2020,17,576,236,238,"51.497304","-0.022793","Alpha Grove, Millwall",474
"13064",2020,17,577,213,219,"51.528869","-0.047548","Globe Town Market, Bethnal Green",432
"13065",2020,17,578,93,85,"51.527607","-0.057133","Hollybush Gardens, Bethnal Green",178
"13066",2020,17,579,361,399,"51.511246","-0.093051","Queen Street 2, Bank",760
"13067",2020,17,580,332,326,"51.48692917","-0.102996299","Doddington Grove, Kennington",658
"13068",2020,17,581,236,218,"51.519167","-0.147983","New Cavendish Street, Marylebone",454
"13069",2020,17,583,402,401,"51.497622","-0.125978","Abingdon Green, Westminster",803
"13070",2020,17,584,238,245,"51.51244","-0.19096","Ilchester Gardens, Bayswater",483
"13071",2020,17,586,103,93,"51.490645","-0.014582","Mudchute DLR, Cubitt Town",196
"13072",2020,17,587,256,262,"51.50964","-0.08497","Monument Street, Monument",518
"13073",2020,17,588,95,80,"51.52959","-0.0801","Hoxton Street, Hoxton",175
"13074",2020,17,589,480,472,"51.487196","-0.179369","Drayton Gardens, West Chelsea",952
"13075",2020,17,590,133,120,"51.53256","-0.16862","Greenberry Street, St.John's Wood",253
"13076",2020,17,592,172,150,"51.5171","-0.18377","Bishop's Bridge Road East, Bayswater",322
"13077",2020,17,593,99,96,"51.531066","-0.11934","Northdown Street, King's Cross",195
"13078",2020,17,594,39,32,"51.513875","-0.117774","Kingsway Southbound, Strand",71
"13079",2020,17,595,196,196,"51.493267","-0.21985","Hammersmith Road, Hammersmith",392
"13080",2020,17,596,320,342,"51.472817","-0.199783","Parson's Green , Parson's Green",662
"13081",2020,17,597,257,250,"51.473471","-0.20782","Fulham Park Road, Fulham",507
"13082",2020,17,598,315,325,"51.494499","-0.228188","Southerton Road, Hammersmith",640
"13083",2020,17,599,138,141,"51.485743","-0.223616","Manbre Road, Hammersmith",279
"13084",2020,17,600,471,458,"51.481747","-0.124642","South Lambeth Road, Vauxhall",929
"13085",2020,17,601,302,311,"51.514767","-0.225787","BBC White City, White City",613
"13086",2020,17,602,288,293,"51.472993","-0.133972","Union Grove, Wandsworth Road",581
"13087",2020,17,603,319,326,"51.477839","-0.116493","Caldwell Street, Stockwell",645
"13088",2020,17,604,83,81,"51.538792","-0.138535","St Martins Close, Camden Town",164
"13089",2020,17,605,195,206,"51.520331","-0.163667","Seymour Place, Marylebone",401
"13090",2020,17,606,111,104,"51.504199","-0.210941","Addison Road, Holland Park",215
"13091",2020,17,607,274,287,"51.468814","-0.210279","Putney Bridge Station, Fulham",561
"13092",2020,17,608,21,23,"51.491093","-0.216493","Colet Gardens, Hammersmith",44
"13093",2020,17,609,124,126,"51.46512358","-0.157788279","Sugden Road, Clapham",250
"13094",2020,17,610,384,378,"51.48256792","-0.172078187","Danvers Street, West Chelsea",762
"13095",2020,17,611,223,243,"51.50646524","-0.208486599","Princedale Road , Holland Park",466
"13096",2020,17,612,343,342,"51.46925984","-0.141812513","Wandsworth Rd, Isley Court, Wandsworth Road",685
"13097",2020,17,613,337,356,"51.50403821","-0.217400093","Woodstock Grove, Shepherd's Bush",693
"13098",2020,17,614,113,106,"51.47817208","-0.144690541","Bradmead, Battersea Park",219
"13099",2020,17,615,298,293,"51.4768851","-0.215895601","Finlay Street, Fulham",591
"13100",2020,17,616,216,214,"51.48102131","-0.209973497","Aintree Street, Fulham",430
"13101",2020,17,617,125,119,"51.47107905","-0.207842908","Elysium Place, Fulham",244
"13102",2020,17,618,279,286,"51.47625965","-0.193254007","Eel Brook Common, Walham Green",565
"13103",2020,17,619,164,191,"51.4737636","-0.197010096","Irene Road, Parsons Green",355
"13104",2020,17,620,194,213,"51.47518024","-0.167160736","Surrey Lane, Battersea",407
"13105",2020,17,621,205,227,"51.46086446","-0.187427294","Wandsworth Town Station, Wandsworth",432
"13106",2020,17,622,278,298,"51.50748124","-0.205535908","Lansdowne Road, Ladbroke Grove",576
"13107",2020,17,623,132,132,"51.46193072","-0.180791784","Nantes Close, Wandsworth",264
"13108",2020,17,624,295,297,"51.4729184","-0.132102704","Courland Grove, Wandsworth Road",592
"13109",2020,17,625,1072,1088,"51.47761941","-0.149551631","Queen's Circus, Battersea Park",2160
"13110",2020,17,626,280,275,"51.48438657","-0.20481514","Normand Park, West Kensington",555
"13111",2020,17,627,114,117,"51.4687905","-0.158230901","Holden Street, Battersea",231
"13112",2020,17,628,98,121,"51.46881971","-0.184318843","William Morris Way, Sands End",219
"13113",2020,17,629,91,96,"51.45995384","-0.190184054","Morie Street, Wandsworth",187
"13114",2020,17,630,259,256,"51.47073264","-0.126994068","Clarence Walk, Stockwell",515
"13115",2020,17,631,191,196,"51.4795017","-0.141770709","Battersea Park Road, Nine Elms",387
"13116",2020,17,632,73,104,"51.47053858","-0.163041605","Sheepcote Lane, Battersea",177
"13117",2020,17,633,348,317,"51.48959104","-0.209378594","Vereker Road, West Kensington",665
"13118",2020,17,634,141,126,"51.49434708","-0.215804559","Brook Green South, Brook Green",267
"13119",2020,17,635,207,214,"51.48606206","-0.214428378","Greyhound Road, Hammersmith",421
"13120",2020,17,636,188,186,"51.46706414","-0.193502076","South Park, Sands End",374
"13121",2020,17,637,228,230,"51.45787019","-0.174691623","Spencer Park, Wandsworth Common",458
"13122",2020,17,638,246,264,"51.46663393","-0.169821175","Falcon Road, Clapham Junction",510
"13123",2020,17,639,183,191,"51.48357068","-0.202038682","Coomer Place, West Kensington",374
"13124",2020,17,640,226,247,"51.47286577","-0.148059277","Silverthorne Road, Battersea",473
"13125",2020,17,641,235,244,"51.49824168","-0.117495865","Archbishop's Park, Waterloo",479
"13126",2020,17,642,141,136,"51.46916161","-0.174485792","Fawcett Close, Battersea",277
"13127",2020,17,643,224,222,"51.5190427","-0.204764421","All Saints' Road, Portobello",446
"13128",2020,17,644,180,172,"51.48373225","-0.223852256","Rainville Road, Hammersmith",352
"13129",2020,17,645,114,111,"51.50173215","-0.100292412","Great Suffolk Street, The Borough",225
"13130",2020,17,646,291,313,"51.49886563","-0.137424571","Buckingham Gate, Westminster",604
"13131",2020,17,647,236,237,"51.50035306","-0.217515071","Richmond Way, Shepherd's Bush",473
"13132",2020,17,648,158,137,"51.46904022","-0.19627483","Peterborough Road, Sands End",295
"13133",2020,17,649,227,248,"51.48180515","-0.18027465","World's End Place, West Chelsea",475
"13134",2020,17,650,359,369,"51.51687069","-0.213872396","St. Mark's Road, North Kensington",728
"13135",2020,17,651,201,185,"51.48089844","-0.183853573","Thorndike Close, West Chelsea",386
"13136",2020,17,652,88,72,"51.51148696","-0.218190203","Evesham Street, Avondale",160
"13137",2020,17,653,284,297,"51.47084722","-0.17070367","Simpson Street, Clapham Junction",581
"13138",2020,17,654,214,217,"51.48267821","-0.117661574","Ashmole Estate, Oval",431
"13139",2020,17,655,190,168,"51.48294452","-0.219346128","Crabtree Lane, Fulham",358
"13140",2020,17,656,64,86,"51.46841875","-0.199135704","Broomhouse Lane, Parsons Green",150
"13141",2020,17,657,232,220,"51.4996806","-0.221791552","Blythe Road West, Shepherd's Bush",452
"13142",2020,17,658,690,693,"51.47729232","-0.16478637","Ethelburga Estate, Battersea Park",1383
"13143",2020,17,659,203,214,"51.511934","-0.10307894","Blackfriars Station, St. Paul's",417
"13144",2020,17,660,163,154,"51.49087074","-0.206029743","West Kensington Station, West Kensington",317
"13145",2020,17,661,416,427,"51.51632095","-0.202608612","All Saints Church, Portobello",843
"13146",2020,17,662,368,346,"51.48498496","-0.167919869","Phene Street, Chelsea",714
"13147",2020,17,663,159,146,"51.51323001","-0.211593602","Clarendon Road, Avondale",305
"13148",2020,17,664,259,273,"51.474376","-0.155442787","Austin Road, Battersea Park",532
"13149",2020,17,665,234,247,"51.46108367","-0.191722864","Smugglers Way, Wandsworth",481
"13150",2020,17,666,274,221,"51.49610093","-0.208158259","Olympia Way, Olympia",495
"13151",2020,17,667,297,309,"51.5015946","-0.222293381","Shepherd's Bush Road North, Shepherd's Bush",606
"13152",2020,17,668,573,587,"51.49422354","-0.236769936","Ravenscourt Park Station, Hammersmith",1160
"13153",2020,17,669,223,210,"51.47614939","-0.1232585","Teversham Lane, Stockwell",433
"13154",2020,17,670,243,241,"51.46718562","-0.152248582","Ashley Crescent, Battersea",484
"13155",2020,17,671,199,191,"51.475089","-0.201968","Parsons Green Station, Parsons Green",390
"13156",2020,17,673,363,357,"51.46517078","-0.18038939","Hibbert Street, Battersea",720
"13157",2020,17,674,196,183,"51.53546778","-0.11619105","Carnegie Street, King's Cross",379
"13158",2020,17,675,224,231,"51.46348914","-0.182126248","Usk Road, Clapham Junction",455
"13159",2020,17,676,305,307,"51.47787084","-0.126874471","Hartington Road, Stockwell",612
"13160",2020,17,677,159,170,"51.46866929","-0.146544642","Heath Road, Battersea",329
"13161",2020,17,678,72,70,"51.46231278","-0.211468596","Esmond Street, Putney",142
"13162",2020,17,679,124,125,"51.47453545","-0.170210533","Orbel Street, Battersea",249
"13163",2020,17,680,327,335,"51.47768469","-0.170329317","Westbridge Road, Battersea",662
"13164",2020,17,681,200,236,"51.47303687","-0.214749808","Bishop's Avenue, Fulham",436
"13165",2020,17,682,467,482,"51.48810829","-0.22660621","Crisp Road, Hammersmith",949
"13166",2020,17,683,232,234,"51.46506424","-0.163750945","Dorothy Road, Clapham Junction",466
"13167",2020,17,684,439,442,"51.45475251","-0.195197203","Neville Gill Close, Wandsworth",881
"13168",2020,17,685,229,226,"51.46067005","-0.198735357","Osiers Road, Wandsworth",455
"13169",2020,17,686,149,134,"51.48814438","-0.222456468","Beryl Road, Hammersmith",283
"13170",2020,17,687,215,210,"51.49760804","-0.21145598","Maclise Road, Olympia",425
"13171",2020,17,688,160,155,"51.46095151","-0.20066766","Northfields, Wandsworth",315
"13172",2020,17,689,134,132,"51.45922541","-0.180884959","Spanish Road, Clapham Junction",266
"13173",2020,17,690,131,129,"51.47047503","-0.152130083","Stanley Grove, Battersea",260
"13174",2020,17,691,297,346,"51.47946386","-0.195777222","Erin Close, Walham Green",643
"13175",2020,17,692,396,407,"51.54211855","-0.028941601","Cadogan Close, Victoria Park",803
"13176",2020,17,693,206,213,"51.464786","-0.215618902","Felsham Road, Putney",419
"13177",2020,17,694,288,297,"51.46071722","-0.216526155","Putney Rail Station, Putney",585
"13178",2020,17,695,611,620,"51.53638435","-0.102757578","Islington Green, Angel",1231
"13179",2020,17,696,129,118,"51.48728535","-0.217995921","Charing Cross Hospital, Hammersmith",247
"13180",2020,17,697,195,203,"51.53639219","-0.112721065","Charlotte Terrace, Angel",398
"13181",2020,17,698,217,202,"51.53908372","-0.070329419","Shoreditch Court, Haggerston",419
"13182",2020,17,699,110,103,"51.5366541","-0.07023031","Belford House, Haggerston",213
"13183",2020,17,700,279,277,"51.47696496","-0.174347066","Battersea Church Road, Battersea",556
"13184",2020,17,701,347,373,"51.47287627","-0.176267008","Vicarage Crescent, Battersea",720
"13185",2020,17,702,154,164,"51.52868155","-0.065550321","Durant Street, Bethnal Green",318
"13186",2020,17,703,106,106,"51.51505991","-0.10534448","St. Bride Street, Holborn",212
"13187",2020,17,704,146,136,"51.45682071","-0.202802098","Mexfield Road, East Putney",282
"13188",2020,17,705,188,191,NA,NA,NA,379
"13189",2020,17,706,178,225,"51.50215353","-0.083632928","Snowsfields, London Bridge",403
"13190",2020,17,707,169,175,"51.49021762","-0.215087092","Barons Court Station, West Kensington",344
"13191",2020,17,708,159,177,"51.46161068","-0.21614583","Disraeli Road, Putney",336
"13192",2020,17,709,135,145,"51.46321128","-0.215550761","Montserrat Road , Putney",280
"13193",2020,17,710,534,536,"51.47439218","-0.163347594","Albert Bridge Road, Battersea Park",1070
"13194",2020,17,711,180,192,"51.48335692","-0.216305546","Everington Street, Fulham",372
"13195",2020,17,712,272,265,"51.51854104","-0.034903714","Mile End Stadium, Mile End",537
"13196",2020,17,713,266,286,"51.54100708","-0.14326094","Hawley Crescent, Camden Town",552
"13197",2020,17,714,125,124,"51.47311696","-0.137235175","Stewart's Road, Wandsworth Road",249
"13198",2020,17,715,193,174,"51.51563007","-0.049067243","Aylward Street, Stepney",367
"13199",2020,17,716,194,176,"51.51542791","-0.02356501","Stainsby Road , Poplar",370
"13200",2020,17,717,496,499,"51.53658514","-0.075885686","Dunston Road , Haggerston",995
"13201",2020,17,718,225,277,"51.53571683","-0.060291813","Ada Street, Hackney Central",502
"13202",2020,17,719,449,457,"51.53642464","-0.054162264","Victoria Park Road, Hackney Central",906
"13203",2020,17,720,218,195,"51.48724429","-0.205279052","Star Road, West Kensington",413
"13204",2020,17,721,226,216,"51.53603947","-0.026262677","Wendon Street, Old Ford",442
"13205",2020,17,722,130,121,"51.52458353","-0.058631453","Finnis Street, Bethnal Green",251
"13206",2020,17,723,447,418,"51.46822047","-0.190346493","Stephendale Road, Sands End",865
"13207",2020,17,724,161,134,"51.45799126","-0.184806157","Alma Road, Wandsworth",295
"13208",2020,17,725,335,318,"51.491327","-0.096518684","Walworth Square, Walworth",653
"13209",2020,17,726,192,197,"51.47505096","-0.150908371","Alfreda Street, Battersea Park",389
"13210",2020,17,727,308,288,"51.47569809","-0.20587627","Chesilton Road, Fulham",596
"13211",2020,17,728,212,216,"51.46199911","-0.206240805","Putney Bridge Road, East Putney",428
"13212",2020,17,729,294,281,"51.47893931","-0.208485293","St. Peter's Terrace, Fulham",575
"13213",2020,17,730,402,428,"51.49208492","-0.229116862","Bridge Avenue, Hammersmith",830
"13214",2020,17,731,147,145,"51.47727637","-0.189210466","Michael Road, Walham Green",292
"13215",2020,17,732,445,454,"51.50630441","-0.087262995","Duke Street Hill, London Bridge",899
"13216",2020,17,733,54,73,"51.50542628","-0.150817316","Park Lane, Mayfair",127
"13217",2020,17,734,168,167,"51.46230566","-0.175407201","Plough Terrace, Clapham Junction",335
"13218",2020,17,735,97,123,"51.46489445","-0.17302926","Grant Road East, Clapham Junction",220
"13219",2020,17,736,125,123,"51.50659035","-0.216104479","Queensdale Road, Shepherd's Bush",248
"13220",2020,17,737,437,462,"51.47993289","-0.19411695","Fulham Broadway, Walham Green",899
"13221",2020,17,738,185,200,"51.47514228","-0.187278987","Imperial Road, Sands End",385
"13222",2020,17,739,265,279,"51.48176572","-0.185273723","Hortensia Road, West Brompton",544
"13223",2020,17,740,84,68,"51.51092871","-0.214594781","Sirdar Road, Avondale",152
"13224",2020,17,741,82,72,"51.5129814","-0.219486603","Freston Road, Avondale",154
"13225",2020,17,742,311,326,"51.51510818","-0.208565479","Blenheim Crescent, Ladbroke Grove",637
"13226",2020,17,743,139,135,"51.46079243","-0.212607684","Oxford Road, Putney",274
"13227",2020,17,744,84,81,"51.46745485","-0.172293499","Ingrave Street, Clapham Junction",165
"13228",2020,17,745,178,165,"51.47816972","-0.18243547","Upcerne Road, West Chelsea",343
"13229",2020,17,746,239,255,"51.4795738","-0.17903854","Lots Road, West Chelsea",494
"13230",2020,17,747,243,230,"51.48796408","-0.161765173","Ormonde Gate, Chelsea",473
"13231",2020,17,748,254,253,"51.53727795","-0.079201849","Hertford Road, De Beauvoir Town",507
"13232",2020,17,749,446,465,"51.53932857","-0.074284675","Haggerston Road, Haggerston",911
"13233",2020,17,750,83,102,"51.4710956","-0.157850096","Culvert Road, Battersea",185
"13234",2020,17,751,50,48,"51.51612862","-0.120909408","Newton Street, Covent Garden",98
"13235",2020,17,754,71,60,"51.5129006","-0.214762686","Grenfell Road, Avondale",131
"13236",2020,17,755,280,273,"51.48512191","-0.174971902","The Vale, Chelsea",553
"13237",2020,17,756,501,515,"51.47515398","-0.159169801","Prince of Wales Drive, Battersea Park",1016
"13238",2020,17,757,361,357,"51.48795853","-0.187404506","Harcourt Terrace, West Brompton",718
"13239",2020,17,758,323,323,"51.51787005","-0.201005397","Westbourne Park Road, Portobello",646
"13240",2020,17,759,70,59,"51.52456169","-0.165668686","Broadley Terrace, Marylebone",129
"13241",2020,17,760,105,92,"51.52526975","-0.163795009","Rossmore Road, Marylebone",197
"13242",2020,17,761,146,154,"51.48321729","-0.211860644","Humbolt Road, Fulham",300
"13243",2020,17,762,872,897,"51.50070305","-0.129698963","Storey's Gate, Westminster",1769
"13244",2020,17,763,279,256,"51.52059714","-0.032566533","Mile End Park Leisure Centre, Mile End",535
"13245",2020,17,764,265,309,"51.46239255","-0.16829214","St. John's Road, Clapham Junction",574
"13246",2020,17,765,141,117,"51.46760141","-0.20682737","Ranelagh Gardens, Fulham",258
"13247",2020,17,766,270,284,"51.45752945","-0.192165613","Ram Street, Wandsworth",554
"13248",2020,17,767,81,63,"51.45705988","-0.200806304","Santos Road, Wandsworth",144
"13249",2020,17,768,895,908,"51.46134382","-0.159322467","Clapham Common North Side, Clapham Common",1803
"13250",2020,17,769,194,213,"51.473611","-0.191803","Sandilands Road, Walham Green",407
"13251",2020,17,770,182,191,"51.491026","-0.209121","Gwendwr Road, West Kensington",373
"13252",2020,17,771,135,133,"51.509224","-0.216016","Rifle Place, Avondale",268
"13253",2020,17,772,435,440,"51.47250956","-0.122831913","Binfield Road, Stockwell",875
"13254",2020,17,773,173,182,"51.511891","-0.107349","Tallis Street, Temple",355
"13255",2020,17,774,134,105,"51.470131","-0.20464","Hurlingham Park, Parsons Green",239
"13256",2020,17,775,187,205,"51.496664","-0.223868","Little Brook Green, Brook Green",392
"13257",2020,17,776,267,257,"51.460333","-0.167029","Abyssinia Close, Clapham Junction",524
"13258",2020,17,777,112,117,"51.4619230679","-0.165297856693","Limburg Road, Clapham Junction",229
"13259",2020,17,779,119,105,"51.514449","-0.077178979","Houndsditch, Aldgate",224
"13260",2020,17,780,477,486,"51.474665","-0.18316517","Imperial Wharf Station, Sands End",963
"13261",2020,17,781,102,92,"51.495898","-0.173009","Victoria & Albert Museum, South Kensington",194
"13262",2020,17,782,369,367,"51.483911","-0.19760944","Halford Road, West Kensington",736
"13263",2020,17,783,246,243,"51.5403115","-0.021630359","Monier Road, Hackney Wick",489
"13264",2020,17,784,538,547,"51.546326","-0.00993526","East Village, Queen Elizabeth Olympic Park",1085
"13265",2020,17,785,793,825,"51.54094","-0.010510565","Aquatic Centre, Queen Elizabeth Olympic Park",1618
"13266",2020,17,786,666,686,"51.549369","-0.015717614","Lee Valley VeloPark, Queen Elizabeth Olympic Park",1352
"13267",2020,17,787,804,810,"51.546805","-0.01469126","Timber Lodge, Queen Elizabeth Olympic Park",1614
"13268",2020,17,789,794,788,"51.538718","-0.011889482","Podium, Queen Elizabeth Olympic Park",1582
"13269",2020,17,790,302,319,"51.541793","-0.00481","Stratford Station, Stratford",621
"13270",2020,17,792,147,138,"51.505461","-0.10454093","Blackfriars Road, Southwark",285
"13271",2020,17,793,123,100,"51.528279","-0.11955857","Cromer Street, Bloomsbury",223
"13272",2020,17,795,36,36,"51.527068","-0.13186102","Euston Square Gardens, Euston",72
"13273",2020,17,796,115,86,"51.524","-0.12640984","Coram Street, Bloomsbury",201
"13274",2020,17,797,130,123,"51.5293","-0.12827903","Ossulston Street, Somers Town",253
"13275",2020,17,798,88,84,"51.5301998755","-0.122299440803","Birkenhead Street, King's Cross",172
"13276",2020,17,799,75,90,"51.4976984561","-0.137598896295","Kings Gate House, Westminster",165
"13277",2020,17,801,138,130,"51.5052241745","-0.0980318118664","Lavington Street, Bankside",268
"13278",2020,17,802,343,322,"51.4765900593","-0.118256789081","Albert Square, Stockwell",665
"13279",2020,17,803,130,119,"51.5054099403","-0.0983410884509","Southwark Street, Bankside",249
"13280",2020,17,804,267,254,"51.5346677396","-0.125078652873","Good's Way, King's Cross",521
"13281",2020,17,806,150,147,"51.5372405623","-0.124807385707","Handyside Street, King's Cross",297
"13282",2020,17,807,457,460,"51.5212","-0.20888818","Bevington Road West, North Kensington",917
"13283",2020,17,809,97,103,"51.5162778834","-0.118272991635","Lincoln's Inn Fields, Holborn",200
"13284",2020,17,810,119,110,"51.5067252868","-0.0988072461627","Tate Modern, Bankside",229
"13285",2020,17,811,515,510,"51.5057030357","-0.0277727426235","Westferry Circus, Canary Wharf",1025
"13286",2020,17,812,342,348,"51.5487311915","-0.0226065549321","Here East North, Queen Elizabeth Olympic Park",690
"13287",2020,17,813,51,120,"51.4878074485","-0.122759625866","New Spring Gardens Walk, Vauxhall",171
"13288",2020,17,814,311,318,"51.4714330677","-0.123670735702","Clapham Road, Lingham Street, Stockwell",629
"13289",2020,17,815,518,523,"51.5000891978","-0.116628700672","Lambeth Palace Road, Waterloo",1041
"13290",2020,17,816,82,85,"51.5465327935","-0.0205975904647","Here East South, Queen Elizabeth Olympic Park",167
"13291",2020,17,817,368,372,"51.4813354746","-0.138212295869","Riverlight South, Nine Elms",740
"13292",2020,17,818,580,599,"51.501513","-0.12382322","Westminster Pier, Westminster",1179
"13293",2020,17,819,108,96,"51.50621","-0.114842","Belvedere Road 2, South Bank",204
"13294",2020,17,820,171,161,"51.492807","-0.091938","Victory Place, Walworth",332
"13295",2020,17,821,778,791,"51.4835074867","-0.147714557371","Battersea Power Station, Battersea Park",1569
"13296",2020,17,826,176,185,"51.496863","-0.1429434","Allington Street, Victoria",361
"13297",2020,17,827,351,350,"51.479601","-0.11147178","Cranmer Road, Stockwell",701
"13298",2020,17,828,280,299,"51.473874","-0.11258096","Normandy Road, Stockwell",579
"13299",2020,17,829,190,207,"51.469217","-0.11268674","Wynne Road, Stockwell",397
"13300",2020,17,830,237,249,"51.469202","-0.11902256","Sidney Road, Stockwell",486
"13301",2020,17,831,245,261,"51.466232","-0.11317995","St John's Crescent, Brixton",506
"13302",2020,17,832,513,524,"51.464019","-0.11578197","Ferndale Road, Brixton",1037
"13303",2020,17,833,708,713,"51.460232","-0.11537509","Saltoun Road, Brixton",1421
"13304",2020,17,834,552,567,"51.477966","-0.14785703","Gas Holders, Battersea Park",1119
"13305",2020,17,835,83,80,"51.516785","-0.10494775","Farringdon Street, Holborn",163
"13306",2020,17,836,283,280,"51.541596","-0.12544145","York Way, Kings Cross",563
"13307",2020,17,838,74,69,"51.518093","-0.0914017","Fore Street Avenue, Guildhall",143
"13308",2020,17,839,240,236,"51.508033","-0.10682363","Sea Containers, South Bank",476
"13309",2020,18,1,89,66,"51.52916347","-0.109970527","River Street , Clerkenwell",155
"13310",2020,18,2,197,218,"51.49960695","-0.197574246","Phillimore Gardens, Kensington",415
"13311",2020,18,3,32,28,"51.52128377","-0.084605692","Christopher Street, Liverpool Street",60
"13312",2020,18,4,49,39,"51.53005939","-0.120973687","St. Chad's Street, King's Cross",88
"13313",2020,18,5,162,164,"51.49313","-0.156876","Sedding Street, Sloane Square",326
"13314",2020,18,6,139,139,"51.51811784","-0.144228881","Broadcasting House, Marylebone",278
"13315",2020,18,7,191,182,"51.53430039","-0.1680743","Charlbert Street, St. John's Wood",373
"13316",2020,18,8,356,342,"51.529857","-0.18348604","Maida Vale, Maida Vale",698
"13317",2020,18,9,140,132,"51.5073853","-0.096440751","New Globe Walk, Bankside",272
"13318",2020,18,10,150,155,"51.50597426","-0.092754157","Park Street, Bankside",305
"13319",2020,18,11,145,149,"51.52395143","-0.122502346","Brunswick Square, Bloomsbury",294
"13320",2020,18,12,103,90,"51.52168078","-0.130431727","Malet Street, Bloomsbury",193
"13321",2020,18,13,77,71,"51.51991453","-0.136039674","Scala Street, Fitzrovia",148
"13322",2020,18,14,233,228,"51.52994371","-0.123616824","Belgrove Street , King's Cross",461
"13323",2020,18,15,78,79,"51.51772703","-0.127854211","Great Russell Street, Bloomsbury",157
"13324",2020,18,16,94,85,"51.52635795","-0.125979294","Cartwright Gardens , Bloomsbury",179
"13325",2020,18,17,167,165,"51.5216612","-0.109006325","Hatton Wall, Holborn",332
"13326",2020,18,18,171,166,"51.51477076","-0.12221963","Drury Lane, Covent Garden",337
"13327",2020,18,19,32,19,"51.52505093","-0.131161087","Taviton Street, Bloomsbury",51
"13328",2020,18,20,27,21,"51.527326","-0.13605286","Drummond Street , Euston",48
"13329",2020,18,21,50,55,"51.53007835","-0.13884627","Hampstead Road (Cartmel), Euston",105
"13330",2020,18,22,182,183,"51.5222641","-0.114079481","Northington Street , Holborn",365
"13331",2020,18,23,45,43,"51.51943538","-0.119123345","Red Lion Square, Holborn",88
"13332",2020,18,24,112,107,"51.51908011","-0.124678402","British Museum, Bloomsbury",219
"13333",2020,18,25,64,62,"51.5288338","-0.132250369","Doric Way , Somers Town",126
"13334",2020,18,26,87,89,"51.52728093","-0.11829517","Ampton Street , Clerkenwell",176
"13335",2020,18,27,53,36,"51.51382102","-0.107927706","Bouverie Street, Temple",89
"13336",2020,18,28,236,225,"51.52351808","-0.143613641","Bolsover Street, Fitzrovia",461
"13337",2020,18,29,199,188,"51.513735","-0.193487","Hereford Road, Bayswater",387
"13338",2020,18,30,116,112,"51.52915444","-0.093421615","Windsor Terrace, Hoxton",228
"13339",2020,18,31,59,99,"51.52953709","-0.083353323","Fanshaw Street, Hoxton",158
"13340",2020,18,32,192,167,"51.52469624","-0.084439283","Leonard Circus , Shoreditch",359
"13341",2020,18,33,119,113,"51.5156","-0.070056","Central House, Aldgate",232
"13342",2020,18,34,85,73,"51.5341235","-0.129386874","Pancras Road, King's Cross",158
"13343",2020,18,36,474,483,"51.50173726","-0.184980612","De Vere Gardens, Kensington",957
"13344",2020,18,37,167,177,"51.49159394","-0.192369256","Penywern Road, Earl's Court",344
"13345",2020,18,38,119,127,"51.4973875","-0.197245586","Abingdon Villas, Kensington",246
"13346",2020,18,39,230,231,"51.5263778","-0.078130921","Shoreditch High Street, Shoreditch",461
"13347",2020,18,40,139,137,"51.52127071","-0.0755789","Commercial Street, Shoreditch",276
"13348",2020,18,41,26,25,"51.520955","-0.083493552","Pindar Street, Liverpool Street",51
"13349",2020,18,42,139,129,"51.53099181","-0.093903825","Wenlock Road , Hoxton",268
"13350",2020,18,43,175,181,"51.52026","-0.157183945","Crawford Street, Marylebone",356
"13351",2020,18,44,99,93,"51.51073687","-0.144165239","Bruton Street, Mayfair",192
"13352",2020,18,45,83,60,"51.522511","-0.162298","Boston Place, Marylebone",143
"13353",2020,18,47,377,386,"51.52334476","-0.183846408","Warwick Avenue Station, Maida Vale",763
"13354",2020,18,48,134,140,"51.51248445","-0.099141408","Godliman Street, St. Paul's",274
"13355",2020,18,49,104,119,"51.50706909","-0.145904427","Curzon Street, Mayfair",223
"13356",2020,18,50,47,51,"51.52867339","-0.087459376","East Road, Hoxton",98
"13357",2020,18,51,83,77,"51.52671796","-0.104298194","Finsbury Library , Finsbury",160
"13358",2020,18,52,124,122,"51.52295439","-0.094934859","Roscoe Street, St. Luke's",246
"13359",2020,18,53,47,47,"51.5099923","-0.143495266","Grafton Street, Mayfair",94
"13360",2020,18,54,122,107,"51.52174785","-0.094475072","Golden Lane, Barbican",229
"13361",2020,18,55,107,107,"51.51707521","-0.086685542","Finsbury Circus, Liverpool Street",214
"13362",2020,18,56,171,167,"51.52058381","-0.154701411","Paddington Street, Marylebone",338
"13363",2020,18,57,172,179,"51.52334672","-0.120202614","Guilford Street , Bloomsbury",351
"13364",2020,18,58,101,99,"51.52452699","-0.079248081","New Inn Yard, Shoreditch",200
"13365",2020,18,60,115,111,"51.52644828","-0.172190727","Lisson Grove, St. John's Wood",226
"13366",2020,18,61,93,111,"51.49738251","-0.089446947","Great Dover Street, The Borough",204
"13367",2020,18,62,111,97,"51.4907579","-0.106323685","Cotton Garden Estate, Kennington",208
"13368",2020,18,63,37,56,"51.53089041","-0.089782579","Murray Grove , Hoxton",93
"13369",2020,18,64,157,169,"51.50946212","-0.124749274","William IV Street, Strand",326
"13370",2020,18,65,64,68,NA,NA,NA,132
"13371",2020,18,66,119,120,"51.51795029","-0.108657431","Holborn Circus, Holborn",239
"13372",2020,18,67,67,64,"51.51882555","-0.108028472","Hatton Garden, Holborn",131
"13373",2020,18,68,158,160,"51.52059681","-0.116688468","Theobald's Road , Holborn",318
"13374",2020,18,69,44,42,"51.5262363","-0.134407652","Euston Road, Euston",86
"13375",2020,18,70,59,44,"51.53136059","-0.117069978","Calshot Street , King's Cross",103
"13376",2020,18,71,159,148,"51.5154186","-0.098850915","Newgate Street , St. Paul's",307
"13377",2020,18,72,100,95,"51.52352001","-0.108340165","Farringdon Lane, Clerkenwell",195
"13378",2020,18,73,161,173,"51.52572618","-0.088486188","Old Street Station, St. Luke's",334
"13379",2020,18,74,410,413,"51.48591714","-0.124469948","Vauxhall Cross, Vauxhall",823
"13380",2020,18,75,107,101,"51.53219984","-0.105480698","Torrens Street, Angel",208
"13381",2020,18,76,88,82,"51.52559505","-0.144083893","Longford Street, The Regent's Park",170
"13382",2020,18,77,167,167,"51.52341837","-0.124121774","Russell Square Station, Bloomsbury",334
"13383",2020,18,78,95,78,"51.52486887","-0.099489485","Sadlers Sports Centre, Finsbury",173
"13384",2020,18,79,41,54,"51.511726","-0.11385596","Arundel Street, Temple",95
"13385",2020,18,80,139,120,"51.50069361","-0.102091246","Webber Street , Southwark",259
"13386",2020,18,81,113,121,"51.52025302","-0.141327271","Great Titchfield Street, Fitzrovia",234
"13387",2020,18,82,81,72,"51.514274","-0.111257","Chancery Lane, Holborn",153
"13388",2020,18,83,209,216,"51.50963938","-0.131510949","Panton Street, West End",425
"13389",2020,18,84,22,22,"51.51593725","-0.111778348","Breams Buildings, Holborn",44
"13390",2020,18,85,272,301,"51.50064702","-0.078600401","Tanner Street, Bermondsey",573
"13391",2020,18,86,100,98,"51.48947903","-0.115156562","Sancroft Street, Vauxhall",198
"13392",2020,18,87,63,50,"51.51646835","-0.079684557","Devonshire Square, Liverpool Street",113
"13393",2020,18,88,163,166,"51.51858757","-0.132053392","Bayley Street , Bloomsbury",329
"13394",2020,18,89,97,99,"51.5262503","-0.123509611","Tavistock Place, Bloomsbury",196
"13395",2020,18,90,40,29,"51.53301907","-0.139174593","Harrington Square 1, Camden Town",69
"13396",2020,18,91,168,162,"51.49368637","-0.111014912","Walnut Tree Walk, Vauxhall",330
"13397",2020,18,92,113,123,"51.49889832","-0.100440521","Borough Road, Elephant & Castle",236
"13398",2020,18,93,181,175,"51.53440868","-0.109025404","Cloudesley Road, Angel",356
"13399",2020,18,94,303,299,"51.49506109","-0.085814489","Bricklayers Arms, Borough",602
"13400",2020,18,95,182,199,"51.5208417","-0.097340162","Aldersgate Street, Barbican",381
"13401",2020,18,96,91,86,"51.53095071","-0.078505384","Falkirk Street, Hoxton",177
"13402",2020,18,97,234,255,"51.49792478","-0.183834706","Gloucester Road (North), Kensington",489
"13403",2020,18,98,168,142,"51.52554222","-0.138231303","Hampstead Road, Euston",310
"13404",2020,18,99,270,275,"51.51457763","-0.158264483","Old Quebec Street, Marylebone",545
"13405",2020,18,100,138,137,"51.49043573","-0.122806861","Albert Embankment, Vauxhall",275
"13406",2020,18,101,202,207,"51.51155322","-0.0929401","Queen Street 1, Bank",409
"13407",2020,18,102,105,110,"51.51340693","-0.076793375","Jewry Street, Aldgate",215
"13408",2020,18,103,131,134,"51.50472376","-0.192538767","Vicarage Gate, Kensington",265
"13409",2020,18,104,116,109,"51.51159481","-0.077121322","Crosswall, Tower",225
"13410",2020,18,105,210,229,"51.51552971","-0.190240716","Westbourne Grove, Bayswater",439
"13411",2020,18,106,60,59,"51.51410514","-0.147301667","Woodstock Street, Mayfair",119
"13412",2020,18,107,150,144,"51.52600832","-0.096317627","Finsbury Leisure Centre, St. Luke's",294
"13413",2020,18,108,149,155,"51.49812559","-0.132102166","Abbey Orchard Street, Westminster",304
"13414",2020,18,109,177,177,"51.51563144","-0.132328837","Soho Square , Soho",354
"13415",2020,18,110,178,163,"51.53304322","-0.172528678","Wellington Road, St. John's Wood",341
"13416",2020,18,111,436,454,"51.5100172","-0.157275636","Park Lane , Hyde Park",890
"13417",2020,18,112,41,39,"51.51580998","-0.105270275","Stonecutter Street, Holborn",80
"13418",2020,18,113,178,181,"51.49646288","-0.183289032","Gloucester Road (Central), South Kensington",359
"13419",2020,18,114,464,446,"51.52451738","-0.158963647","Park Road (Baker Street), The Regent's Park",910
"13420",2020,18,115,192,189,"51.51423368","-0.073537654","Braham Street, Aldgate",381
"13421",2020,18,116,147,138,"51.51449962","-0.141423695","Little Argyll Street, West End",285
"13422",2020,18,117,116,116,"51.49288067","-0.114934001","Lollard Street, Vauxhall",232
"13423",2020,18,118,91,107,"51.49582705","-0.13547809","Rochester Row, Westminster",198
"13424",2020,18,119,201,207,"51.52589324","-0.090847761","Bath Street, St. Luke's",408
"13425",2020,18,120,46,42,"51.51573534","-0.093080779","The Guildhall, Guildhall",88
"13426",2020,18,121,69,62,"51.51891348","-0.156166631","Baker Street, Marylebone",131
"13427",2020,18,122,78,75,"51.52111369","-0.078869751","Norton Folgate, Liverpool Street",153
"13428",2020,18,123,66,59,"51.52836014","-0.104724625","St. John Street, Finsbury",125
"13429",2020,18,125,184,177,"51.50069491","-0.094524319","Borough High Street, The Borough",361
"13430",2020,18,126,74,73,"51.51782144","-0.096496865","Museum of London, Barbican",147
"13431",2020,18,127,57,59,"51.51700801","-0.09388536","Wood Street, Guildhall",116
"13432",2020,18,128,200,197,"51.49536226","-0.185296516","Emperor's Gate, South Kensington",397
"13433",2020,18,129,167,167,"51.5118973","-0.137043852","Golden Square, Soho",334
"13434",2020,18,130,478,474,"51.50950627","-0.075459482","Tower Gardens , Tower",952
"13435",2020,18,131,120,119,"51.53300545","-0.136792671","Eversholt Street , Camden Town",239
"13436",2020,18,132,286,289,"51.52364804","-0.074754872","Bethnal Green Road, Shoreditch",575
"13437",2020,18,133,296,316,NA,NA,NA,612
"13438",2020,18,134,288,272,"51.504904","-0.06797","Wapping High Street, Wapping",560
"13439",2020,18,135,141,160,"51.52326004","-0.104708922","Clerkenwell Green, Clerkenwell",301
"13440",2020,18,136,180,178,"51.51196176","-0.097441687","Queen Victoria Street, St. Paul's",358
"13441",2020,18,138,185,185,"51.51227622","-0.157436972","Green Street, Mayfair",370
"13442",2020,18,139,137,148,"51.49488108","-0.117974901","Lambeth Road, Vauxhall",285
"13443",2020,18,140,88,80,"51.52096262","-0.085634242","Finsbury Square , Moorgate",168
"13444",2020,18,141,103,91,"51.51530805","-0.147203711","Chapel Place, Marylebone",194
"13445",2020,18,142,161,180,"51.49372451","-0.198286569","West Cromwell Road, Earl's Court",341
"13446",2020,18,143,129,140,"51.4968865","-0.161203828","Pont Street, Knightsbridge",269
"13447",2020,18,144,241,215,"51.48894022","-0.111435796","Kennington Cross, Kennington",456
"13448",2020,18,145,85,87,"51.50074359","-0.202759212","Ilchester Place, Kensington",172
"13449",2020,18,146,173,175,"51.48836528","-0.129361842","Vauxhall Bridge , Pimlico",348
"13450",2020,18,148,175,181,"51.49211134","-0.138364847","Tachbrook Street, Victoria",356
"13451",2020,18,149,216,230,"51.48478899","-0.110683213","Kennington Road Post Office, Oval",446
"13452",2020,18,150,122,113,"51.49705603","-0.168917077","Holy Trinity Brompton, Knightsbridge",235
"13453",2020,18,151,182,162,"51.51213691","-0.201554966","Chepstow Villas, Notting Hill",344
"13454",2020,18,152,232,240,"51.49217002","-0.101536865","Hampton Street, Walworth",472
"13455",2020,18,153,582,592,"51.511933","-0.174411","Bayswater Road, Hyde Park",1174
"13456",2020,18,154,67,49,"51.50379168","-0.11282408","Waterloo Station 3, Waterloo",116
"13457",2020,18,155,124,143,"51.49586666","-0.191933711","Lexham Gardens, Kensington",267
"13458",2020,18,156,94,120,"51.49443626","-0.092921165","New Kent Road, The Borough",214
"13459",2020,18,157,149,174,"51.50039792","-0.193068385","Wright's Lane, Kensington",323
"13460",2020,18,158,174,147,"51.49085368","-0.196170309","Trebovir Road, Earl's Court",321
"13461",2020,18,159,154,145,"51.51461995","-0.137841333","Great Marlborough Street, Soho",299
"13462",2020,18,160,181,169,"51.50663341","-0.131773845","Waterloo Place, St. James's",350
"13463",2020,18,161,106,110,"51.49234577","-0.141334487","Guildhouse Street, Victoria",216
"13464",2020,18,162,137,135,"51.51760685","-0.121328408","Southampton Place, Holborn",272
"13465",2020,18,163,239,220,"51.4931848","-0.167894973","Sloane Avenue, Knightsbridge",459
"13466",2020,18,164,137,139,"51.515607","-0.183118788","Cleveland Gardens, Bayswater",276
"13467",2020,18,166,293,277,"51.50185512","-0.159237081","Seville Street, Knightsbridge",570
"13468",2020,18,167,133,147,"51.49395092","-0.147624377","Eccleston Place, Victoria",280
"13469",2020,18,168,151,172,"51.50040123","-0.195455928","Argyll Road, Kensington",323
"13470",2020,18,169,325,330,"51.51474612","-0.165164288","Porchester Place, Paddington",655
"13471",2020,18,170,42,42,"51.52784273","-0.108068155","Hardwick Street, Clerkenwell",84
"13472",2020,18,171,151,162,"51.4916156","-0.186753859","Collingham Gardens, Earl's Court",313
"13473",2020,18,172,160,174,"51.49121192","-0.173715911","Sumner Place, South Kensington",334
"13474",2020,18,173,47,58,"51.50486","-0.113001","Waterloo Road, South Bank",105
"13475",2020,18,174,77,73,"51.512529","-0.115163","Strand, Strand",150
"13476",2020,18,175,38,38,"51.521668","-0.079608554","Worship Street, Shoreditch",76
"13477",2020,18,176,162,149,"51.51791921","-0.188098863","Gloucester Terrace, Bayswater",311
"13478",2020,18,177,104,125,"51.49616092","-0.140947636","Ashley Place, Victoria",229
"13479",2020,18,178,206,193,"51.48985626","-0.141923621","Warwick Square, Pimlico",399
"13480",2020,18,180,198,200,"51.5129118","-0.153645496","North Audley Street, Mayfair",398
"13481",2020,18,181,162,163,"51.49941247","-0.152317537","Belgrave Square, Belgravia",325
"13482",2020,18,182,99,87,"51.52202903","-0.165842551","Bell Street , Marylebone",186
"13483",2020,18,183,351,351,"51.482362","-0.13612398","Riverlight North, Nine Elms",702
"13484",2020,18,184,99,92,"51.52071513","-0.14521173","Portland Place, Marylebone",191
"13485",2020,18,185,249,256,"51.48805753","-0.140741432","Alderney Street, Pimlico",505
"13486",2020,18,186,159,148,"51.51733558","-0.175810943","South Wharf Road, Paddington",307
"13487",2020,18,187,192,188,"51.49247977","-0.178433004","Queen's Gate (South), South Kensington",380
"13488",2020,18,188,50,52,"51.5165179","-0.164393768","Nutford Place, Marylebone",102
"13489",2020,18,189,89,68,"51.53166681","-0.109914711","Claremont Square, Angel",157
"13490",2020,18,190,166,158,"51.48997562","-0.132845681","Rampayne Street, Pimlico",324
"13491",2020,18,191,279,279,"51.50311799","-0.153520935","Hyde Park Corner, Hyde Park",558
"13492",2020,18,192,310,310,"51.51251523","-0.133201961","Wardour Street, Soho",620
"13493",2020,18,193,81,91,"51.50581776","-0.100186337","Bankside Mix, Bankside",172
"13494",2020,18,194,438,534,"51.50462759","-0.091773776","Hop Exchange, The Borough",972
"13495",2020,18,195,164,155,"51.50724437","-0.106237501","Milroy Walk, South Bank",319
"13496",2020,18,196,91,109,"51.50368837","-0.098497684","Union Street, The Borough",200
"13497",2020,18,197,68,71,"51.50556905","-0.111606696","Stamford Street, South Bank",139
"13498",2020,18,199,188,174,"51.51048489","-0.082989638","Great Tower Street, Monument",362
"13499",2020,18,200,148,143,"51.51492456","-0.066078037","LMU Commercial Road, Whitechapel",291
"13500",2020,18,201,180,176,"51.5225965","-0.161113413","Dorset Square, Marylebone",356
"13501",2020,18,202,198,201,"51.51236389","-0.06954201","Leman Street, Aldgate",399
"13502",2020,18,203,130,131,"51.51821864","-0.100791005","West Smithfield Rotunda, Farringdon",261
"13503",2020,18,204,68,76,"51.52659961","-0.112432615","Margery Street, Clerkenwell",144
"13504",2020,18,206,194,185,"51.518154","-0.062697","New Road 1 , Whitechapel",379
"13505",2020,18,207,105,90,"51.50135267","-0.153194766","Grosvenor Crescent, Belgravia",195
"13506",2020,18,208,40,43,"51.52505151","-0.166304359","Mallory Street, Marylebone",83
"13507",2020,18,209,119,95,"51.49358391","-0.165101392","Denyer Street, Knightsbridge",214
"13508",2020,18,210,118,110,"51.51681444","-0.151926305","Hinde Street, Marylebone",228
"13509",2020,18,211,143,116,"51.49464523","-0.158105512","Cadogan Place, Knightsbridge",259
"13510",2020,18,212,121,87,"51.50658458","-0.199004026","Campden Hill Road, Notting Hill",208
"13511",2020,18,213,900,922,"51.50274025","-0.149569201","Wellington Arch, Hyde Park",1822
"13512",2020,18,214,59,61,"51.52683806","-0.130504336","Endsleigh Gardens, Euston",120
"13513",2020,18,215,74,61,"51.51906932","-0.088285377","Moorfields, Moorgate",135
"13514",2020,18,216,232,243,"51.49094565","-0.181190899","Old Brompton Road, South Kensington",475
"13515",2020,18,217,185,206,"51.51615461","-0.082422399","Wormwood Street, Liverpool Street",391
"13516",2020,18,218,214,199,"51.48971651","-0.170194408","St. Luke's Church, Chelsea",413
"13517",2020,18,219,322,298,"51.49016361","-0.19039362","Bramham Gardens, Earl's Court",620
"13518",2020,18,220,208,215,"51.49066456","-0.166485083","Chelsea Green, Chelsea",423
"13519",2020,18,221,115,111,"51.49481649","-0.13045856","Horseferry Road, Westminster",226
"13520",2020,18,222,331,326,"51.50275704","-0.155349725","Knightsbridge, Hyde Park",657
"13521",2020,18,223,232,231,"51.49148474","-0.090220911","Rodney Road , Walworth",463
"13522",2020,18,224,561,556,"51.51031","-0.18740235","Queensway, Kensington Gardens",1117
"13523",2020,18,225,212,187,"51.50935342","-0.196422","Notting Hill Gate Station, Notting Hill",399
"13524",2020,18,226,92,88,"51.50844614","-0.131961389","Charles II Street, West End",180
"13525",2020,18,227,60,89,"51.52891573","-0.115480888","Great Percy Street, Clerkenwell",149
"13526",2020,18,228,162,173,"51.50742485","-0.134621209","St. James's Square, St. James's",335
"13527",2020,18,229,268,257,"51.50654321","-0.123179697","Whitehall Place, Strand",525
"13528",2020,18,230,63,61,"51.50669284","-0.103137426","Poured Lines, Bankside",124
"13529",2020,18,231,155,157,"51.49396755","-0.17873226","Queen's Gate (Central), South Kensington",312
"13530",2020,18,232,42,37,"51.51501025","-0.112753217","Carey Street, Holborn",79
"13531",2020,18,233,183,216,"51.50777049","-0.130699733","Pall Mall East, West End",399
"13532",2020,18,234,204,219,"51.53450449","-0.106992706","Liverpool Road (N1 Centre), Angel",423
"13533",2020,18,235,152,152,"51.49571828","-0.110889274","Kennington Road  , Vauxhall",304
"13534",2020,18,236,67,51,"51.51838043","-0.073438925","Fashion Street, Whitechapel",118
"13535",2020,18,237,199,198,"51.5097860151","-0.0681619805156","Dock Street, Wapping",397
"13536",2020,18,238,131,141,"51.5233534","-0.175116099","Frampton Street, Paddington",272
"13537",2020,18,239,198,202,"51.52443845","-0.138019439","Warren Street Station, Euston",400
"13538",2020,18,240,30,25,"51.50545935","-0.10569204","Colombo Street, Southwark",55
"13539",2020,18,242,183,184,"51.52200801","-0.151359288","Beaumont Street, Marylebone",367
"13540",2020,18,243,180,190,"51.49096258","-0.139625122","Gloucester Street, Pimlico",370
"13541",2020,18,244,87,85,"51.51611887","-0.128585022","Earnshaw Street , Covent Garden",172
"13542",2020,18,245,147,140,"51.4853572","-0.142207481","Grosvenor Road, Pimlico",287
"13543",2020,18,246,159,168,"51.52285301","-0.099994052","Berry Street, Clerkenwell",327
"13544",2020,18,247,248,234,"51.530529","-0.167515","St. John's Wood Church, The Regent's Park",482
"13545",2020,18,248,244,250,"51.50645179","-0.170279555","Triangle Car Park, Hyde Park",494
"13546",2020,18,249,108,80,"51.49859784","-0.096191134","Harper Road, The Borough",188
"13547",2020,18,250,92,102,"51.489932","-0.162727","Royal Avenue 1, Chelsea",194
"13548",2020,18,251,267,259,"51.518908","-0.079249","Brushfield Street, Liverpool Street",526
"13549",2020,18,252,216,245,"51.5046364","-0.116542278","Jubilee Gardens, South Bank",461
"13550",2020,18,253,331,326,"51.53404294","-0.086379717","Shoreditch Park, Hoxton",657
"13551",2020,18,254,171,178,"51.53051587","-0.106408455","Chadwell Street, Angel",349
"13552",2020,18,255,197,194,"51.52557531","-0.179592915","Clifton Road, Maida Vale",391
"13553",2020,18,256,16,16,"51.51362054","-0.116764211","Houghton Street, Strand",32
"13554",2020,18,257,160,158,"51.52248185","-0.154907218","Westminster University, Marylebone",318
"13555",2020,18,259,205,206,"51.490959","-0.1532331","Bourne Street, Belgravia",411
"13556",2020,18,260,103,94,"51.5136846","-0.135580879","Broadwick Street, Soho",197
"13557",2020,18,261,114,113,"51.5134891","-0.191351186","Princes Square, Bayswater",227
"13558",2020,18,262,109,106,"51.49874469","-0.103132904","LSBU (Borough Road), Elephant & Castle",215
"13559",2020,18,263,40,43,"51.51422502","-0.080660083","St. Mary Axe, Aldgate",83
"13560",2020,18,264,145,159,"51.52644342","-0.109256828","Tysoe Street, Clerkenwell",304
"13561",2020,18,265,140,119,"51.51595344","-0.169249375","Southwick Street, Paddington",259
"13562",2020,18,266,366,404,"51.50102668","-0.180246101","Queen's Gate (North), Kensington",770
"13563",2020,18,267,135,126,"51.49206037","-0.132224622","Regency Street, Westminster",261
"13564",2020,18,268,115,130,"51.49320445","-0.144132875","Belgrave Road, Victoria",245
"13565",2020,18,269,161,194,"51.50082346","-0.089740764","Empire Square, The Borough",355
"13566",2020,18,270,255,256,"51.4863434","-0.122492418","Kennington Lane Rail Bridge, Vauxhall",511
"13567",2020,18,271,74,92,"51.53583617","-0.156285395","London Zoo,  The Regent's Park",166
"13568",2020,18,272,149,149,"51.50144456","-0.110699309","Baylis Road, Waterloo",298
"13569",2020,18,273,92,78,"51.50613324","-0.114686385","Belvedere Road 1, South Bank",170
"13570",2020,18,274,146,148,"51.49671237","-0.20528437","Warwick Road, Olympia",294
"13571",2020,18,275,73,89,"51.52004497","-0.092176447","Barbican Centre, Barbican",162
"13572",2020,18,276,47,49,"51.50930161","-0.084985356","Lower Thames Street, Monument",96
"13573",2020,18,277,170,178,"51.50315739","-0.191496313","Kensington Church Street, Kensington",348
"13574",2020,18,278,485,503,"51.5034938","-0.07962099","Tooley Street, Bermondsey",988
"13575",2020,18,279,112,99,"51.51862243","-0.176645823","North Wharf Road, Paddington",211
"13576",2020,18,280,140,144,"51.490083","-0.162418","Royal Avenue 2, Chelsea",284
"13577",2020,18,281,108,128,"51.49580589","-0.127575233","Smith Square, Westminster",236
"13578",2020,18,282,254,266,"51.51906446","-0.059642081","Royal London Hospital, Whitechapel",520
"13579",2020,18,283,18,18,"51.51440928","-0.118478757","Kingsway, Covent Garden",36
"13580",2020,18,284,125,123,"51.49914063","-0.112031483","Lambeth North Station, Waterloo",248
"13581",2020,18,286,119,90,"51.5272947","-0.174653609","St. John's Wood Road, St. John's Wood",209
"13582",2020,18,287,37,35,"51.52367314","-0.128377673","Bedford Way, Bloomsbury",72
"13583",2020,18,288,175,172,"51.49236962","-0.147478734","Elizabeth Bridge, Victoria",347
"13584",2020,18,289,55,60,"51.50923022","-0.151296092","South Audley Street, Mayfair",115
"13585",2020,18,290,154,162,"51.518268","-0.17110323","St Mary's Hospital, Paddington",316
"13586",2020,18,291,222,197,"51.48483991","-0.138089062","Claverton Street, Pimlico",419
"13587",2020,18,292,209,208,"51.49888404","-0.165471605","Montpelier Street, Knightsbridge",417
"13588",2020,18,293,93,89,"51.49815779","-0.209494128","Kensington Olympia Station, Olympia",182
"13589",2020,18,294,211,191,"51.488226","-0.135635511","St. George's Square, Pimlico",402
"13590",2020,18,295,85,79,"51.50029631","-0.092762704","Swan Street, The Borough",164
"13591",2020,18,296,170,179,"51.49363156","-0.190603326","Knaresborough Place, Earl's Court",349
"13592",2020,18,297,58,39,"51.49612799","-0.106000855","Geraldine Street, Elephant & Castle",97
"13593",2020,18,298,488,489,"51.50227992","-0.074189225","Curlew Street, Shad Thames",977
"13594",2020,18,299,75,65,"51.49398524","-0.136928582","Vincent Square, Westminster",140
"13595",2020,18,300,169,170,"51.505014","-0.17306032","Serpentine Car Park, Hyde Park",339
"13596",2020,18,301,137,131,"51.51475963","-0.148105415","Marylebone Lane, Marylebone",268
"13597",2020,18,302,269,285,"51.466907","-0.216573","Putney Pier, Wandsworth",554
"13598",2020,18,303,268,272,"51.50295379","-0.158456089","Albert Gate, Hyde Park",540
"13599",2020,18,306,72,66,"51.51816295","-0.135025698","Rathbone Street, Fitzrovia",138
"13600",2020,18,307,250,251,"51.50990837","-0.187842717","Black Lion Gate, Kensington Gardens",501
"13601",2020,18,308,166,165,"51.49907558","-0.085666316","Long Lane , Bermondsey",331
"13602",2020,18,309,282,303,"51.50963123","-0.119047563","Embankment (Savoy), Strand",585
"13603",2020,18,310,103,102,"51.4908679","-0.116911864","Black Prince Road, Vauxhall",205
"13604",2020,18,311,143,134,"51.51918144","-0.140485596","Foley Street, Fitzrovia",277
"13605",2020,18,312,245,218,"51.53088935","-0.176770502","Grove End Road, St. John's Wood",463
"13606",2020,18,313,85,88,"51.51734403","-0.138072691","Wells Street, Fitzrovia",173
"13607",2020,18,314,157,175,"51.50088934","-0.083159352","Tyers Gate, Bermondsey",332
"13608",2020,18,315,98,97,"51.52536703","-0.153463612","The Tennis Courts, The Regent's Park",195
"13609",2020,18,316,170,158,NA,NA,NA,328
"13610",2020,18,317,33,47,"51.49679128","-0.093913472","Dickens Square, Borough",80
"13611",2020,18,318,113,115,"51.51004801","-0.138846453","Sackville Street, Mayfair",228
"13612",2020,18,319,161,171,"51.52702563","-0.088542771","Baldwin Street, St. Luke's",332
"13613",2020,18,320,147,177,"51.49357351","-0.139956043","Queen Mother Sports Centre, Victoria",324
"13614",2020,18,321,359,373,"51.49785559","-0.081608045","Bermondsey Street, Bermondsey",732
"13615",2020,18,322,113,90,"51.526293","-0.073955","Palissy Street, Shoreditch",203
"13616",2020,18,323,35,32,"51.523196","-0.083067","Clifton Street, Shoreditch",67
"13617",2020,18,324,190,198,"51.49652013","-0.101384068","Ontario Street, Elephant & Castle",388
"13618",2020,18,325,37,44,"51.50908747","-0.129697889","St. Martin's Street, West End",81
"13619",2020,18,326,248,249,"51.53266186","-0.099981142","Graham Street, Angel",497
"13620",2020,18,327,30,39,"51.53095","-0.085603","New North Road 1, Hoxton",69
"13621",2020,18,328,26,42,"51.53114","-0.086016","New North Road 2, Hoxton",68
"13622",2020,18,329,447,444,"51.53589283","-0.160854428","Prince Albert Road, The Regent's Park",891
"13623",2020,18,330,75,68,"51.51641749","-0.179135079","Eastbourne Mews, Paddington",143
"13624",2020,18,331,107,105,"51.52085887","-0.089887855","Bunhill Row, Moorgate",212
"13625",2020,18,332,94,90,"51.49334336","-0.194757949","Nevern Place, Earl's Court",184
"13626",2020,18,333,221,227,"51.50860544","-0.193764092","Palace Gardens Terrace, Notting Hill",448
"13627",2020,18,334,56,65,"51.505044","-0.115851","Concert Hall Approach 1, South Bank",121
"13628",2020,18,335,96,98,"51.51196803","-0.120718759","Tavistock Street, Covent Garden",194
"13629",2020,18,336,43,46,"51.504942","-0.115533","Concert Hall Approach 2, South Bank",89
"13630",2020,18,337,112,104,"51.51108452","-0.197524944","Pembridge Villas, Notting Hill",216
"13631",2020,18,338,180,181,"51.51175646","-0.119643424","Wellington Street , Strand",361
"13632",2020,18,339,67,60,"51.5333196","-0.1117812","Risinghill Street, Angel",127
"13633",2020,18,340,120,119,"51.51444134","-0.087587447","Bank of England Museum, Bank",239
"13634",2020,18,341,258,256,"51.50810309","-0.12602103","Craven Street, Strand",514
"13635",2020,18,343,69,104,"51.53692216","-0.150181444","London Zoo Car Park, The Regent's Park",173
"13636",2020,18,344,71,59,"51.528246","-0.10102611","Goswell Road (City Uni), Finsbury",130
"13637",2020,18,345,219,233,"51.48802358","-0.166878535","Flood Street, Chelsea",452
"13638",2020,18,347,142,153,"51.50013942","-0.113936001","Lower Marsh, Waterloo",295
"13639",2020,18,348,136,135,"51.51217033","-0.150481272","Grosvenor Square, Mayfair",271
"13640",2020,18,349,68,71,"51.51196","-0.142783033","St. George Street, Mayfair",139
"13641",2020,18,350,125,145,"51.5017154373867","-0.1798541843891","Queen's Gate, Kensington Gardens",270
"13642",2020,18,351,128,130,"51.529423","-0.097122","Macclesfield Rd, St Lukes",258
"13643",2020,18,352,109,111,"51.486965","-0.116625","Vauxhall Street, Vauxhall",220
"13644",2020,18,353,71,69,"51.49459148","-0.134234258","Greycoat Street , Westminster",140
"13645",2020,18,354,135,135,"51.506767","-0.123702","Northumberland Avenue, Strand",270
"13646",2020,18,356,218,239,"51.494412","-0.173881","South Kensington Station, South Kensington",457
"13647",2020,18,357,95,87,"51.520994","-0.139016","Howland Street, Fitzrovia",182
"13648",2020,18,358,48,42,"51.516226","-0.124826","High Holborn , Covent Garden",90
"13649",2020,18,359,66,66,"51.49782999","-0.135440826","Butler Place, Westminster",132
"13650",2020,18,360,101,96,"51.49675303","-0.138733562","Howick Place, Westminster",197
"13651",2020,18,361,71,56,"51.50391973","-0.11342629","Waterloo Station 2, Waterloo",127
"13652",2020,18,362,105,107,"51.536264","-0.133952","Royal College Street, Camden Town",212
"13653",2020,18,363,55,52,"51.5291212008901","-0.171185284853","Lord's, St. John's Wood",107
"13654",2020,18,364,79,71,"51.519656","-0.132339","Alfred Place, Bloomsbury",150
"13655",2020,18,365,83,70,"51.530344","-0.100168","City Road, Angel",153
"13656",2020,18,366,79,67,"51.5109192966489","-0.1511263847351","Millennium Hotel, Mayfair",146
"13657",2020,18,367,177,180,"51.5173721","-0.1642075","Harrowby Street, Marylebone",357
"13658",2020,18,368,219,183,"51.50024195","-0.15934065","Harriet Street, Knightsbridge",402
"13659",2020,18,370,61,48,"51.520205","-0.174593","Paddington Green, Paddington",109
"13660",2020,18,371,47,52,"51.49775","-0.10988","King Edward Walk, Waterloo",99
"13661",2020,18,372,18,5,"51.515208","-0.117863","Sardinia Street, Holborn",23
"13662",2020,18,373,71,70,"51.49980661","-0.176415994","Prince Consort Road, Knightsbridge",141
"13663",2020,18,374,84,110,"51.50402794","-0.11386436","Waterloo Station 1, Waterloo",194
"13664",2020,18,375,88,97,"51.50194596","-0.194392952","Kensington Town Hall, Kensington",185
"13665",2020,18,376,171,176,"51.49188409","-0.125674815","Millbank Tower, Pimlico",347
"13666",2020,18,377,72,65,"51.50535447","-0.113656543","Waterloo Bridge, South Bank",137
"13667",2020,18,378,32,62,"51.49559291","-0.179077626","Natural History Museum, South Kensington",94
"13668",2020,18,379,191,194,"51.51431171","-0.200838199","Turquoise Island, Notting Hill",385
"13669",2020,18,380,50,45,"51.50686435","-0.150666888","Stanhope Gate, Mayfair",95
"13670",2020,18,381,83,74,"51.51953043","-0.13577731","Charlotte Street, Fitzrovia",157
"13671",2020,18,382,63,59,"51.50935171","-0.14744969","Farm Street, Mayfair",122
"13672",2020,18,383,118,111,"51.51310333","-0.13121385","Frith Street, Soho",229
"13673",2020,18,384,124,131,"51.496481","-0.192404","Marloes Road, Kensington",255
"13674",2020,18,386,193,191,"51.51352755","-0.130110822","Moor Street, Soho",384
"13675",2020,18,387,232,223,"51.49369988","-0.121394101","Fire Brigade Pier, Vauxhall",455
"13676",2020,18,388,122,129,"51.51070161","-0.121723604","Southampton Street, Strand",251
"13677",2020,18,389,32,25,"51.51013066","-0.155757901","Upper Grosvenor Street, Mayfair",57
"13678",2020,18,390,66,54,"51.521776","-0.068856","Buxton Street 1, Shoreditch",120
"13679",2020,18,392,154,148,"51.49942855","-0.179702476","Imperial College, Knightsbridge",302
"13680",2020,18,393,62,62,"51.51733427","-0.103604248","Snow Hill, Farringdon",124
"13681",2020,18,394,109,99,"51.524826","-0.176268","Aberdeen Place, St. John's Wood",208
"13682",2020,18,395,192,176,"51.492462","-0.159919","Cadogan Gardens, Chelsea",368
"13683",2020,18,396,124,121,"51.51809","-0.163609","Shouldham Street, Marylebone",245
"13684",2020,18,397,306,295,"51.51348","-0.17977","Devonshire Terrace, Bayswater",601
"13685",2020,18,398,178,151,"51.502319","-0.200742","Holland Park, Kensington",329
"13686",2020,18,399,158,171,"51.52261762","-0.071653961","Brick Lane Market, Shoreditch",329
"13687",2020,18,400,110,111,"51.517703","-0.154106","George Street, Marylebone",221
"13688",2020,18,401,191,191,"51.528187","-0.075375","Columbia Road, Shoreditch",382
"13689",2020,18,402,62,58,"51.52289229","-0.171681991","Penfold Street, Marylebone",120
"13690",2020,18,403,152,146,"51.51689296","-0.158249929","George Place Mews, Marylebone",298
"13691",2020,18,404,194,202,"51.50204238","-0.184400221","Palace Gate, Kensington Gardens",396
"13692",2020,18,405,263,279,"51.49418566","-0.18267094","Gloucester Road Station, South Kensington",542
"13693",2020,18,409,245,222,"51.493146","-0.099828","Strata, Elephant & Castle",467
"13694",2020,18,410,200,160,"51.519968","-0.169774","Edgware Road Station, Marylebone",360
"13695",2020,18,411,246,274,"51.49337264","-0.09968067","Walworth Road, Elephant & Castle",520
"13696",2020,18,412,103,103,"51.488105","-0.110121","Cleaver Street, Kennington",206
"13697",2020,18,419,360,351,"51.485821","-0.149004","Chelsea Bridge, Pimlico",711
"13698",2020,18,420,67,60,"51.504043","-0.105312","Southwark Station 1, Southwark",127
"13699",2020,18,421,82,73,"51.504044","-0.104778","Southwark Station 2, Southwark",155
"13700",2020,18,423,155,166,"51.49456127","-0.15393398","Eaton Square (South), Belgravia",321
"13701",2020,18,424,133,127,"51.490491","-0.149186","Ebury Bridge, Pimlico",260
"13702",2020,18,425,78,85,"51.533379","-0.139159","Harrington Square 2, Camden Town",163
"13703",2020,18,426,172,156,"51.493072","-0.129925","Vincent Street, Pimlico",328
"13704",2020,18,427,247,246,"51.51397065","-0.09294031","Cheapside, Bank",493
"13705",2020,18,428,266,287,"51.499917","-0.174554","Exhibition Road, Knightsbridge",553
"13706",2020,18,430,134,126,"51.48902","-0.17524","South Parade, Chelsea",260
"13707",2020,18,431,66,65,"51.534474","-0.122203","Crinan Street, King's Cross",131
"13708",2020,18,432,118,113,"51.496957","-0.173894","Exhibition Road Museums, South Kensington",231
"13709",2020,18,433,87,73,"51.524564","-0.116279","Wren Street, Holborn",160
"13710",2020,18,435,131,131,"51.488852","-0.105593","Kennington Station, Kennington",262
"13711",2020,18,436,45,48,"51.51824","-0.11655","Red Lion Street, Holborn",93
"13712",2020,18,437,144,134,"51.488124","-0.120903","Vauxhall Walk, Vauxhall",278
"13713",2020,18,439,46,41,"51.5338","-0.118677","Killick Street, King's Cross",87
"13714",2020,18,440,194,213,"51.483145","-0.113134","Kennington Oval, Oval",407
"13715",2020,18,441,158,153,"51.495656","-0.114605","Sail Street, Vauxhall",311
"13716",2020,18,442,107,116,"51.510101","-0.211358","Walmer Road, Avondale",223
"13717",2020,18,443,138,135,"51.515256","-0.058641","Philpot Street, Whitechapel",273
"13718",2020,18,444,107,106,"51.52568","-0.055312","Bethnal Green Garden, Bethnal Green",213
"13719",2020,18,445,107,107,"51.52388","-0.065076","Cheshire Street, Bethnal Green",214
"13720",2020,18,446,91,97,"51.528936","-0.055894","York Hall, Bethnal Green",188
"13721",2020,18,447,77,75,"51.493381","-0.007542","Jubilee Crescent, Cubitt Town",152
"13722",2020,18,448,141,140,"51.50623","-0.02296","Fisherman's Walk West, Canary Wharf",281
"13723",2020,18,449,268,239,"51.511088","-0.057159","Shadwell Station, Shadwell",507
"13724",2020,18,450,125,114,"51.515975","-0.053177","Jubilee Street, Stepney",239
"13725",2020,18,451,170,155,"51.504719","-0.063531","Hermitage Court, Wapping",325
"13726",2020,18,452,146,175,"51.505697","-0.070542","St. Katharine's Way, Tower",321
"13727",2020,18,453,162,142,"51.508447","-0.055167","Garnet Street, Shadwell",304
"13728",2020,18,454,147,145,"51.487679","-0.021582","Napier Avenue, Millwall",292
"13729",2020,18,455,105,107,"51.49447","-0.014409","East Ferry Road, Cubitt Town",212
"13730",2020,18,456,174,204,"51.538071","-0.144664","Parkway, Camden Town",378
"13731",2020,18,458,194,204,"51.504749","-0.057544","Wapping Lane, Wapping",398
"13732",2020,18,459,162,173,"51.535179","-0.03338","Gunmakers Lane, Old Ford",335
"13733",2020,18,460,213,203,"51.516196","-0.029138","Burdett Road, Mile End",416
"13734",2020,18,461,90,79,"51.516","-0.038775","Aston Street, Stepney",169
"13735",2020,18,462,323,326,"51.541603","-0.138853","Bonny Street, Camden Town",649
"13736",2020,18,463,91,84,"51.534776","-0.071881","Thurtle Road, Haggerston",175
"13737",2020,18,464,36,46,"51.51417","-0.052099","St. Mary & St. Michael Church, Stepney",82
"13738",2020,18,465,143,146,"51.53558","-0.08249","Pitfield Street North,Hoxton",289
"13739",2020,18,466,113,126,"51.534464","-0.076341","Whiston Road, Haggerston",239
"13740",2020,18,467,106,108,"51.523538","-0.030556","Southern Grove, Bow",214
"13741",2020,18,468,64,64,"51.521564","-0.022694","Cantrell Road, Bow",128
"13742",2020,18,469,131,122,"51.513757","-0.020467","Lindfield Street, Poplar",253
"13743",2020,18,470,147,142,"51.530535","-0.025492","Mostyn Grove, Bow",289
"13744",2020,18,471,116,126,"51.533283","-0.028155","Hewison Street, Old Ford",242
"13745",2020,18,472,34,27,"51.529452","-0.027616","Malmesbury Road, Bow",61
"13746",2020,18,473,105,110,"51.496137","-0.019355","Millharbour, Millwall",215
"13747",2020,18,475,160,169,"51.499041","-0.020157","Lightermans Road, Millwall",329
"13748",2020,18,476,98,100,"51.489096","-0.009205","Stebondale Street, Cubitt Town",198
"13749",2020,18,477,107,93,"51.49109","-0.018716","Spindrift Avenue, Millwall",200
"13750",2020,18,478,191,188,"51.521889","-0.04667","Stepney Green Station, Stepney",379
"13751",2020,18,479,162,174,"51.527152","-0.058005","Pott Street, Bethnal Green",336
"13752",2020,18,480,370,370,"51.5128711","-0.0389866","Flamborough Street, Limehouse",740
"13753",2020,18,481,269,284,"51.487129","-0.009001","Saunders Ness Road, Cubitt Town",553
"13754",2020,18,483,149,132,"51.51328","-0.047784","Albert Gardens, Stepney",281
"13755",2020,18,484,124,138,"51.528828","-0.013258","Bromley High Street, Bow",262
"13756",2020,18,485,154,160,"51.531127","-0.048017","Old Ford Road, Bethnal Green",314
"13757",2020,18,486,200,208,"51.525645","-0.069543","Granby Street, Shoreditch",408
"13758",2020,18,487,107,103,"51.511811","-0.025626","Canton Street, Poplar",210
"13759",2020,18,488,121,132,"51.506946","-0.058681","Reardon Street, Wapping",253
"13760",2020,18,489,134,135,"51.513074","-0.064094","Christian Street, Whitechapel",269
"13761",2020,18,490,95,72,"51.508622","-0.065006","Pennington Street, Wapping",167
"13762",2020,18,491,115,95,"51.522507","-0.041378","Queen Mary's, Mile End",210
"13763",2020,18,492,166,157,"51.525501","-0.032267204","Maplin Street, Mile End",323
"13764",2020,18,494,18,18,"51.50196","-0.016251","South Quay East, Canary Wharf",36
"13765",2020,18,495,272,272,"51.528169","-0.018703","Bow Church Station, Bow",544
"13766",2020,18,496,164,162,"51.52512","-0.015578","Devons Road, Bow",326
"13767",2020,18,497,78,72,"51.526149","-0.027396845","Merchant Street, Bow",150
"13768",2020,18,498,141,131,"51.527058","-0.025296","Bow Road Station, Bow",272
"13769",2020,18,499,196,181,"51.519265","-0.021345","Furze Green, Bow",377
"13770",2020,18,500,268,268,"51.519806","-0.055731","Ansell House, Stepney",536
"13771",2020,18,501,130,121,"51.522561","-0.054883","Cephas Street, Bethnal Green",251
"13772",2020,18,502,248,256,"51.53341","-0.049591815","Bonner Gate, Victoria Park",504
"13773",2020,18,503,222,229,"51.520893","-0.051394","Cleveland Way, Stepney",451
"13774",2020,18,504,78,76,"51.496454","-0.009506","St. John's Park, Cubitt Town",154
"13775",2020,18,505,135,140,"51.520398","-0.026768","Ackroyd Drive, Bow",275
"13776",2020,18,506,104,108,"51.517475","-0.075855","Bell Lane, Liverpool Street",212
"13777",2020,18,507,71,67,"51.528692","-0.059091","Clarkson Street, Bethnal Green",138
"13778",2020,18,508,67,76,"51.519362","-0.074431","Fournier Street, Whitechapel",143
"13779",2020,18,509,39,30,"51.517842","-0.090075","Fore Street, Guildhall",69
"13780",2020,18,510,347,367,"51.509303","-0.025996","Westferry DLR, Limehouse",714
"13781",2020,18,511,225,228,"51.511066","-0.053558","Sutton Street, Shadwell",453
"13782",2020,18,512,177,194,"51.532091","-0.06142","Pritchard's Road, Bethnal Green",371
"13783",2020,18,513,136,149,"51.5142228","-0.055656","Watney Market, Stepney",285
"13784",2020,18,514,103,111,"51.516204","-0.155525","Portman Square, Marylebone",214
"13785",2020,18,515,98,101,"51.500088","-0.211316","Russell Gardens, Olympia",199
"13786",2020,18,516,116,121,"51.5112","-0.014438","Chrisp Street Market, Poplar",237
"13787",2020,18,517,77,84,"51.532513","-0.033085","Ford Road, Old Ford",161
"13788",2020,18,518,162,143,"51.528224","-0.037471","Antill Road, Mile End",305
"13789",2020,18,519,54,54,"51.518811","-0.011662","Teviot Street, Poplar",108
"13790",2020,18,520,107,85,"51.526041","-0.047218","Bancroft Road, Bethnal Green",192
"13791",2020,18,521,187,195,"51.534137","-0.037366","Driffield Road, Old Ford",382
"13792",2020,18,522,202,205,"51.525941","-0.036017","Clinton Road, Mile End",407
"13793",2020,18,523,69,66,"51.51549","-0.013475","Langdon Park, Poplar",135
"13794",2020,18,524,183,156,"51.511654","-0.179668","Lancaster Gate , Bayswater",339
"13795",2020,18,526,117,100,"51.503143","-0.008428","Lancaster Drive, Blackwall",217
"13796",2020,18,527,105,136,"51.503802","-0.215808","Hansard Mews, Holland Park",241
"13797",2020,18,528,32,25,"51.507326","-0.145827","Clarges Street, Mayfair",57
"13798",2020,18,529,122,118,"51.486892","-0.170983","Manresa Road, Chelsea",240
"13799",2020,18,530,120,119,"51.508896","-0.012413","Newby Place, Poplar",239
"13800",2020,18,531,192,177,"51.530326","-0.042744","Twig Folly Bridge, Mile End",369
"13801",2020,18,532,219,219,"51.50357","-0.020068","Jubilee Plaza, Canary Wharf",438
"13802",2020,18,533,112,103,"51.528222","-0.069743","Wellington Row, Bethnal Green",215
"13803",2020,18,534,209,222,"51.531864","-0.066035","Goldsmith's Row, Haggerston",431
"13804",2020,18,535,269,268,"51.537349","-0.147154","Gloucester Avenue, Camden Town",537
"13805",2020,18,536,63,64,"51.53385","-0.06992","Queensbridge Road, Haggerston",127
"13806",2020,18,537,136,140,"51.51793","-0.067937","Old Montague Street, Whitechapel",276
"13807",2020,18,538,133,128,"51.508981","-0.00699","Naval Row, Blackwall",261
"13808",2020,18,540,193,192,"51.528302","-0.144466","Albany Street, The Regent's Park",385
"13809",2020,18,541,334,331,"51.506613","-0.142844","Green Park Station, Mayfair",665
"13810",2020,18,542,194,184,"51.514115","-0.033828","Salmon Lane, Limehouse",378
"13811",2020,18,543,62,50,"51.509591","-0.204666","Lansdowne Walk, Ladbroke Grove",112
"13812",2020,18,544,79,77,"51.526153","-0.102208","Percival Street, Finsbury",156
"13813",2020,18,545,130,138,"51.539957","-0.145246","Arlington Road, Camden Town",268
"13814",2020,18,546,87,84,"51.517428","-0.107987","New Fetter Lane, Holborn",171
"13815",2020,18,547,319,336,"51.509474","-0.002275","East India DLR, Blackwall",655
"13816",2020,18,548,32,44,"51.498386","-0.107913","Westminster Bridge Road, Elephant & Castle",76
"13817",2020,18,549,117,121,"51.49605","-0.104193","Gaywood  Street, Elephant & Castle",238
"13818",2020,18,550,74,70,"51.521564","-0.039264","Harford Street, Mile End",144
"13819",2020,18,551,67,72,"51.505772","-0.016460175","Import Dock, Canary Wharf",139
"13820",2020,18,552,105,105,"51.511542","-0.056667","Watney Street, Shadwell",210
"13821",2020,18,553,575,572,"51.535678","-0.062546","Regent's Row , Haggerston",1147
"13822",2020,18,554,75,65,"51.513548","-0.005659","Aberfeldy Street, Poplar",140
"13823",2020,18,556,63,57,"51.502661","-0.021596","Heron Quays DLR, Canary Wharf",120
"13824",2020,18,557,63,65,"51.51601","-0.0985","King Edward Street, St Pauls",128
"13825",2020,18,558,128,130,"51.493978","-0.127554","Page Street, Westminster",258
"13826",2020,18,559,110,111,"51.501391","-0.205991","Abbotsbury Road, Holland Park",221
"13827",2020,18,560,67,47,"51.511624","-0.205921","Ladbroke Grove Central, Ladbroke Grove",114
"13828",2020,18,561,98,96,"51.518369","-0.043371","Rectory Square, Stepney",194
"13829",2020,18,562,56,56,"51.51746","-0.12335","Bury Place, Holborn",112
"13830",2020,18,563,100,94,"51.499286","-0.009152","Preston's Road, Cubitt Town",194
"13831",2020,18,564,176,175,"51.509943","-0.117619","Somerset House, Strand",351
"13832",2020,18,565,55,54,"51.521905","-0.063386","Selby Street, Whitechapel",109
"13833",2020,18,566,176,168,"51.509158","-0.224103","Westfield Ariel Way, White City",344
"13834",2020,18,568,270,271,"51.51616","-0.18697","Bishop's Bridge Road West, Bayswater",541
"13835",2020,18,569,52,64,"51.53213","-0.08299","Pitfield Street Central, Hoxton",116
"13836",2020,18,570,165,179,"51.503083","-0.017676","Upper Bank Street, Canary Wharf",344
"13837",2020,18,571,84,74,"51.506256","-0.218337","Westfield Southern Terrace ,Shepherd's Bush",158
"13838",2020,18,572,203,212,"51.539099","-0.141728","Greenland Road, Camden Town",415
"13839",2020,18,573,299,316,"51.485587","-0.18119","Limerston Street, West Chelsea",615
"13840",2020,18,574,218,206,"51.53356","-0.09315","Eagle Wharf Road, Hoxton",424
"13841",2020,18,576,118,126,"51.497304","-0.022793","Alpha Grove, Millwall",244
"13842",2020,18,577,192,193,"51.528869","-0.047548","Globe Town Market, Bethnal Green",385
"13843",2020,18,578,45,43,"51.527607","-0.057133","Hollybush Gardens, Bethnal Green",88
"13844",2020,18,579,279,281,"51.511246","-0.093051","Queen Street 2, Bank",560
"13845",2020,18,580,255,249,"51.48692917","-0.102996299","Doddington Grove, Kennington",504
"13846",2020,18,581,188,186,"51.519167","-0.147983","New Cavendish Street, Marylebone",374
"13847",2020,18,583,271,286,"51.497622","-0.125978","Abingdon Green, Westminster",557
"13848",2020,18,584,189,194,"51.51244","-0.19096","Ilchester Gardens, Bayswater",383
"13849",2020,18,586,62,57,"51.490645","-0.014582","Mudchute DLR, Cubitt Town",119
"13850",2020,18,587,197,192,"51.50964","-0.08497","Monument Street, Monument",389
"13851",2020,18,588,107,101,"51.52959","-0.0801","Hoxton Street, Hoxton",208
"13852",2020,18,589,267,271,"51.487196","-0.179369","Drayton Gardens, West Chelsea",538
"13853",2020,18,590,80,62,"51.53256","-0.16862","Greenberry Street, St.John's Wood",142
"13854",2020,18,592,106,109,"51.5171","-0.18377","Bishop's Bridge Road East, Bayswater",215
"13855",2020,18,593,45,70,"51.531066","-0.11934","Northdown Street, King's Cross",115
"13856",2020,18,594,21,22,"51.513875","-0.117774","Kingsway Southbound, Strand",43
"13857",2020,18,595,125,142,"51.493267","-0.21985","Hammersmith Road, Hammersmith",267
"13858",2020,18,596,238,239,"51.472817","-0.199783","Parson's Green , Parson's Green",477
"13859",2020,18,597,148,131,"51.473471","-0.20782","Fulham Park Road, Fulham",279
"13860",2020,18,598,179,185,"51.494499","-0.228188","Southerton Road, Hammersmith",364
"13861",2020,18,599,93,107,"51.485743","-0.223616","Manbre Road, Hammersmith",200
"13862",2020,18,600,336,327,"51.481747","-0.124642","South Lambeth Road, Vauxhall",663
"13863",2020,18,601,189,192,"51.514767","-0.225787","BBC White City, White City",381
"13864",2020,18,602,196,176,"51.472993","-0.133972","Union Grove, Wandsworth Road",372
"13865",2020,18,603,259,284,"51.477839","-0.116493","Caldwell Street, Stockwell",543
"13866",2020,18,604,43,59,"51.538792","-0.138535","St Martins Close, Camden Town",102
"13867",2020,18,605,149,137,"51.520331","-0.163667","Seymour Place, Marylebone",286
"13868",2020,18,606,57,64,"51.504199","-0.210941","Addison Road, Holland Park",121
"13869",2020,18,607,164,171,"51.468814","-0.210279","Putney Bridge Station, Fulham",335
"13870",2020,18,608,21,27,"51.491093","-0.216493","Colet Gardens, Hammersmith",48
"13871",2020,18,609,129,134,"51.46512358","-0.157788279","Sugden Road, Clapham",263
"13872",2020,18,610,248,230,"51.48256792","-0.172078187","Danvers Street, West Chelsea",478
"13873",2020,18,611,168,158,"51.50646524","-0.208486599","Princedale Road , Holland Park",326
"13874",2020,18,612,251,245,"51.46925984","-0.141812513","Wandsworth Rd, Isley Court, Wandsworth Road",496
"13875",2020,18,613,228,239,"51.50403821","-0.217400093","Woodstock Grove, Shepherd's Bush",467
"13876",2020,18,614,52,56,"51.47817208","-0.144690541","Bradmead, Battersea Park",108
"13877",2020,18,615,152,162,"51.4768851","-0.215895601","Finlay Street, Fulham",314
"13878",2020,18,616,139,145,"51.48102131","-0.209973497","Aintree Street, Fulham",284
"13879",2020,18,617,80,70,"51.47107905","-0.207842908","Elysium Place, Fulham",150
"13880",2020,18,618,139,149,"51.47625965","-0.193254007","Eel Brook Common, Walham Green",288
"13881",2020,18,619,138,132,"51.4737636","-0.197010096","Irene Road, Parsons Green",270
"13882",2020,18,620,126,127,"51.47518024","-0.167160736","Surrey Lane, Battersea",253
"13883",2020,18,621,151,175,"51.46086446","-0.187427294","Wandsworth Town Station, Wandsworth",326
"13884",2020,18,622,207,215,"51.50748124","-0.205535908","Lansdowne Road, Ladbroke Grove",422
"13885",2020,18,623,66,79,"51.46193072","-0.180791784","Nantes Close, Wandsworth",145
"13886",2020,18,624,174,178,"51.4729184","-0.132102704","Courland Grove, Wandsworth Road",352
"13887",2020,18,625,707,693,"51.47761941","-0.149551631","Queen's Circus, Battersea Park",1400
"13888",2020,18,626,198,190,"51.48438657","-0.20481514","Normand Park, West Kensington",388
"13889",2020,18,627,79,72,"51.4687905","-0.158230901","Holden Street, Battersea",151
"13890",2020,18,628,40,45,"51.46881971","-0.184318843","William Morris Way, Sands End",85
"13891",2020,18,629,50,67,"51.45995384","-0.190184054","Morie Street, Wandsworth",117
"13892",2020,18,630,166,162,"51.47073264","-0.126994068","Clarence Walk, Stockwell",328
"13893",2020,18,631,147,148,"51.4795017","-0.141770709","Battersea Park Road, Nine Elms",295
"13894",2020,18,632,104,107,"51.47053858","-0.163041605","Sheepcote Lane, Battersea",211
"13895",2020,18,633,221,198,"51.48959104","-0.209378594","Vereker Road, West Kensington",419
"13896",2020,18,634,114,94,"51.49434708","-0.215804559","Brook Green South, Brook Green",208
"13897",2020,18,635,157,143,"51.48606206","-0.214428378","Greyhound Road, Hammersmith",300
"13898",2020,18,636,109,110,"51.46706414","-0.193502076","South Park, Sands End",219
"13899",2020,18,637,156,148,"51.45787019","-0.174691623","Spencer Park, Wandsworth Common",304
"13900",2020,18,638,174,190,"51.46663393","-0.169821175","Falcon Road, Clapham Junction",364
"13901",2020,18,639,137,139,"51.48357068","-0.202038682","Coomer Place, West Kensington",276
"13902",2020,18,640,172,169,"51.47286577","-0.148059277","Silverthorne Road, Battersea",341
"13903",2020,18,641,186,201,"51.49824168","-0.117495865","Archbishop's Park, Waterloo",387
"13904",2020,18,642,88,84,"51.46916161","-0.174485792","Fawcett Close, Battersea",172
"13905",2020,18,643,135,140,"51.5190427","-0.204764421","All Saints' Road, Portobello",275
"13906",2020,18,644,165,143,"51.48373225","-0.223852256","Rainville Road, Hammersmith",308
"13907",2020,18,645,80,94,"51.50173215","-0.100292412","Great Suffolk Street, The Borough",174
"13908",2020,18,646,183,207,"51.49886563","-0.137424571","Buckingham Gate, Westminster",390
"13909",2020,18,647,185,183,"51.50035306","-0.217515071","Richmond Way, Shepherd's Bush",368
"13910",2020,18,648,92,83,"51.46904022","-0.19627483","Peterborough Road, Sands End",175
"13911",2020,18,649,161,184,"51.48180515","-0.18027465","World's End Place, West Chelsea",345
"13912",2020,18,650,238,230,"51.51687069","-0.213872396","St. Mark's Road, North Kensington",468
"13913",2020,18,651,121,126,"51.48089844","-0.183853573","Thorndike Close, West Chelsea",247
"13914",2020,18,652,56,53,"51.51148696","-0.218190203","Evesham Street, Avondale",109
"13915",2020,18,653,111,149,"51.47084722","-0.17070367","Simpson Street, Clapham Junction",260
"13916",2020,18,654,165,179,"51.48267821","-0.117661574","Ashmole Estate, Oval",344
"13917",2020,18,655,128,122,"51.48294452","-0.219346128","Crabtree Lane, Fulham",250
"13918",2020,18,656,55,56,"51.46841875","-0.199135704","Broomhouse Lane, Parsons Green",111
"13919",2020,18,657,118,118,"51.4996806","-0.221791552","Blythe Road West, Shepherd's Bush",236
"13920",2020,18,658,523,527,"51.47729232","-0.16478637","Ethelburga Estate, Battersea Park",1050
"13921",2020,18,659,148,141,"51.511934","-0.10307894","Blackfriars Station, St. Paul's",289
"13922",2020,18,660,132,125,"51.49087074","-0.206029743","West Kensington Station, West Kensington",257
"13923",2020,18,661,306,325,"51.51632095","-0.202608612","All Saints Church, Portobello",631
"13924",2020,18,662,245,236,"51.48498496","-0.167919869","Phene Street, Chelsea",481
"13925",2020,18,663,102,104,"51.51323001","-0.211593602","Clarendon Road, Avondale",206
"13926",2020,18,664,254,241,"51.474376","-0.155442787","Austin Road, Battersea Park",495
"13927",2020,18,665,174,165,"51.46108367","-0.191722864","Smugglers Way, Wandsworth",339
"13928",2020,18,666,171,148,"51.49610093","-0.208158259","Olympia Way, Olympia",319
"13929",2020,18,667,187,186,"51.5015946","-0.222293381","Shepherd's Bush Road North, Shepherd's Bush",373
"13930",2020,18,668,376,393,"51.49422354","-0.236769936","Ravenscourt Park Station, Hammersmith",769
"13931",2020,18,669,155,174,"51.47614939","-0.1232585","Teversham Lane, Stockwell",329
"13932",2020,18,670,192,181,"51.46718562","-0.152248582","Ashley Crescent, Battersea",373
"13933",2020,18,671,138,151,"51.475089","-0.201968","Parsons Green Station, Parsons Green",289
"13934",2020,18,673,217,235,"51.46517078","-0.18038939","Hibbert Street, Battersea",452
"13935",2020,18,674,115,99,"51.53546778","-0.11619105","Carnegie Street, King's Cross",214
"13936",2020,18,675,111,103,"51.46348914","-0.182126248","Usk Road, Clapham Junction",214
"13937",2020,18,676,214,211,"51.47787084","-0.126874471","Hartington Road, Stockwell",425
"13938",2020,18,677,96,77,"51.46866929","-0.146544642","Heath Road, Battersea",173
"13939",2020,18,678,45,33,"51.46231278","-0.211468596","Esmond Street, Putney",78
"13940",2020,18,679,105,98,"51.47453545","-0.170210533","Orbel Street, Battersea",203
"13941",2020,18,680,228,229,"51.47768469","-0.170329317","Westbridge Road, Battersea",457
"13942",2020,18,681,183,202,"51.47303687","-0.214749808","Bishop's Avenue, Fulham",385
"13943",2020,18,682,309,337,"51.48810829","-0.22660621","Crisp Road, Hammersmith",646
"13944",2020,18,683,163,168,"51.46506424","-0.163750945","Dorothy Road, Clapham Junction",331
"13945",2020,18,684,274,271,"51.45475251","-0.195197203","Neville Gill Close, Wandsworth",545
"13946",2020,18,685,150,157,"51.46067005","-0.198735357","Osiers Road, Wandsworth",307
"13947",2020,18,686,118,106,"51.48814438","-0.222456468","Beryl Road, Hammersmith",224
"13948",2020,18,687,118,124,"51.49760804","-0.21145598","Maclise Road, Olympia",242
"13949",2020,18,688,110,105,"51.46095151","-0.20066766","Northfields, Wandsworth",215
"13950",2020,18,689,77,78,"51.45922541","-0.180884959","Spanish Road, Clapham Junction",155
"13951",2020,18,690,94,83,"51.47047503","-0.152130083","Stanley Grove, Battersea",177
"13952",2020,18,691,226,251,"51.47946386","-0.195777222","Erin Close, Walham Green",477
"13953",2020,18,692,249,234,"51.54211855","-0.028941601","Cadogan Close, Victoria Park",483
"13954",2020,18,693,114,126,"51.464786","-0.215618902","Felsham Road, Putney",240
"13955",2020,18,694,148,152,"51.46071722","-0.216526155","Putney Rail Station, Putney",300
"13956",2020,18,695,469,480,"51.53638435","-0.102757578","Islington Green, Angel",949
"13957",2020,18,696,118,107,"51.48728535","-0.217995921","Charing Cross Hospital, Hammersmith",225
"13958",2020,18,697,137,135,"51.53639219","-0.112721065","Charlotte Terrace, Angel",272
"13959",2020,18,698,146,154,"51.53908372","-0.070329419","Shoreditch Court, Haggerston",300
"13960",2020,18,699,94,70,"51.5366541","-0.07023031","Belford House, Haggerston",164
"13961",2020,18,700,145,151,"51.47696496","-0.174347066","Battersea Church Road, Battersea",296
"13962",2020,18,701,267,239,"51.47287627","-0.176267008","Vicarage Crescent, Battersea",506
"13963",2020,18,702,131,137,"51.52868155","-0.065550321","Durant Street, Bethnal Green",268
"13964",2020,18,703,88,98,"51.51505991","-0.10534448","St. Bride Street, Holborn",186
"13965",2020,18,704,101,76,"51.45682071","-0.202802098","Mexfield Road, East Putney",177
"13966",2020,18,705,128,133,NA,NA,NA,261
"13967",2020,18,706,90,109,"51.50215353","-0.083632928","Snowsfields, London Bridge",199
"13968",2020,18,707,112,119,"51.49021762","-0.215087092","Barons Court Station, West Kensington",231
"13969",2020,18,708,110,104,"51.46161068","-0.21614583","Disraeli Road, Putney",214
"13970",2020,18,709,121,114,"51.46321128","-0.215550761","Montserrat Road , Putney",235
"13971",2020,18,710,355,355,"51.47439218","-0.163347594","Albert Bridge Road, Battersea Park",710
"13972",2020,18,711,107,110,"51.48335692","-0.216305546","Everington Street, Fulham",217
"13973",2020,18,712,176,175,"51.51854104","-0.034903714","Mile End Stadium, Mile End",351
"13974",2020,18,713,175,183,"51.54100708","-0.14326094","Hawley Crescent, Camden Town",358
"13975",2020,18,714,73,71,"51.47311696","-0.137235175","Stewart's Road, Wandsworth Road",144
"13976",2020,18,715,135,107,"51.51563007","-0.049067243","Aylward Street, Stepney",242
"13977",2020,18,716,95,100,"51.51542791","-0.02356501","Stainsby Road , Poplar",195
"13978",2020,18,717,293,303,"51.53658514","-0.075885686","Dunston Road , Haggerston",596
"13979",2020,18,718,166,175,"51.53571683","-0.060291813","Ada Street, Hackney Central",341
"13980",2020,18,719,290,284,"51.53642464","-0.054162264","Victoria Park Road, Hackney Central",574
"13981",2020,18,720,148,137,"51.48724429","-0.205279052","Star Road, West Kensington",285
"13982",2020,18,721,146,139,"51.53603947","-0.026262677","Wendon Street, Old Ford",285
"13983",2020,18,722,79,79,"51.52458353","-0.058631453","Finnis Street, Bethnal Green",158
"13984",2020,18,723,327,324,"51.46822047","-0.190346493","Stephendale Road, Sands End",651
"13985",2020,18,724,96,81,"51.45799126","-0.184806157","Alma Road, Wandsworth",177
"13986",2020,18,725,193,194,"51.491327","-0.096518684","Walworth Square, Walworth",387
"13987",2020,18,726,139,133,"51.47505096","-0.150908371","Alfreda Street, Battersea Park",272
"13988",2020,18,727,216,205,"51.47569809","-0.20587627","Chesilton Road, Fulham",421
"13989",2020,18,728,130,133,"51.46199911","-0.206240805","Putney Bridge Road, East Putney",263
"13990",2020,18,729,201,189,"51.47893931","-0.208485293","St. Peter's Terrace, Fulham",390
"13991",2020,18,730,233,242,"51.49208492","-0.229116862","Bridge Avenue, Hammersmith",475
"13992",2020,18,731,98,112,"51.47727637","-0.189210466","Michael Road, Walham Green",210
"13993",2020,18,732,329,346,"51.50630441","-0.087262995","Duke Street Hill, London Bridge",675
"13994",2020,18,733,93,75,"51.50542628","-0.150817316","Park Lane, Mayfair",168
"13995",2020,18,734,124,123,"51.46230566","-0.175407201","Plough Terrace, Clapham Junction",247
"13996",2020,18,735,71,77,"51.46489445","-0.17302926","Grant Road East, Clapham Junction",148
"13997",2020,18,736,89,94,"51.50659035","-0.216104479","Queensdale Road, Shepherd's Bush",183
"13998",2020,18,737,275,284,"51.47993289","-0.19411695","Fulham Broadway, Walham Green",559
"13999",2020,18,738,143,129,"51.47514228","-0.187278987","Imperial Road, Sands End",272
"14000",2020,18,739,161,152,"51.48176572","-0.185273723","Hortensia Road, West Brompton",313
"14001",2020,18,740,56,58,"51.51092871","-0.214594781","Sirdar Road, Avondale",114
"14002",2020,18,741,54,54,"51.5129814","-0.219486603","Freston Road, Avondale",108
"14003",2020,18,742,169,182,"51.51510818","-0.208565479","Blenheim Crescent, Ladbroke Grove",351
"14004",2020,18,743,70,86,"51.46079243","-0.212607684","Oxford Road, Putney",156
"14005",2020,18,744,54,62,"51.46745485","-0.172293499","Ingrave Street, Clapham Junction",116
"14006",2020,18,745,94,70,"51.47816972","-0.18243547","Upcerne Road, West Chelsea",164
"14007",2020,18,746,200,189,"51.4795738","-0.17903854","Lots Road, West Chelsea",389
"14008",2020,18,747,157,132,"51.48796408","-0.161765173","Ormonde Gate, Chelsea",289
"14009",2020,18,748,184,201,"51.53727795","-0.079201849","Hertford Road, De Beauvoir Town",385
"14010",2020,18,749,316,328,"51.53932857","-0.074284675","Haggerston Road, Haggerston",644
"14011",2020,18,750,63,58,"51.4710956","-0.157850096","Culvert Road, Battersea",121
"14012",2020,18,751,52,44,"51.51612862","-0.120909408","Newton Street, Covent Garden",96
"14013",2020,18,754,54,48,"51.5129006","-0.214762686","Grenfell Road, Avondale",102
"14014",2020,18,755,207,209,"51.48512191","-0.174971902","The Vale, Chelsea",416
"14015",2020,18,756,106,138,"51.47515398","-0.159169801","Prince of Wales Drive, Battersea Park",244
"14016",2020,18,757,271,250,"51.48795853","-0.187404506","Harcourt Terrace, West Brompton",521
"14017",2020,18,758,157,173,"51.51787005","-0.201005397","Westbourne Park Road, Portobello",330
"14018",2020,18,759,45,45,"51.52456169","-0.165668686","Broadley Terrace, Marylebone",90
"14019",2020,18,760,59,50,"51.52526975","-0.163795009","Rossmore Road, Marylebone",109
"14020",2020,18,761,78,87,"51.48321729","-0.211860644","Humbolt Road, Fulham",165
"14021",2020,18,762,529,540,"51.50070305","-0.129698963","Storey's Gate, Westminster",1069
"14022",2020,18,763,165,161,"51.52059714","-0.032566533","Mile End Park Leisure Centre, Mile End",326
"14023",2020,18,764,188,201,"51.46239255","-0.16829214","St. John's Road, Clapham Junction",389
"14024",2020,18,765,85,100,"51.46760141","-0.20682737","Ranelagh Gardens, Fulham",185
"14025",2020,18,766,219,209,"51.45752945","-0.192165613","Ram Street, Wandsworth",428
"14026",2020,18,767,46,38,"51.45705988","-0.200806304","Santos Road, Wandsworth",84
"14027",2020,18,768,559,565,"51.46134382","-0.159322467","Clapham Common North Side, Clapham Common",1124
"14028",2020,18,769,157,164,"51.473611","-0.191803","Sandilands Road, Walham Green",321
"14029",2020,18,770,143,139,"51.491026","-0.209121","Gwendwr Road, West Kensington",282
"14030",2020,18,771,66,66,"51.509224","-0.216016","Rifle Place, Avondale",132
"14031",2020,18,772,351,358,"51.47250956","-0.122831913","Binfield Road, Stockwell",709
"14032",2020,18,773,111,94,"51.511891","-0.107349","Tallis Street, Temple",205
"14033",2020,18,774,84,92,"51.470131","-0.20464","Hurlingham Park, Parsons Green",176
"14034",2020,18,775,106,116,"51.496664","-0.223868","Little Brook Green, Brook Green",222
"14035",2020,18,776,209,224,"51.460333","-0.167029","Abyssinia Close, Clapham Junction",433
"14036",2020,18,777,107,124,"51.4619230679","-0.165297856693","Limburg Road, Clapham Junction",231
"14037",2020,18,779,77,70,"51.514449","-0.077178979","Houndsditch, Aldgate",147
"14038",2020,18,780,294,303,"51.474665","-0.18316517","Imperial Wharf Station, Sands End",597
"14039",2020,18,781,86,78,"51.495898","-0.173009","Victoria & Albert Museum, South Kensington",164
"14040",2020,18,782,231,236,"51.483911","-0.19760944","Halford Road, West Kensington",467
"14041",2020,18,783,148,157,"51.5403115","-0.021630359","Monier Road, Hackney Wick",305
"14042",2020,18,784,352,342,"51.546326","-0.00993526","East Village, Queen Elizabeth Olympic Park",694
"14043",2020,18,785,464,422,"51.54094","-0.010510565","Aquatic Centre, Queen Elizabeth Olympic Park",886
"14044",2020,18,786,429,406,"51.549369","-0.015717614","Lee Valley VeloPark, Queen Elizabeth Olympic Park",835
"14045",2020,18,787,358,371,"51.546805","-0.01469126","Timber Lodge, Queen Elizabeth Olympic Park",729
"14046",2020,18,789,454,465,"51.538718","-0.011889482","Podium, Queen Elizabeth Olympic Park",919
"14047",2020,18,790,179,187,"51.541793","-0.00481","Stratford Station, Stratford",366
"14048",2020,18,792,62,68,"51.505461","-0.10454093","Blackfriars Road, Southwark",130
"14049",2020,18,793,65,66,"51.528279","-0.11955857","Cromer Street, Bloomsbury",131
"14050",2020,18,795,27,22,"51.527068","-0.13186102","Euston Square Gardens, Euston",49
"14051",2020,18,796,72,85,"51.524","-0.12640984","Coram Street, Bloomsbury",157
"14052",2020,18,797,72,58,"51.5293","-0.12827903","Ossulston Street, Somers Town",130
"14053",2020,18,798,66,74,"51.5301998755","-0.122299440803","Birkenhead Street, King's Cross",140
"14054",2020,18,799,63,66,"51.4976984561","-0.137598896295","Kings Gate House, Westminster",129
"14055",2020,18,801,142,144,"51.5052241745","-0.0980318118664","Lavington Street, Bankside",286
"14056",2020,18,802,273,251,"51.4765900593","-0.118256789081","Albert Square, Stockwell",524
"14057",2020,18,803,94,87,"51.5054099403","-0.0983410884509","Southwark Street, Bankside",181
"14058",2020,18,804,197,206,"51.5346677396","-0.125078652873","Good's Way, King's Cross",403
"14059",2020,18,806,144,141,"51.5372405623","-0.124807385707","Handyside Street, King's Cross",285
"14060",2020,18,807,276,273,"51.5212","-0.20888818","Bevington Road West, North Kensington",549
"14061",2020,18,809,85,81,"51.5162778834","-0.118272991635","Lincoln's Inn Fields, Holborn",166
"14062",2020,18,810,82,65,"51.5067252868","-0.0988072461627","Tate Modern, Bankside",147
"14063",2020,18,811,377,388,"51.5057030357","-0.0277727426235","Westferry Circus, Canary Wharf",765
"14064",2020,18,812,201,199,"51.5487311915","-0.0226065549321","Here East North, Queen Elizabeth Olympic Park",400
"14065",2020,18,813,29,76,"51.4878074485","-0.122759625866","New Spring Gardens Walk, Vauxhall",105
"14066",2020,18,814,251,244,"51.4714330677","-0.123670735702","Clapham Road, Lingham Street, Stockwell",495
"14067",2020,18,815,303,274,"51.5000891978","-0.116628700672","Lambeth Palace Road, Waterloo",577
"14068",2020,18,816,63,60,"51.5465327935","-0.0205975904647","Here East South, Queen Elizabeth Olympic Park",123
"14069",2020,18,817,241,236,"51.4813354746","-0.138212295869","Riverlight South, Nine Elms",477
"14070",2020,18,818,552,540,"51.501513","-0.12382322","Westminster Pier, Westminster",1092
"14071",2020,18,819,113,86,"51.50621","-0.114842","Belvedere Road 2, South Bank",199
"14072",2020,18,820,128,134,"51.492807","-0.091938","Victory Place, Walworth",262
"14073",2020,18,821,462,466,"51.4835074867","-0.147714557371","Battersea Power Station, Battersea Park",928
"14074",2020,18,826,165,159,"51.496863","-0.1429434","Allington Street, Victoria",324
"14075",2020,18,827,262,264,"51.479601","-0.11147178","Cranmer Road, Stockwell",526
"14076",2020,18,828,179,178,"51.473874","-0.11258096","Normandy Road, Stockwell",357
"14077",2020,18,829,108,112,"51.469217","-0.11268674","Wynne Road, Stockwell",220
"14078",2020,18,830,174,175,"51.469202","-0.11902256","Sidney Road, Stockwell",349
"14079",2020,18,831,209,207,"51.466232","-0.11317995","St John's Crescent, Brixton",416
"14080",2020,18,832,356,370,"51.464019","-0.11578197","Ferndale Road, Brixton",726
"14081",2020,18,833,495,503,"51.460232","-0.11537509","Saltoun Road, Brixton",998
"14082",2020,18,834,281,323,"51.477966","-0.14785703","Gas Holders, Battersea Park",604
"14083",2020,18,835,79,81,"51.516785","-0.10494775","Farringdon Street, Holborn",160
"14084",2020,18,836,154,153,"51.541596","-0.12544145","York Way, Kings Cross",307
"14085",2020,18,838,63,61,"51.518093","-0.0914017","Fore Street Avenue, Guildhall",124
"14086",2020,18,839,152,165,"51.508033","-0.10682363","Sea Containers, South Bank",317
"14087",2020,19,1,166,157,"51.52916347","-0.109970527","River Street , Clerkenwell",323
"14088",2020,19,2,448,466,"51.49960695","-0.197574246","Phillimore Gardens, Kensington",914
"14089",2020,19,3,45,43,"51.52128377","-0.084605692","Christopher Street, Liverpool Street",88
"14090",2020,19,4,67,57,"51.53005939","-0.120973687","St. Chad's Street, King's Cross",124
"14091",2020,19,5,309,303,"51.49313","-0.156876","Sedding Street, Sloane Square",612
"14092",2020,19,6,172,169,"51.51811784","-0.144228881","Broadcasting House, Marylebone",341
"14093",2020,19,7,264,259,"51.53430039","-0.1680743","Charlbert Street, St. John's Wood",523
"14094",2020,19,8,630,648,"51.529857","-0.18348604","Maida Vale, Maida Vale",1278
"14095",2020,19,9,280,286,"51.5073853","-0.096440751","New Globe Walk, Bankside",566
"14096",2020,19,10,187,177,"51.50597426","-0.092754157","Park Street, Bankside",364
"14097",2020,19,11,146,152,"51.52395143","-0.122502346","Brunswick Square, Bloomsbury",298
"14098",2020,19,12,113,107,"51.52168078","-0.130431727","Malet Street, Bloomsbury",220
"14099",2020,19,13,92,90,"51.51991453","-0.136039674","Scala Street, Fitzrovia",182
"14100",2020,19,14,310,292,"51.52994371","-0.123616824","Belgrove Street , King's Cross",602
"14101",2020,19,15,118,116,"51.51772703","-0.127854211","Great Russell Street, Bloomsbury",234
"14102",2020,19,16,154,160,"51.52635795","-0.125979294","Cartwright Gardens , Bloomsbury",314
"14103",2020,19,17,242,259,"51.5216612","-0.109006325","Hatton Wall, Holborn",501
"14104",2020,19,18,240,231,"51.51477076","-0.12221963","Drury Lane, Covent Garden",471
"14105",2020,19,19,37,34,"51.52505093","-0.131161087","Taviton Street, Bloomsbury",71
"14106",2020,19,20,42,36,"51.527326","-0.13605286","Drummond Street , Euston",78
"14107",2020,19,21,64,72,"51.53007835","-0.13884627","Hampstead Road (Cartmel), Euston",136
"14108",2020,19,22,201,215,"51.5222641","-0.114079481","Northington Street , Holborn",416
"14109",2020,19,23,92,70,"51.51943538","-0.119123345","Red Lion Square, Holborn",162
"14110",2020,19,24,140,129,"51.51908011","-0.124678402","British Museum, Bloomsbury",269
"14111",2020,19,25,88,85,"51.5288338","-0.132250369","Doric Way , Somers Town",173
"14112",2020,19,26,115,108,"51.52728093","-0.11829517","Ampton Street , Clerkenwell",223
"14113",2020,19,27,84,66,"51.51382102","-0.107927706","Bouverie Street, Temple",150
"14114",2020,19,28,389,381,"51.52351808","-0.143613641","Bolsover Street, Fitzrovia",770
"14115",2020,19,29,276,272,"51.513735","-0.193487","Hereford Road, Bayswater",548
"14116",2020,19,30,193,169,"51.52915444","-0.093421615","Windsor Terrace, Hoxton",362
"14117",2020,19,31,152,166,"51.52953709","-0.083353323","Fanshaw Street, Hoxton",318
"14118",2020,19,32,229,238,"51.52469624","-0.084439283","Leonard Circus , Shoreditch",467
"14119",2020,19,33,184,183,"51.5156","-0.070056","Central House, Aldgate",367
"14120",2020,19,34,126,130,"51.5341235","-0.129386874","Pancras Road, King's Cross",256
"14121",2020,19,36,911,925,"51.50173726","-0.184980612","De Vere Gardens, Kensington",1836
"14122",2020,19,37,278,275,"51.49159394","-0.192369256","Penywern Road, Earl's Court",553
"14123",2020,19,38,189,193,"51.4973875","-0.197245586","Abingdon Villas, Kensington",382
"14124",2020,19,39,346,336,"51.5263778","-0.078130921","Shoreditch High Street, Shoreditch",682
"14125",2020,19,40,185,174,"51.52127071","-0.0755789","Commercial Street, Shoreditch",359
"14126",2020,19,41,36,29,"51.520955","-0.083493552","Pindar Street, Liverpool Street",65
"14127",2020,19,42,183,162,"51.53099181","-0.093903825","Wenlock Road , Hoxton",345
"14128",2020,19,43,276,267,"51.52026","-0.157183945","Crawford Street, Marylebone",543
"14129",2020,19,44,87,90,"51.51073687","-0.144165239","Bruton Street, Mayfair",177
"14130",2020,19,45,104,81,"51.522511","-0.162298","Boston Place, Marylebone",185
"14131",2020,19,47,664,688,"51.52334476","-0.183846408","Warwick Avenue Station, Maida Vale",1352
"14132",2020,19,48,317,312,"51.51248445","-0.099141408","Godliman Street, St. Paul's",629
"14133",2020,19,49,177,176,"51.50706909","-0.145904427","Curzon Street, Mayfair",353
"14134",2020,19,50,101,83,"51.52867339","-0.087459376","East Road, Hoxton",184
"14135",2020,19,51,110,103,"51.52671796","-0.104298194","Finsbury Library , Finsbury",213
"14136",2020,19,52,133,134,"51.52295439","-0.094934859","Roscoe Street, St. Luke's",267
"14137",2020,19,53,88,84,"51.5099923","-0.143495266","Grafton Street, Mayfair",172
"14138",2020,19,54,174,176,"51.52174785","-0.094475072","Golden Lane, Barbican",350
"14139",2020,19,55,148,135,"51.51707521","-0.086685542","Finsbury Circus, Liverpool Street",283
"14140",2020,19,56,230,235,"51.52058381","-0.154701411","Paddington Street, Marylebone",465
"14141",2020,19,57,217,215,"51.52334672","-0.120202614","Guilford Street , Bloomsbury",432
"14142",2020,19,58,154,151,"51.52452699","-0.079248081","New Inn Yard, Shoreditch",305
"14143",2020,19,60,124,127,"51.52644828","-0.172190727","Lisson Grove, St. John's Wood",251
"14144",2020,19,61,204,220,"51.49738251","-0.089446947","Great Dover Street, The Borough",424
"14145",2020,19,62,173,156,"51.4907579","-0.106323685","Cotton Garden Estate, Kennington",329
"14146",2020,19,63,132,123,"51.53089041","-0.089782579","Murray Grove , Hoxton",255
"14147",2020,19,64,332,337,"51.50946212","-0.124749274","William IV Street, Strand",669
"14148",2020,19,65,101,71,NA,NA,NA,172
"14149",2020,19,66,49,51,"51.51795029","-0.108657431","Holborn Circus, Holborn",100
"14150",2020,19,67,90,76,"51.51882555","-0.108028472","Hatton Garden, Holborn",166
"14151",2020,19,68,206,207,"51.52059681","-0.116688468","Theobald's Road , Holborn",413
"14152",2020,19,69,84,55,"51.5262363","-0.134407652","Euston Road, Euston",139
"14153",2020,19,70,118,88,"51.53136059","-0.117069978","Calshot Street , King's Cross",206
"14154",2020,19,71,260,210,"51.5154186","-0.098850915","Newgate Street , St. Paul's",470
"14155",2020,19,72,196,190,"51.52352001","-0.108340165","Farringdon Lane, Clerkenwell",386
"14156",2020,19,73,237,232,"51.52572618","-0.088486188","Old Street Station, St. Luke's",469
"14157",2020,19,74,656,666,"51.48591714","-0.124469948","Vauxhall Cross, Vauxhall",1322
"14158",2020,19,75,187,187,"51.53219984","-0.105480698","Torrens Street, Angel",374
"14159",2020,19,76,188,180,"51.52559505","-0.144083893","Longford Street, The Regent's Park",368
"14160",2020,19,77,213,213,"51.52341837","-0.124121774","Russell Square Station, Bloomsbury",426
"14161",2020,19,78,128,125,"51.52486887","-0.099489485","Sadlers Sports Centre, Finsbury",253
"14162",2020,19,79,83,85,"51.511726","-0.11385596","Arundel Street, Temple",168
"14163",2020,19,80,196,193,"51.50069361","-0.102091246","Webber Street , Southwark",389
"14164",2020,19,81,190,185,"51.52025302","-0.141327271","Great Titchfield Street, Fitzrovia",375
"14165",2020,19,82,87,81,"51.514274","-0.111257","Chancery Lane, Holborn",168
"14166",2020,19,83,299,301,"51.50963938","-0.131510949","Panton Street, West End",600
"14167",2020,19,84,47,41,"51.51593725","-0.111778348","Breams Buildings, Holborn",88
"14168",2020,19,85,501,546,"51.50064702","-0.078600401","Tanner Street, Bermondsey",1047
"14169",2020,19,86,150,134,"51.48947903","-0.115156562","Sancroft Street, Vauxhall",284
"14170",2020,19,87,61,60,"51.51646835","-0.079684557","Devonshire Square, Liverpool Street",121
"14171",2020,19,88,236,226,"51.51858757","-0.132053392","Bayley Street , Bloomsbury",462
"14172",2020,19,89,177,169,"51.5262503","-0.123509611","Tavistock Place, Bloomsbury",346
"14173",2020,19,90,47,42,"51.53301907","-0.139174593","Harrington Square 1, Camden Town",89
"14174",2020,19,91,246,237,"51.49368637","-0.111014912","Walnut Tree Walk, Vauxhall",483
"14175",2020,19,92,194,189,"51.49889832","-0.100440521","Borough Road, Elephant & Castle",383
"14176",2020,19,93,279,359,"51.53440868","-0.109025404","Cloudesley Road, Angel",638
"14177",2020,19,94,487,476,"51.49506109","-0.085814489","Bricklayers Arms, Borough",963
"14178",2020,19,95,264,274,"51.5208417","-0.097340162","Aldersgate Street, Barbican",538
"14179",2020,19,96,175,172,"51.53095071","-0.078505384","Falkirk Street, Hoxton",347
"14180",2020,19,97,400,389,"51.49792478","-0.183834706","Gloucester Road (North), Kensington",789
"14181",2020,19,98,300,313,"51.52554222","-0.138231303","Hampstead Road, Euston",613
"14182",2020,19,99,441,456,"51.51457763","-0.158264483","Old Quebec Street, Marylebone",897
"14183",2020,19,100,281,272,"51.49043573","-0.122806861","Albert Embankment, Vauxhall",553
"14184",2020,19,101,253,256,"51.51155322","-0.0929401","Queen Street 1, Bank",509
"14185",2020,19,102,203,196,"51.51340693","-0.076793375","Jewry Street, Aldgate",399
"14186",2020,19,103,159,144,"51.50472376","-0.192538767","Vicarage Gate, Kensington",303
"14187",2020,19,104,209,222,"51.51159481","-0.077121322","Crosswall, Tower",431
"14188",2020,19,105,369,366,"51.51552971","-0.190240716","Westbourne Grove, Bayswater",735
"14189",2020,19,106,105,94,"51.51410514","-0.147301667","Woodstock Street, Mayfair",199
"14190",2020,19,107,200,200,"51.52600832","-0.096317627","Finsbury Leisure Centre, St. Luke's",400
"14191",2020,19,108,199,216,"51.49812559","-0.132102166","Abbey Orchard Street, Westminster",415
"14192",2020,19,109,281,282,"51.51563144","-0.132328837","Soho Square , Soho",563
"14193",2020,19,110,319,313,"51.53304322","-0.172528678","Wellington Road, St. John's Wood",632
"14194",2020,19,111,768,785,"51.5100172","-0.157275636","Park Lane , Hyde Park",1553
"14195",2020,19,112,58,57,"51.51580998","-0.105270275","Stonecutter Street, Holborn",115
"14196",2020,19,113,248,248,"51.49646288","-0.183289032","Gloucester Road (Central), South Kensington",496
"14197",2020,19,114,750,739,"51.52451738","-0.158963647","Park Road (Baker Street), The Regent's Park",1489
"14198",2020,19,115,366,355,"51.51423368","-0.073537654","Braham Street, Aldgate",721
"14199",2020,19,116,258,253,"51.51449962","-0.141423695","Little Argyll Street, West End",511
"14200",2020,19,117,175,164,"51.49288067","-0.114934001","Lollard Street, Vauxhall",339
"14201",2020,19,118,155,165,"51.49582705","-0.13547809","Rochester Row, Westminster",320
"14202",2020,19,119,279,283,"51.52589324","-0.090847761","Bath Street, St. Luke's",562
"14203",2020,19,120,52,50,"51.51573534","-0.093080779","The Guildhall, Guildhall",102
"14204",2020,19,121,128,113,"51.51891348","-0.156166631","Baker Street, Marylebone",241
"14205",2020,19,122,133,137,"51.52111369","-0.078869751","Norton Folgate, Liverpool Street",270
"14206",2020,19,123,121,113,"51.52836014","-0.104724625","St. John Street, Finsbury",234
"14207",2020,19,125,223,229,"51.50069491","-0.094524319","Borough High Street, The Borough",452
"14208",2020,19,126,92,92,"51.51782144","-0.096496865","Museum of London, Barbican",184
"14209",2020,19,127,79,76,"51.51700801","-0.09388536","Wood Street, Guildhall",155
"14210",2020,19,128,278,283,"51.49536226","-0.185296516","Emperor's Gate, South Kensington",561
"14211",2020,19,129,247,245,"51.5118973","-0.137043852","Golden Square, Soho",492
"14212",2020,19,130,822,857,"51.50950627","-0.075459482","Tower Gardens , Tower",1679
"14213",2020,19,131,149,144,"51.53300545","-0.136792671","Eversholt Street , Camden Town",293
"14214",2020,19,132,428,434,"51.52364804","-0.074754872","Bethnal Green Road, Shoreditch",862
"14215",2020,19,133,456,471,NA,NA,NA,927
"14216",2020,19,134,440,428,"51.504904","-0.06797","Wapping High Street, Wapping",868
"14217",2020,19,135,251,251,"51.52326004","-0.104708922","Clerkenwell Green, Clerkenwell",502
"14218",2020,19,136,269,275,"51.51196176","-0.097441687","Queen Victoria Street, St. Paul's",544
"14219",2020,19,138,467,488,"51.51227622","-0.157436972","Green Street, Mayfair",955
"14220",2020,19,139,200,178,"51.49488108","-0.117974901","Lambeth Road, Vauxhall",378
"14221",2020,19,140,112,109,"51.52096262","-0.085634242","Finsbury Square , Moorgate",221
"14222",2020,19,141,125,123,"51.51530805","-0.147203711","Chapel Place, Marylebone",248
"14223",2020,19,142,238,230,"51.49372451","-0.198286569","West Cromwell Road, Earl's Court",468
"14224",2020,19,143,242,245,"51.4968865","-0.161203828","Pont Street, Knightsbridge",487
"14225",2020,19,144,347,344,"51.48894022","-0.111435796","Kennington Cross, Kennington",691
"14226",2020,19,145,185,172,"51.50074359","-0.202759212","Ilchester Place, Kensington",357
"14227",2020,19,146,281,271,"51.48836528","-0.129361842","Vauxhall Bridge , Pimlico",552
"14228",2020,19,148,263,245,"51.49211134","-0.138364847","Tachbrook Street, Victoria",508
"14229",2020,19,149,406,404,"51.48478899","-0.110683213","Kennington Road Post Office, Oval",810
"14230",2020,19,150,189,200,"51.49705603","-0.168917077","Holy Trinity Brompton, Knightsbridge",389
"14231",2020,19,151,274,253,"51.51213691","-0.201554966","Chepstow Villas, Notting Hill",527
"14232",2020,19,152,354,334,"51.49217002","-0.101536865","Hampton Street, Walworth",688
"14233",2020,19,153,1028,1024,"51.511933","-0.174411","Bayswater Road, Hyde Park",2052
"14234",2020,19,154,91,76,"51.50379168","-0.11282408","Waterloo Station 3, Waterloo",167
"14235",2020,19,155,141,151,"51.49586666","-0.191933711","Lexham Gardens, Kensington",292
"14236",2020,19,156,216,224,"51.49443626","-0.092921165","New Kent Road, The Borough",440
"14237",2020,19,157,219,274,"51.50039792","-0.193068385","Wright's Lane, Kensington",493
"14238",2020,19,158,340,337,"51.49085368","-0.196170309","Trebovir Road, Earl's Court",677
"14239",2020,19,159,246,235,"51.51461995","-0.137841333","Great Marlborough Street, Soho",481
"14240",2020,19,160,312,309,"51.50663341","-0.131773845","Waterloo Place, St. James's",621
"14241",2020,19,161,133,123,"51.49234577","-0.141334487","Guildhouse Street, Victoria",256
"14242",2020,19,162,162,161,"51.51760685","-0.121328408","Southampton Place, Holborn",323
"14243",2020,19,163,362,365,"51.4931848","-0.167894973","Sloane Avenue, Knightsbridge",727
"14244",2020,19,164,225,231,"51.515607","-0.183118788","Cleveland Gardens, Bayswater",456
"14245",2020,19,166,453,470,"51.50185512","-0.159237081","Seville Street, Knightsbridge",923
"14246",2020,19,167,183,170,"51.49395092","-0.147624377","Eccleston Place, Victoria",353
"14247",2020,19,168,216,213,"51.50040123","-0.195455928","Argyll Road, Kensington",429
"14248",2020,19,169,548,557,"51.51474612","-0.165164288","Porchester Place, Paddington",1105
"14249",2020,19,170,63,55,"51.52784273","-0.108068155","Hardwick Street, Clerkenwell",118
"14250",2020,19,171,225,225,"51.4916156","-0.186753859","Collingham Gardens, Earl's Court",450
"14251",2020,19,172,249,246,"51.49121192","-0.173715911","Sumner Place, South Kensington",495
"14252",2020,19,173,104,108,"51.50486","-0.113001","Waterloo Road, South Bank",212
"14253",2020,19,174,100,94,"51.512529","-0.115163","Strand, Strand",194
"14254",2020,19,175,47,51,"51.521668","-0.079608554","Worship Street, Shoreditch",98
"14255",2020,19,176,295,292,"51.51791921","-0.188098863","Gloucester Terrace, Bayswater",587
"14256",2020,19,177,177,175,"51.49616092","-0.140947636","Ashley Place, Victoria",352
"14257",2020,19,178,285,276,"51.48985626","-0.141923621","Warwick Square, Pimlico",561
"14258",2020,19,180,283,292,"51.5129118","-0.153645496","North Audley Street, Mayfair",575
"14259",2020,19,181,200,202,"51.49941247","-0.152317537","Belgrave Square, Belgravia",402
"14260",2020,19,182,180,178,"51.52202903","-0.165842551","Bell Street , Marylebone",358
"14261",2020,19,183,521,493,"51.482362","-0.13612398","Riverlight North, Nine Elms",1014
"14262",2020,19,184,242,245,"51.52071513","-0.14521173","Portland Place, Marylebone",487
"14263",2020,19,185,310,308,"51.48805753","-0.140741432","Alderney Street, Pimlico",618
"14264",2020,19,186,248,231,"51.51733558","-0.175810943","South Wharf Road, Paddington",479
"14265",2020,19,187,310,322,"51.49247977","-0.178433004","Queen's Gate (South), South Kensington",632
"14266",2020,19,188,89,91,"51.5165179","-0.164393768","Nutford Place, Marylebone",180
"14267",2020,19,189,195,184,"51.53166681","-0.109914711","Claremont Square, Angel",379
"14268",2020,19,190,316,307,"51.48997562","-0.132845681","Rampayne Street, Pimlico",623
"14269",2020,19,191,738,749,"51.50311799","-0.153520935","Hyde Park Corner, Hyde Park",1487
"14270",2020,19,192,421,427,"51.51251523","-0.133201961","Wardour Street, Soho",848
"14271",2020,19,193,150,133,"51.50581776","-0.100186337","Bankside Mix, Bankside",283
"14272",2020,19,194,911,1078,"51.50462759","-0.091773776","Hop Exchange, The Borough",1989
"14273",2020,19,195,239,230,"51.50724437","-0.106237501","Milroy Walk, South Bank",469
"14274",2020,19,196,85,85,"51.50368837","-0.098497684","Union Street, The Borough",170
"14275",2020,19,197,147,137,"51.50556905","-0.111606696","Stamford Street, South Bank",284
"14276",2020,19,199,311,316,"51.51048489","-0.082989638","Great Tower Street, Monument",627
"14277",2020,19,200,251,260,"51.51492456","-0.066078037","LMU Commercial Road, Whitechapel",511
"14278",2020,19,201,266,260,"51.5225965","-0.161113413","Dorset Square, Marylebone",526
"14279",2020,19,202,242,273,"51.51236389","-0.06954201","Leman Street, Aldgate",515
"14280",2020,19,203,165,166,"51.51821864","-0.100791005","West Smithfield Rotunda, Farringdon",331
"14281",2020,19,204,118,124,"51.52659961","-0.112432615","Margery Street, Clerkenwell",242
"14282",2020,19,206,165,175,"51.518154","-0.062697","New Road 1 , Whitechapel",340
"14283",2020,19,207,212,211,"51.50135267","-0.153194766","Grosvenor Crescent, Belgravia",423
"14284",2020,19,208,90,87,"51.52505151","-0.166304359","Mallory Street, Marylebone",177
"14285",2020,19,209,130,121,"51.49358391","-0.165101392","Denyer Street, Knightsbridge",251
"14286",2020,19,210,189,170,"51.51681444","-0.151926305","Hinde Street, Marylebone",359
"14287",2020,19,211,281,271,"51.49464523","-0.158105512","Cadogan Place, Knightsbridge",552
"14288",2020,19,212,128,116,"51.50658458","-0.199004026","Campden Hill Road, Notting Hill",244
"14289",2020,19,213,1329,1313,"51.50274025","-0.149569201","Wellington Arch, Hyde Park",2642
"14290",2020,19,214,98,65,"51.52683806","-0.130504336","Endsleigh Gardens, Euston",163
"14291",2020,19,215,134,97,"51.51906932","-0.088285377","Moorfields, Moorgate",231
"14292",2020,19,216,345,342,"51.49094565","-0.181190899","Old Brompton Road, South Kensington",687
"14293",2020,19,217,296,279,"51.51615461","-0.082422399","Wormwood Street, Liverpool Street",575
"14294",2020,19,218,313,282,"51.48971651","-0.170194408","St. Luke's Church, Chelsea",595
"14295",2020,19,219,511,517,"51.49016361","-0.19039362","Bramham Gardens, Earl's Court",1028
"14296",2020,19,220,286,275,"51.49066456","-0.166485083","Chelsea Green, Chelsea",561
"14297",2020,19,221,194,197,"51.49481649","-0.13045856","Horseferry Road, Westminster",391
"14298",2020,19,222,577,594,"51.50275704","-0.155349725","Knightsbridge, Hyde Park",1171
"14299",2020,19,223,387,400,"51.49148474","-0.090220911","Rodney Road , Walworth",787
"14300",2020,19,224,1081,1044,"51.51031","-0.18740235","Queensway, Kensington Gardens",2125
"14301",2020,19,225,365,368,"51.50935342","-0.196422","Notting Hill Gate Station, Notting Hill",733
"14302",2020,19,226,154,150,"51.50844614","-0.131961389","Charles II Street, West End",304
"14303",2020,19,227,158,156,"51.52891573","-0.115480888","Great Percy Street, Clerkenwell",314
"14304",2020,19,228,297,295,"51.50742485","-0.134621209","St. James's Square, St. James's",592
"14305",2020,19,229,488,492,"51.50654321","-0.123179697","Whitehall Place, Strand",980
"14306",2020,19,230,130,122,"51.50669284","-0.103137426","Poured Lines, Bankside",252
"14307",2020,19,231,255,252,"51.49396755","-0.17873226","Queen's Gate (Central), South Kensington",507
"14308",2020,19,232,34,28,"51.51501025","-0.112753217","Carey Street, Holborn",62
"14309",2020,19,233,541,552,"51.50777049","-0.130699733","Pall Mall East, West End",1093
"14310",2020,19,234,290,292,"51.53450449","-0.106992706","Liverpool Road (N1 Centre), Angel",582
"14311",2020,19,235,220,205,"51.49571828","-0.110889274","Kennington Road  , Vauxhall",425
"14312",2020,19,236,106,109,"51.51838043","-0.073438925","Fashion Street, Whitechapel",215
"14313",2020,19,237,339,353,"51.5097860151","-0.0681619805156","Dock Street, Wapping",692
"14314",2020,19,238,230,243,"51.5233534","-0.175116099","Frampton Street, Paddington",473
"14315",2020,19,239,337,359,"51.52443845","-0.138019439","Warren Street Station, Euston",696
"14316",2020,19,240,43,43,"51.50545935","-0.10569204","Colombo Street, Southwark",86
"14317",2020,19,242,268,275,"51.52200801","-0.151359288","Beaumont Street, Marylebone",543
"14318",2020,19,243,344,330,"51.49096258","-0.139625122","Gloucester Street, Pimlico",674
"14319",2020,19,244,167,170,"51.51611887","-0.128585022","Earnshaw Street , Covent Garden",337
"14320",2020,19,245,257,221,"51.4853572","-0.142207481","Grosvenor Road, Pimlico",478
"14321",2020,19,246,228,223,"51.52285301","-0.099994052","Berry Street, Clerkenwell",451
"14322",2020,19,247,454,433,"51.530529","-0.167515","St. John's Wood Church, The Regent's Park",887
"14323",2020,19,248,575,583,"51.50645179","-0.170279555","Triangle Car Park, Hyde Park",1158
"14324",2020,19,249,149,138,"51.49859784","-0.096191134","Harper Road, The Borough",287
"14325",2020,19,250,173,165,"51.489932","-0.162727","Royal Avenue 1, Chelsea",338
"14326",2020,19,251,345,356,"51.518908","-0.079249","Brushfield Street, Liverpool Street",701
"14327",2020,19,252,438,493,"51.5046364","-0.116542278","Jubilee Gardens, South Bank",931
"14328",2020,19,253,468,465,"51.53404294","-0.086379717","Shoreditch Park, Hoxton",933
"14329",2020,19,254,122,141,"51.53051587","-0.106408455","Chadwell Street, Angel",263
"14330",2020,19,255,303,301,"51.52557531","-0.179592915","Clifton Road, Maida Vale",604
"14331",2020,19,256,35,39,"51.51362054","-0.116764211","Houghton Street, Strand",74
"14332",2020,19,257,258,259,"51.52248185","-0.154907218","Westminster University, Marylebone",517
"14333",2020,19,259,2,NA,"51.490959","-0.1532331","Bourne Street, Belgravia",NA
"14334",2020,19,260,160,156,"51.5136846","-0.135580879","Broadwick Street, Soho",316
"14335",2020,19,261,142,123,"51.5134891","-0.191351186","Princes Square, Bayswater",265
"14336",2020,19,262,162,171,"51.49874469","-0.103132904","LSBU (Borough Road), Elephant & Castle",333
"14337",2020,19,263,81,69,"51.51422502","-0.080660083","St. Mary Axe, Aldgate",150
"14338",2020,19,264,299,306,"51.52644342","-0.109256828","Tysoe Street, Clerkenwell",605
"14339",2020,19,265,194,200,"51.51595344","-0.169249375","Southwick Street, Paddington",394
"14340",2020,19,266,727,829,"51.50102668","-0.180246101","Queen's Gate (North), Kensington",1556
"14341",2020,19,267,230,226,"51.49206037","-0.132224622","Regency Street, Westminster",456
"14342",2020,19,268,161,143,"51.49320445","-0.144132875","Belgrave Road, Victoria",304
"14343",2020,19,269,262,302,"51.50082346","-0.089740764","Empire Square, The Borough",564
"14344",2020,19,270,513,494,"51.4863434","-0.122492418","Kennington Lane Rail Bridge, Vauxhall",1007
"14345",2020,19,271,183,223,"51.53583617","-0.156285395","London Zoo,  The Regent's Park",406
"14346",2020,19,272,237,252,"51.50144456","-0.110699309","Baylis Road, Waterloo",489
"14347",2020,19,273,172,171,"51.50613324","-0.114686385","Belvedere Road 1, South Bank",343
"14348",2020,19,274,253,282,"51.49671237","-0.20528437","Warwick Road, Olympia",535
"14349",2020,19,275,112,110,"51.52004497","-0.092176447","Barbican Centre, Barbican",222
"14350",2020,19,276,107,104,"51.50930161","-0.084985356","Lower Thames Street, Monument",211
"14351",2020,19,277,273,267,"51.50315739","-0.191496313","Kensington Church Street, Kensington",540
"14352",2020,19,278,864,900,"51.5034938","-0.07962099","Tooley Street, Bermondsey",1764
"14353",2020,19,279,149,128,"51.51862243","-0.176645823","North Wharf Road, Paddington",277
"14354",2020,19,280,241,237,"51.490083","-0.162418","Royal Avenue 2, Chelsea",478
"14355",2020,19,281,223,225,"51.49580589","-0.127575233","Smith Square, Westminster",448
"14356",2020,19,282,331,343,"51.51906446","-0.059642081","Royal London Hospital, Whitechapel",674
"14357",2020,19,283,26,31,"51.51440928","-0.118478757","Kingsway, Covent Garden",57
"14358",2020,19,284,151,171,"51.49914063","-0.112031483","Lambeth North Station, Waterloo",322
"14359",2020,19,286,218,215,"51.5272947","-0.174653609","St. John's Wood Road, St. John's Wood",433
"14360",2020,19,287,40,23,"51.52367314","-0.128377673","Bedford Way, Bloomsbury",63
"14361",2020,19,288,301,313,"51.49236962","-0.147478734","Elizabeth Bridge, Victoria",614
"14362",2020,19,289,73,69,"51.50923022","-0.151296092","South Audley Street, Mayfair",142
"14363",2020,19,290,269,269,"51.518268","-0.17110323","St Mary's Hospital, Paddington",538
"14364",2020,19,291,271,264,"51.48483991","-0.138089062","Claverton Street, Pimlico",535
"14365",2020,19,292,371,373,"51.49888404","-0.165471605","Montpelier Street, Knightsbridge",744
"14366",2020,19,293,143,134,"51.49815779","-0.209494128","Kensington Olympia Station, Olympia",277
"14367",2020,19,294,337,330,"51.488226","-0.135635511","St. George's Square, Pimlico",667
"14368",2020,19,295,134,141,"51.50029631","-0.092762704","Swan Street, The Borough",275
"14369",2020,19,296,279,276,"51.49363156","-0.190603326","Knaresborough Place, Earl's Court",555
"14370",2020,19,297,90,93,"51.49612799","-0.106000855","Geraldine Street, Elephant & Castle",183
"14371",2020,19,298,709,715,"51.50227992","-0.074189225","Curlew Street, Shad Thames",1424
"14372",2020,19,299,105,87,"51.49398524","-0.136928582","Vincent Square, Westminster",192
"14373",2020,19,300,449,447,"51.505014","-0.17306032","Serpentine Car Park, Hyde Park",896
"14374",2020,19,301,248,249,"51.51475963","-0.148105415","Marylebone Lane, Marylebone",497
"14375",2020,19,302,486,504,"51.466907","-0.216573","Putney Pier, Wandsworth",990
"14376",2020,19,303,436,437,"51.50295379","-0.158456089","Albert Gate, Hyde Park",873
"14377",2020,19,306,104,98,"51.51816295","-0.135025698","Rathbone Street, Fitzrovia",202
"14378",2020,19,307,565,563,"51.50990837","-0.187842717","Black Lion Gate, Kensington Gardens",1128
"14379",2020,19,308,239,240,"51.49907558","-0.085666316","Long Lane , Bermondsey",479
"14380",2020,19,309,346,319,"51.50963123","-0.119047563","Embankment (Savoy), Strand",665
"14381",2020,19,310,206,183,"51.4908679","-0.116911864","Black Prince Road, Vauxhall",389
"14382",2020,19,311,200,201,"51.51918144","-0.140485596","Foley Street, Fitzrovia",401
"14383",2020,19,312,405,389,"51.53088935","-0.176770502","Grove End Road, St. John's Wood",794
"14384",2020,19,313,139,132,"51.51734403","-0.138072691","Wells Street, Fitzrovia",271
"14385",2020,19,314,264,292,"51.50088934","-0.083159352","Tyers Gate, Bermondsey",556
"14386",2020,19,315,211,212,"51.52536703","-0.153463612","The Tennis Courts, The Regent's Park",423
"14387",2020,19,316,327,332,NA,NA,NA,659
"14388",2020,19,317,100,105,"51.49679128","-0.093913472","Dickens Square, Borough",205
"14389",2020,19,318,205,205,"51.51004801","-0.138846453","Sackville Street, Mayfair",410
"14390",2020,19,319,168,175,"51.52702563","-0.088542771","Baldwin Street, St. Luke's",343
"14391",2020,19,320,285,285,"51.49357351","-0.139956043","Queen Mother Sports Centre, Victoria",570
"14392",2020,19,321,559,554,"51.49785559","-0.081608045","Bermondsey Street, Bermondsey",1113
"14393",2020,19,322,156,151,"51.526293","-0.073955","Palissy Street, Shoreditch",307
"14394",2020,19,323,41,39,"51.523196","-0.083067","Clifton Street, Shoreditch",80
"14395",2020,19,324,318,295,"51.49652013","-0.101384068","Ontario Street, Elephant & Castle",613
"14396",2020,19,325,51,49,"51.50908747","-0.129697889","St. Martin's Street, West End",100
"14397",2020,19,326,313,327,"51.53266186","-0.099981142","Graham Street, Angel",640
"14398",2020,19,327,57,40,"51.53095","-0.085603","New North Road 1, Hoxton",97
"14399",2020,19,328,79,72,"51.53114","-0.086016","New North Road 2, Hoxton",151
"14400",2020,19,329,891,918,"51.53589283","-0.160854428","Prince Albert Road, The Regent's Park",1809
"14401",2020,19,330,146,147,"51.51641749","-0.179135079","Eastbourne Mews, Paddington",293
"14402",2020,19,331,124,144,"51.52085887","-0.089887855","Bunhill Row, Moorgate",268
"14403",2020,19,332,175,183,"51.49334336","-0.194757949","Nevern Place, Earl's Court",358
"14404",2020,19,333,358,341,"51.50860544","-0.193764092","Palace Gardens Terrace, Notting Hill",699
"14405",2020,19,334,124,118,"51.505044","-0.115851","Concert Hall Approach 1, South Bank",242
"14406",2020,19,335,160,155,"51.51196803","-0.120718759","Tavistock Street, Covent Garden",315
"14407",2020,19,336,138,122,"51.504942","-0.115533","Concert Hall Approach 2, South Bank",260
"14408",2020,19,337,190,173,"51.51108452","-0.197524944","Pembridge Villas, Notting Hill",363
"14409",2020,19,338,239,263,"51.51175646","-0.119643424","Wellington Street , Strand",502
"14410",2020,19,339,115,114,"51.5333196","-0.1117812","Risinghill Street, Angel",229
"14411",2020,19,340,161,165,"51.51444134","-0.087587447","Bank of England Museum, Bank",326
"14412",2020,19,341,359,371,"51.50810309","-0.12602103","Craven Street, Strand",730
"14413",2020,19,343,86,167,"51.53692216","-0.150181444","London Zoo Car Park, The Regent's Park",253
"14414",2020,19,344,126,104,"51.528246","-0.10102611","Goswell Road (City Uni), Finsbury",230
"14415",2020,19,345,447,449,"51.48802358","-0.166878535","Flood Street, Chelsea",896
"14416",2020,19,347,208,204,"51.50013942","-0.113936001","Lower Marsh, Waterloo",412
"14417",2020,19,348,188,207,"51.51217033","-0.150481272","Grosvenor Square, Mayfair",395
"14418",2020,19,349,121,109,"51.51196","-0.142783033","St. George Street, Mayfair",230
"14419",2020,19,350,238,237,"51.5017154373867","-0.1798541843891","Queen's Gate, Kensington Gardens",475
"14420",2020,19,351,239,218,"51.529423","-0.097122","Macclesfield Rd, St Lukes",457
"14421",2020,19,352,174,171,"51.486965","-0.116625","Vauxhall Street, Vauxhall",345
"14422",2020,19,353,101,96,"51.49459148","-0.134234258","Greycoat Street , Westminster",197
"14423",2020,19,354,233,250,"51.506767","-0.123702","Northumberland Avenue, Strand",483
"14424",2020,19,356,408,418,"51.494412","-0.173881","South Kensington Station, South Kensington",826
"14425",2020,19,357,188,175,"51.520994","-0.139016","Howland Street, Fitzrovia",363
"14426",2020,19,358,94,101,"51.516226","-0.124826","High Holborn , Covent Garden",195
"14427",2020,19,359,101,101,"51.49782999","-0.135440826","Butler Place, Westminster",202
"14428",2020,19,360,121,117,"51.49675303","-0.138733562","Howick Place, Westminster",238
"14429",2020,19,361,71,46,"51.50391973","-0.11342629","Waterloo Station 2, Waterloo",117
"14430",2020,19,362,171,164,"51.536264","-0.133952","Royal College Street, Camden Town",335
"14431",2020,19,363,105,96,"51.5291212008901","-0.171185284853","Lord's, St. John's Wood",201
"14432",2020,19,364,119,109,"51.519656","-0.132339","Alfred Place, Bloomsbury",228
"14433",2020,19,365,161,156,"51.530344","-0.100168","City Road, Angel",317
"14434",2020,19,366,90,87,"51.5109192966489","-0.1511263847351","Millennium Hotel, Mayfair",177
"14435",2020,19,367,226,231,"51.5173721","-0.1642075","Harrowby Street, Marylebone",457
"14436",2020,19,368,373,395,"51.50024195","-0.15934065","Harriet Street, Knightsbridge",768
"14437",2020,19,370,88,80,"51.520205","-0.174593","Paddington Green, Paddington",168
"14438",2020,19,371,78,65,"51.49775","-0.10988","King Edward Walk, Waterloo",143
"14439",2020,19,372,22,15,"51.515208","-0.117863","Sardinia Street, Holborn",37
"14440",2020,19,373,128,129,"51.49980661","-0.176415994","Prince Consort Road, Knightsbridge",257
"14441",2020,19,374,154,190,"51.50402794","-0.11386436","Waterloo Station 1, Waterloo",344
"14442",2020,19,375,165,148,"51.50194596","-0.194392952","Kensington Town Hall, Kensington",313
"14443",2020,19,376,342,352,"51.49188409","-0.125674815","Millbank Tower, Pimlico",694
"14444",2020,19,377,122,134,"51.50535447","-0.113656543","Waterloo Bridge, South Bank",256
"14445",2020,19,378,6,15,"51.49559291","-0.179077626","Natural History Museum, South Kensington",21
"14446",2020,19,379,189,189,"51.51431171","-0.200838199","Turquoise Island, Notting Hill",378
"14447",2020,19,380,91,74,"51.50686435","-0.150666888","Stanhope Gate, Mayfair",165
"14448",2020,19,381,183,162,"51.51953043","-0.13577731","Charlotte Street, Fitzrovia",345
"14449",2020,19,382,100,91,"51.50935171","-0.14744969","Farm Street, Mayfair",191
"14450",2020,19,383,237,244,"51.51310333","-0.13121385","Frith Street, Soho",481
"14451",2020,19,384,190,193,"51.496481","-0.192404","Marloes Road, Kensington",383
"14452",2020,19,386,364,365,"51.51352755","-0.130110822","Moor Street, Soho",729
"14453",2020,19,387,392,384,"51.49369988","-0.121394101","Fire Brigade Pier, Vauxhall",776
"14454",2020,19,388,277,272,"51.51070161","-0.121723604","Southampton Street, Strand",549
"14455",2020,19,389,171,178,"51.51013066","-0.155757901","Upper Grosvenor Street, Mayfair",349
"14456",2020,19,390,114,101,"51.521776","-0.068856","Buxton Street 1, Shoreditch",215
"14457",2020,19,392,330,319,"51.49942855","-0.179702476","Imperial College, Knightsbridge",649
"14458",2020,19,393,83,69,"51.51733427","-0.103604248","Snow Hill, Farringdon",152
"14459",2020,19,394,180,185,"51.524826","-0.176268","Aberdeen Place, St. John's Wood",365
"14460",2020,19,395,305,297,"51.492462","-0.159919","Cadogan Gardens, Chelsea",602
"14461",2020,19,396,152,152,"51.51809","-0.163609","Shouldham Street, Marylebone",304
"14462",2020,19,397,428,419,"51.51348","-0.17977","Devonshire Terrace, Bayswater",847
"14463",2020,19,398,300,290,"51.502319","-0.200742","Holland Park, Kensington",590
"14464",2020,19,399,228,221,"51.52261762","-0.071653961","Brick Lane Market, Shoreditch",449
"14465",2020,19,400,129,138,"51.517703","-0.154106","George Street, Marylebone",267
"14466",2020,19,401,300,311,"51.528187","-0.075375","Columbia Road, Shoreditch",611
"14467",2020,19,402,111,104,"51.52289229","-0.171681991","Penfold Street, Marylebone",215
"14468",2020,19,403,239,238,"51.51689296","-0.158249929","George Place Mews, Marylebone",477
"14469",2020,19,404,211,212,"51.50204238","-0.184400221","Palace Gate, Kensington Gardens",423
"14470",2020,19,405,416,430,"51.49418566","-0.18267094","Gloucester Road Station, South Kensington",846
"14471",2020,19,409,379,416,"51.493146","-0.099828","Strata, Elephant & Castle",795
"14472",2020,19,410,247,249,"51.519968","-0.169774","Edgware Road Station, Marylebone",496
"14473",2020,19,411,347,351,"51.49337264","-0.09968067","Walworth Road, Elephant & Castle",698
"14474",2020,19,412,146,139,"51.488105","-0.110121","Cleaver Street, Kennington",285
"14475",2020,19,419,666,672,"51.485821","-0.149004","Chelsea Bridge, Pimlico",1338
"14476",2020,19,420,112,103,"51.504043","-0.105312","Southwark Station 1, Southwark",215
"14477",2020,19,421,70,73,"51.504044","-0.104778","Southwark Station 2, Southwark",143
"14478",2020,19,423,297,292,"51.49456127","-0.15393398","Eaton Square (South), Belgravia",589
"14479",2020,19,424,260,260,"51.490491","-0.149186","Ebury Bridge, Pimlico",520
"14480",2020,19,425,123,119,"51.533379","-0.139159","Harrington Square 2, Camden Town",242
"14481",2020,19,426,238,207,"51.493072","-0.129925","Vincent Street, Pimlico",445
"14482",2020,19,427,301,292,"51.51397065","-0.09294031","Cheapside, Bank",593
"14483",2020,19,428,468,484,"51.499917","-0.174554","Exhibition Road, Knightsbridge",952
"14484",2020,19,430,187,162,"51.48902","-0.17524","South Parade, Chelsea",349
"14485",2020,19,431,131,138,"51.534474","-0.122203","Crinan Street, King's Cross",269
"14486",2020,19,432,244,248,"51.496957","-0.173894","Exhibition Road Museums, South Kensington",492
"14487",2020,19,433,118,108,"51.524564","-0.116279","Wren Street, Holborn",226
"14488",2020,19,435,219,223,"51.488852","-0.105593","Kennington Station, Kennington",442
"14489",2020,19,436,154,149,"51.51824","-0.11655","Red Lion Street, Holborn",303
"14490",2020,19,437,196,210,"51.488124","-0.120903","Vauxhall Walk, Vauxhall",406
"14491",2020,19,439,67,57,"51.5338","-0.118677","Killick Street, King's Cross",124
"14492",2020,19,440,341,353,"51.483145","-0.113134","Kennington Oval, Oval",694
"14493",2020,19,441,171,153,"51.495656","-0.114605","Sail Street, Vauxhall",324
"14494",2020,19,442,164,151,"51.510101","-0.211358","Walmer Road, Avondale",315
"14495",2020,19,443,145,184,"51.515256","-0.058641","Philpot Street, Whitechapel",329
"14496",2020,19,444,176,168,"51.52568","-0.055312","Bethnal Green Garden, Bethnal Green",344
"14497",2020,19,445,149,149,"51.52388","-0.065076","Cheshire Street, Bethnal Green",298
"14498",2020,19,446,208,205,"51.528936","-0.055894","York Hall, Bethnal Green",413
"14499",2020,19,447,102,96,"51.493381","-0.007542","Jubilee Crescent, Cubitt Town",198
"14500",2020,19,448,285,274,"51.50623","-0.02296","Fisherman's Walk West, Canary Wharf",559
"14501",2020,19,449,219,171,"51.511088","-0.057159","Shadwell Station, Shadwell",390
"14502",2020,19,450,187,174,"51.515975","-0.053177","Jubilee Street, Stepney",361
"14503",2020,19,451,200,194,"51.504719","-0.063531","Hermitage Court, Wapping",394
"14504",2020,19,452,310,296,"51.505697","-0.070542","St. Katharine's Way, Tower",606
"14505",2020,19,453,281,279,"51.508447","-0.055167","Garnet Street, Shadwell",560
"14506",2020,19,454,218,219,"51.487679","-0.021582","Napier Avenue, Millwall",437
"14507",2020,19,455,243,241,"51.49447","-0.014409","East Ferry Road, Cubitt Town",484
"14508",2020,19,456,279,334,"51.538071","-0.144664","Parkway, Camden Town",613
"14509",2020,19,458,329,321,"51.504749","-0.057544","Wapping Lane, Wapping",650
"14510",2020,19,459,66,69,"51.535179","-0.03338","Gunmakers Lane, Old Ford",135
"14511",2020,19,460,255,257,"51.516196","-0.029138","Burdett Road, Mile End",512
"14512",2020,19,461,120,116,"51.516","-0.038775","Aston Street, Stepney",236
"14513",2020,19,462,514,556,"51.541603","-0.138853","Bonny Street, Camden Town",1070
"14514",2020,19,463,124,115,"51.534776","-0.071881","Thurtle Road, Haggerston",239
"14515",2020,19,464,93,58,"51.51417","-0.052099","St. Mary & St. Michael Church, Stepney",151
"14516",2020,19,465,253,245,"51.53558","-0.08249","Pitfield Street North,Hoxton",498
"14517",2020,19,466,170,156,"51.534464","-0.076341","Whiston Road, Haggerston",326
"14518",2020,19,467,150,124,"51.523538","-0.030556","Southern Grove, Bow",274
"14519",2020,19,468,72,69,"51.521564","-0.022694","Cantrell Road, Bow",141
"14520",2020,19,469,218,223,"51.513757","-0.020467","Lindfield Street, Poplar",441
"14521",2020,19,470,258,259,"51.530535","-0.025492","Mostyn Grove, Bow",517
"14522",2020,19,471,129,136,"51.533283","-0.028155","Hewison Street, Old Ford",265
"14523",2020,19,472,56,43,"51.529452","-0.027616","Malmesbury Road, Bow",99
"14524",2020,19,473,221,224,"51.496137","-0.019355","Millharbour, Millwall",445
"14525",2020,19,475,270,296,"51.499041","-0.020157","Lightermans Road, Millwall",566
"14526",2020,19,476,182,196,"51.489096","-0.009205","Stebondale Street, Cubitt Town",378
"14527",2020,19,477,164,161,"51.49109","-0.018716","Spindrift Avenue, Millwall",325
"14528",2020,19,478,96,106,"51.521889","-0.04667","Stepney Green Station, Stepney",202
"14529",2020,19,479,253,260,"51.527152","-0.058005","Pott Street, Bethnal Green",513
"14530",2020,19,480,496,508,"51.5128711","-0.0389866","Flamborough Street, Limehouse",1004
"14531",2020,19,481,684,680,"51.487129","-0.009001","Saunders Ness Road, Cubitt Town",1364
"14532",2020,19,483,217,206,"51.51328","-0.047784","Albert Gardens, Stepney",423
"14533",2020,19,484,200,186,"51.528828","-0.013258","Bromley High Street, Bow",386
"14534",2020,19,485,260,259,"51.531127","-0.048017","Old Ford Road, Bethnal Green",519
"14535",2020,19,486,336,304,"51.525645","-0.069543","Granby Street, Shoreditch",640
"14536",2020,19,487,160,152,"51.511811","-0.025626","Canton Street, Poplar",312
"14537",2020,19,488,213,214,"51.506946","-0.058681","Reardon Street, Wapping",427
"14538",2020,19,489,168,177,"51.513074","-0.064094","Christian Street, Whitechapel",345
"14539",2020,19,490,118,105,"51.508622","-0.065006","Pennington Street, Wapping",223
"14540",2020,19,491,178,186,"51.522507","-0.041378","Queen Mary's, Mile End",364
"14541",2020,19,492,298,288,"51.525501","-0.032267204","Maplin Street, Mile End",586
"14542",2020,19,494,39,37,"51.50196","-0.016251","South Quay East, Canary Wharf",76
"14543",2020,19,495,446,443,"51.528169","-0.018703","Bow Church Station, Bow",889
"14544",2020,19,496,250,252,"51.52512","-0.015578","Devons Road, Bow",502
"14545",2020,19,497,173,169,"51.526149","-0.027396845","Merchant Street, Bow",342
"14546",2020,19,498,190,187,"51.527058","-0.025296","Bow Road Station, Bow",377
"14547",2020,19,499,240,245,"51.519265","-0.021345","Furze Green, Bow",485
"14548",2020,19,500,488,480,"51.519806","-0.055731","Ansell House, Stepney",968
"14549",2020,19,501,197,200,"51.522561","-0.054883","Cephas Street, Bethnal Green",397
"14550",2020,19,502,397,416,"51.53341","-0.049591815","Bonner Gate, Victoria Park",813
"14551",2020,19,503,300,299,"51.520893","-0.051394","Cleveland Way, Stepney",599
"14552",2020,19,504,156,155,"51.496454","-0.009506","St. John's Park, Cubitt Town",311
"14553",2020,19,505,158,152,"51.520398","-0.026768","Ackroyd Drive, Bow",310
"14554",2020,19,506,180,187,"51.517475","-0.075855","Bell Lane, Liverpool Street",367
"14555",2020,19,507,111,101,"51.528692","-0.059091","Clarkson Street, Bethnal Green",212
"14556",2020,19,508,134,146,"51.519362","-0.074431","Fournier Street, Whitechapel",280
"14557",2020,19,509,50,35,"51.517842","-0.090075","Fore Street, Guildhall",85
"14558",2020,19,510,566,594,"51.509303","-0.025996","Westferry DLR, Limehouse",1160
"14559",2020,19,511,403,405,"51.511066","-0.053558","Sutton Street, Shadwell",808
"14560",2020,19,512,285,289,"51.532091","-0.06142","Pritchard's Road, Bethnal Green",574
"14561",2020,19,513,229,175,"51.5142228","-0.055656","Watney Market, Stepney",404
"14562",2020,19,514,122,133,"51.516204","-0.155525","Portman Square, Marylebone",255
"14563",2020,19,515,129,116,"51.500088","-0.211316","Russell Gardens, Olympia",245
"14564",2020,19,516,219,211,"51.5112","-0.014438","Chrisp Street Market, Poplar",430
"14565",2020,19,517,223,223,"51.532513","-0.033085","Ford Road, Old Ford",446
"14566",2020,19,518,216,237,"51.528224","-0.037471","Antill Road, Mile End",453
"14567",2020,19,519,78,68,"51.518811","-0.011662","Teviot Street, Poplar",146
"14568",2020,19,520,155,141,"51.526041","-0.047218","Bancroft Road, Bethnal Green",296
"14569",2020,19,521,424,423,"51.534137","-0.037366","Driffield Road, Old Ford",847
"14570",2020,19,522,299,316,"51.525941","-0.036017","Clinton Road, Mile End",615
"14571",2020,19,523,145,132,"51.51549","-0.013475","Langdon Park, Poplar",277
"14572",2020,19,524,278,273,"51.511654","-0.179668","Lancaster Gate , Bayswater",551
"14573",2020,19,526,164,173,"51.503143","-0.008428","Lancaster Drive, Blackwall",337
"14574",2020,19,527,229,248,"51.503802","-0.215808","Hansard Mews, Holland Park",477
"14575",2020,19,528,31,25,"51.507326","-0.145827","Clarges Street, Mayfair",56
"14576",2020,19,529,178,183,"51.486892","-0.170983","Manresa Road, Chelsea",361
"14577",2020,19,530,197,215,"51.508896","-0.012413","Newby Place, Poplar",412
"14578",2020,19,531,345,320,"51.530326","-0.042744","Twig Folly Bridge, Mile End",665
"14579",2020,19,532,355,352,"51.50357","-0.020068","Jubilee Plaza, Canary Wharf",707
"14580",2020,19,533,158,159,"51.528222","-0.069743","Wellington Row, Bethnal Green",317
"14581",2020,19,534,320,304,"51.531864","-0.066035","Goldsmith's Row, Haggerston",624
"14582",2020,19,535,530,538,"51.537349","-0.147154","Gloucester Avenue, Camden Town",1068
"14583",2020,19,536,93,92,"51.53385","-0.06992","Queensbridge Road, Haggerston",185
"14584",2020,19,537,182,179,"51.51793","-0.067937","Old Montague Street, Whitechapel",361
"14585",2020,19,538,250,255,"51.508981","-0.00699","Naval Row, Blackwall",505
"14586",2020,19,540,361,373,"51.528302","-0.144466","Albany Street, The Regent's Park",734
"14587",2020,19,541,576,597,"51.506613","-0.142844","Green Park Station, Mayfair",1173
"14588",2020,19,542,301,291,"51.514115","-0.033828","Salmon Lane, Limehouse",592
"14589",2020,19,543,84,85,"51.509591","-0.204666","Lansdowne Walk, Ladbroke Grove",169
"14590",2020,19,544,116,109,"51.526153","-0.102208","Percival Street, Finsbury",225
"14591",2020,19,545,208,210,"51.539957","-0.145246","Arlington Road, Camden Town",418
"14592",2020,19,546,174,151,"51.517428","-0.107987","New Fetter Lane, Holborn",325
"14593",2020,19,547,583,582,"51.509474","-0.002275","East India DLR, Blackwall",1165
"14594",2020,19,548,81,56,"51.498386","-0.107913","Westminster Bridge Road, Elephant & Castle",137
"14595",2020,19,549,234,218,"51.49605","-0.104193","Gaywood  Street, Elephant & Castle",452
"14596",2020,19,550,142,126,"51.521564","-0.039264","Harford Street, Mile End",268
"14597",2020,19,551,73,67,"51.505772","-0.016460175","Import Dock, Canary Wharf",140
"14598",2020,19,552,214,206,"51.511542","-0.056667","Watney Street, Shadwell",420
"14599",2020,19,553,843,861,"51.535678","-0.062546","Regent's Row , Haggerston",1704
"14600",2020,19,554,133,131,"51.513548","-0.005659","Aberfeldy Street, Poplar",264
"14601",2020,19,556,105,102,"51.502661","-0.021596","Heron Quays DLR, Canary Wharf",207
"14602",2020,19,557,126,120,"51.51601","-0.0985","King Edward Street, St Pauls",246
"14603",2020,19,558,222,222,"51.493978","-0.127554","Page Street, Westminster",444
"14604",2020,19,559,207,204,"51.501391","-0.205991","Abbotsbury Road, Holland Park",411
"14605",2020,19,560,102,91,"51.511624","-0.205921","Ladbroke Grove Central, Ladbroke Grove",193
"14606",2020,19,561,111,106,"51.518369","-0.043371","Rectory Square, Stepney",217
"14607",2020,19,562,101,100,"51.51746","-0.12335","Bury Place, Holborn",201
"14608",2020,19,563,195,216,"51.499286","-0.009152","Preston's Road, Cubitt Town",411
"14609",2020,19,564,773,816,"51.509943","-0.117619","Somerset House, Strand",1589
"14610",2020,19,565,76,75,"51.521905","-0.063386","Selby Street, Whitechapel",151
"14611",2020,19,566,272,303,"51.509158","-0.224103","Westfield Ariel Way, White City",575
"14612",2020,19,568,425,418,"51.51616","-0.18697","Bishop's Bridge Road West, Bayswater",843
"14613",2020,19,569,132,110,"51.53213","-0.08299","Pitfield Street Central, Hoxton",242
"14614",2020,19,570,236,235,"51.503083","-0.017676","Upper Bank Street, Canary Wharf",471
"14615",2020,19,571,109,137,"51.506256","-0.218337","Westfield Southern Terrace ,Shepherd's Bush",246
"14616",2020,19,572,381,382,"51.539099","-0.141728","Greenland Road, Camden Town",763
"14617",2020,19,573,432,452,"51.485587","-0.18119","Limerston Street, West Chelsea",884
"14618",2020,19,574,307,307,"51.53356","-0.09315","Eagle Wharf Road, Hoxton",614
"14619",2020,19,576,201,201,"51.497304","-0.022793","Alpha Grove, Millwall",402
"14620",2020,19,577,277,278,"51.528869","-0.047548","Globe Town Market, Bethnal Green",555
"14621",2020,19,578,96,82,"51.527607","-0.057133","Hollybush Gardens, Bethnal Green",178
"14622",2020,19,579,515,555,"51.511246","-0.093051","Queen Street 2, Bank",1070
"14623",2020,19,580,375,357,"51.48692917","-0.102996299","Doddington Grove, Kennington",732
"14624",2020,19,581,238,236,"51.519167","-0.147983","New Cavendish Street, Marylebone",474
"14625",2020,19,583,343,364,"51.497622","-0.125978","Abingdon Green, Westminster",707
"14626",2020,19,584,261,252,"51.51244","-0.19096","Ilchester Gardens, Bayswater",513
"14627",2020,19,586,143,146,"51.490645","-0.014582","Mudchute DLR, Cubitt Town",289
"14628",2020,19,587,346,339,"51.50964","-0.08497","Monument Street, Monument",685
"14629",2020,19,588,137,116,"51.52959","-0.0801","Hoxton Street, Hoxton",253
"14630",2020,19,589,470,491,"51.487196","-0.179369","Drayton Gardens, West Chelsea",961
"14631",2020,19,590,166,145,"51.53256","-0.16862","Greenberry Street, St.John's Wood",311
"14632",2020,19,592,166,146,"51.5171","-0.18377","Bishop's Bridge Road East, Bayswater",312
"14633",2020,19,593,119,112,"51.531066","-0.11934","Northdown Street, King's Cross",231
"14634",2020,19,594,61,53,"51.513875","-0.117774","Kingsway Southbound, Strand",114
"14635",2020,19,595,239,234,"51.493267","-0.21985","Hammersmith Road, Hammersmith",473
"14636",2020,19,596,392,387,"51.472817","-0.199783","Parson's Green , Parson's Green",779
"14637",2020,19,597,214,223,"51.473471","-0.20782","Fulham Park Road, Fulham",437
"14638",2020,19,598,284,306,"51.494499","-0.228188","Southerton Road, Hammersmith",590
"14639",2020,19,599,171,177,"51.485743","-0.223616","Manbre Road, Hammersmith",348
"14640",2020,19,600,384,382,"51.481747","-0.124642","South Lambeth Road, Vauxhall",766
"14641",2020,19,601,327,320,"51.514767","-0.225787","BBC White City, White City",647
"14642",2020,19,602,293,290,"51.472993","-0.133972","Union Grove, Wandsworth Road",583
"14643",2020,19,603,340,355,"51.477839","-0.116493","Caldwell Street, Stockwell",695
"14644",2020,19,604,95,100,"51.538792","-0.138535","St Martins Close, Camden Town",195
"14645",2020,19,605,190,190,"51.520331","-0.163667","Seymour Place, Marylebone",380
"14646",2020,19,606,120,108,"51.504199","-0.210941","Addison Road, Holland Park",228
"14647",2020,19,607,324,329,"51.468814","-0.210279","Putney Bridge Station, Fulham",653
"14648",2020,19,608,51,34,"51.491093","-0.216493","Colet Gardens, Hammersmith",85
"14649",2020,19,609,205,206,"51.46512358","-0.157788279","Sugden Road, Clapham",411
"14650",2020,19,610,470,473,"51.48256792","-0.172078187","Danvers Street, West Chelsea",943
"14651",2020,19,611,247,237,"51.50646524","-0.208486599","Princedale Road , Holland Park",484
"14652",2020,19,612,436,431,"51.46925984","-0.141812513","Wandsworth Rd, Isley Court, Wandsworth Road",867
"14653",2020,19,613,356,364,"51.50403821","-0.217400093","Woodstock Grove, Shepherd's Bush",720
"14654",2020,19,614,178,179,"51.47817208","-0.144690541","Bradmead, Battersea Park",357
"14655",2020,19,615,299,292,"51.4768851","-0.215895601","Finlay Street, Fulham",591
"14656",2020,19,616,224,222,"51.48102131","-0.209973497","Aintree Street, Fulham",446
"14657",2020,19,617,121,129,"51.47107905","-0.207842908","Elysium Place, Fulham",250
"14658",2020,19,618,263,283,"51.47625965","-0.193254007","Eel Brook Common, Walham Green",546
"14659",2020,19,619,194,211,"51.4737636","-0.197010096","Irene Road, Parsons Green",405
"14660",2020,19,620,291,300,"51.47518024","-0.167160736","Surrey Lane, Battersea",591
"14661",2020,19,621,301,309,"51.46086446","-0.187427294","Wandsworth Town Station, Wandsworth",610
"14662",2020,19,622,329,324,"51.50748124","-0.205535908","Lansdowne Road, Ladbroke Grove",653
"14663",2020,19,623,131,125,"51.46193072","-0.180791784","Nantes Close, Wandsworth",256
"14664",2020,19,624,312,326,"51.4729184","-0.132102704","Courland Grove, Wandsworth Road",638
"14665",2020,19,625,1178,1191,"51.47761941","-0.149551631","Queen's Circus, Battersea Park",2369
"14666",2020,19,626,321,330,"51.48438657","-0.20481514","Normand Park, West Kensington",651
"14667",2020,19,627,143,141,"51.4687905","-0.158230901","Holden Street, Battersea",284
"14668",2020,19,628,280,275,"51.46881971","-0.184318843","William Morris Way, Sands End",555
"14669",2020,19,629,137,131,"51.45995384","-0.190184054","Morie Street, Wandsworth",268
"14670",2020,19,630,238,240,"51.47073264","-0.126994068","Clarence Walk, Stockwell",478
"14671",2020,19,631,245,234,"51.4795017","-0.141770709","Battersea Park Road, Nine Elms",479
"14672",2020,19,632,153,158,"51.47053858","-0.163041605","Sheepcote Lane, Battersea",311
"14673",2020,19,633,420,406,"51.48959104","-0.209378594","Vereker Road, West Kensington",826
"14674",2020,19,634,179,170,"51.49434708","-0.215804559","Brook Green South, Brook Green",349
"14675",2020,19,635,261,259,"51.48606206","-0.214428378","Greyhound Road, Hammersmith",520
"14676",2020,19,636,174,152,"51.46706414","-0.193502076","South Park, Sands End",326
"14677",2020,19,637,371,365,"51.45787019","-0.174691623","Spencer Park, Wandsworth Common",736
"14678",2020,19,638,338,357,"51.46663393","-0.169821175","Falcon Road, Clapham Junction",695
"14679",2020,19,639,216,228,"51.48357068","-0.202038682","Coomer Place, West Kensington",444
"14680",2020,19,640,295,300,"51.47286577","-0.148059277","Silverthorne Road, Battersea",595
"14681",2020,19,641,227,222,"51.49824168","-0.117495865","Archbishop's Park, Waterloo",449
"14682",2020,19,642,122,149,"51.46916161","-0.174485792","Fawcett Close, Battersea",271
"14683",2020,19,643,233,234,"51.5190427","-0.204764421","All Saints' Road, Portobello",467
"14684",2020,19,644,203,212,"51.48373225","-0.223852256","Rainville Road, Hammersmith",415
"14685",2020,19,645,154,140,"51.50173215","-0.100292412","Great Suffolk Street, The Borough",294
"14686",2020,19,646,409,417,"51.49886563","-0.137424571","Buckingham Gate, Westminster",826
"14687",2020,19,647,288,292,"51.50035306","-0.217515071","Richmond Way, Shepherd's Bush",580
"14688",2020,19,648,163,154,"51.46904022","-0.19627483","Peterborough Road, Sands End",317
"14689",2020,19,649,296,284,"51.48180515","-0.18027465","World's End Place, West Chelsea",580
"14690",2020,19,650,336,324,"51.51687069","-0.213872396","St. Mark's Road, North Kensington",660
"14691",2020,19,651,217,205,"51.48089844","-0.183853573","Thorndike Close, West Chelsea",422
"14692",2020,19,652,70,62,"51.51148696","-0.218190203","Evesham Street, Avondale",132
"14693",2020,19,653,264,263,"51.47084722","-0.17070367","Simpson Street, Clapham Junction",527
"14694",2020,19,654,277,267,"51.48267821","-0.117661574","Ashmole Estate, Oval",544
"14695",2020,19,655,183,179,"51.48294452","-0.219346128","Crabtree Lane, Fulham",362
"14696",2020,19,656,98,81,"51.46841875","-0.199135704","Broomhouse Lane, Parsons Green",179
"14697",2020,19,657,275,282,"51.4996806","-0.221791552","Blythe Road West, Shepherd's Bush",557
"14698",2020,19,658,1002,1027,"51.47729232","-0.16478637","Ethelburga Estate, Battersea Park",2029
"14699",2020,19,659,235,221,"51.511934","-0.10307894","Blackfriars Station, St. Paul's",456
"14700",2020,19,660,193,200,"51.49087074","-0.206029743","West Kensington Station, West Kensington",393
"14701",2020,19,661,486,509,"51.51632095","-0.202608612","All Saints Church, Portobello",995
"14702",2020,19,662,431,423,"51.48498496","-0.167919869","Phene Street, Chelsea",854
"14703",2020,19,663,160,147,"51.51323001","-0.211593602","Clarendon Road, Avondale",307
"14704",2020,19,664,355,357,"51.474376","-0.155442787","Austin Road, Battersea Park",712
"14705",2020,19,665,277,289,"51.46108367","-0.191722864","Smugglers Way, Wandsworth",566
"14706",2020,19,666,367,329,"51.49610093","-0.208158259","Olympia Way, Olympia",696
"14707",2020,19,667,326,349,"51.5015946","-0.222293381","Shepherd's Bush Road North, Shepherd's Bush",675
"14708",2020,19,668,656,672,"51.49422354","-0.236769936","Ravenscourt Park Station, Hammersmith",1328
"14709",2020,19,669,201,223,"51.47614939","-0.1232585","Teversham Lane, Stockwell",424
"14710",2020,19,670,277,283,"51.46718562","-0.152248582","Ashley Crescent, Battersea",560
"14711",2020,19,671,272,258,"51.475089","-0.201968","Parsons Green Station, Parsons Green",530
"14712",2020,19,673,421,422,"51.46517078","-0.18038939","Hibbert Street, Battersea",843
"14713",2020,19,674,216,197,"51.53546778","-0.11619105","Carnegie Street, King's Cross",413
"14714",2020,19,675,244,250,"51.46348914","-0.182126248","Usk Road, Clapham Junction",494
"14715",2020,19,676,299,312,"51.47787084","-0.126874471","Hartington Road, Stockwell",611
"14716",2020,19,677,182,179,"51.46866929","-0.146544642","Heath Road, Battersea",361
"14717",2020,19,678,71,101,"51.46231278","-0.211468596","Esmond Street, Putney",172
"14718",2020,19,679,145,163,"51.47453545","-0.170210533","Orbel Street, Battersea",308
"14719",2020,19,680,176,188,"51.47768469","-0.170329317","Westbridge Road, Battersea",364
"14720",2020,19,681,294,306,"51.47303687","-0.214749808","Bishop's Avenue, Fulham",600
"14721",2020,19,682,519,524,"51.48810829","-0.22660621","Crisp Road, Hammersmith",1043
"14722",2020,19,683,238,261,"51.46506424","-0.163750945","Dorothy Road, Clapham Junction",499
"14723",2020,19,684,442,453,"51.45475251","-0.195197203","Neville Gill Close, Wandsworth",895
"14724",2020,19,685,239,226,"51.46067005","-0.198735357","Osiers Road, Wandsworth",465
"14725",2020,19,686,203,199,"51.48814438","-0.222456468","Beryl Road, Hammersmith",402
"14726",2020,19,687,221,216,"51.49760804","-0.21145598","Maclise Road, Olympia",437
"14727",2020,19,688,212,226,"51.46095151","-0.20066766","Northfields, Wandsworth",438
"14728",2020,19,689,148,140,"51.45922541","-0.180884959","Spanish Road, Clapham Junction",288
"14729",2020,19,690,150,143,"51.47047503","-0.152130083","Stanley Grove, Battersea",293
"14730",2020,19,691,425,422,"51.47946386","-0.195777222","Erin Close, Walham Green",847
"14731",2020,19,692,293,303,"51.54211855","-0.028941601","Cadogan Close, Victoria Park",596
"14732",2020,19,693,225,228,"51.464786","-0.215618902","Felsham Road, Putney",453
"14733",2020,19,694,416,423,"51.46071722","-0.216526155","Putney Rail Station, Putney",839
"14734",2020,19,695,721,697,"51.53638435","-0.102757578","Islington Green, Angel",1418
"14735",2020,19,696,155,154,"51.48728535","-0.217995921","Charing Cross Hospital, Hammersmith",309
"14736",2020,19,697,241,232,"51.53639219","-0.112721065","Charlotte Terrace, Angel",473
"14737",2020,19,698,355,325,"51.53908372","-0.070329419","Shoreditch Court, Haggerston",680
"14738",2020,19,699,180,170,"51.5366541","-0.07023031","Belford House, Haggerston",350
"14739",2020,19,700,287,291,"51.47696496","-0.174347066","Battersea Church Road, Battersea",578
"14740",2020,19,701,404,423,"51.47287627","-0.176267008","Vicarage Crescent, Battersea",827
"14741",2020,19,702,195,185,"51.52868155","-0.065550321","Durant Street, Bethnal Green",380
"14742",2020,19,703,155,159,"51.51505991","-0.10534448","St. Bride Street, Holborn",314
"14743",2020,19,704,165,158,"51.45682071","-0.202802098","Mexfield Road, East Putney",323
"14744",2020,19,705,222,216,NA,NA,NA,438
"14745",2020,19,706,238,243,"51.50215353","-0.083632928","Snowsfields, London Bridge",481
"14746",2020,19,707,208,200,"51.49021762","-0.215087092","Barons Court Station, West Kensington",408
"14747",2020,19,708,242,257,"51.46161068","-0.21614583","Disraeli Road, Putney",499
"14748",2020,19,709,170,182,"51.46321128","-0.215550761","Montserrat Road , Putney",352
"14749",2020,19,710,770,773,"51.47439218","-0.163347594","Albert Bridge Road, Battersea Park",1543
"14750",2020,19,711,185,178,"51.48335692","-0.216305546","Everington Street, Fulham",363
"14751",2020,19,712,292,277,"51.51854104","-0.034903714","Mile End Stadium, Mile End",569
"14752",2020,19,713,360,343,"51.54100708","-0.14326094","Hawley Crescent, Camden Town",703
"14753",2020,19,714,131,104,"51.47311696","-0.137235175","Stewart's Road, Wandsworth Road",235
"14754",2020,19,715,100,85,"51.51563007","-0.049067243","Aylward Street, Stepney",185
"14755",2020,19,716,214,195,"51.51542791","-0.02356501","Stainsby Road , Poplar",409
"14756",2020,19,717,537,541,"51.53658514","-0.075885686","Dunston Road , Haggerston",1078
"14757",2020,19,718,255,309,"51.53571683","-0.060291813","Ada Street, Hackney Central",564
"14758",2020,19,719,542,551,"51.53642464","-0.054162264","Victoria Park Road, Hackney Central",1093
"14759",2020,19,720,190,188,"51.48724429","-0.205279052","Star Road, West Kensington",378
"14760",2020,19,721,223,225,"51.53603947","-0.026262677","Wendon Street, Old Ford",448
"14761",2020,19,722,143,126,"51.52458353","-0.058631453","Finnis Street, Bethnal Green",269
"14762",2020,19,723,462,463,"51.46822047","-0.190346493","Stephendale Road, Sands End",925
"14763",2020,19,724,164,149,"51.45799126","-0.184806157","Alma Road, Wandsworth",313
"14764",2020,19,725,385,375,"51.491327","-0.096518684","Walworth Square, Walworth",760
"14765",2020,19,726,280,293,"51.47505096","-0.150908371","Alfreda Street, Battersea Park",573
"14766",2020,19,727,359,363,"51.47569809","-0.20587627","Chesilton Road, Fulham",722
"14767",2020,19,728,209,203,"51.46199911","-0.206240805","Putney Bridge Road, East Putney",412
"14768",2020,19,729,327,322,"51.47893931","-0.208485293","St. Peter's Terrace, Fulham",649
"14769",2020,19,730,439,438,"51.49208492","-0.229116862","Bridge Avenue, Hammersmith",877
"14770",2020,19,731,137,149,"51.47727637","-0.189210466","Michael Road, Walham Green",286
"14771",2020,19,732,610,626,"51.50630441","-0.087262995","Duke Street Hill, London Bridge",1236
"14772",2020,19,733,192,196,"51.50542628","-0.150817316","Park Lane, Mayfair",388
"14773",2020,19,734,230,236,"51.46230566","-0.175407201","Plough Terrace, Clapham Junction",466
"14774",2020,19,735,126,138,"51.46489445","-0.17302926","Grant Road East, Clapham Junction",264
"14775",2020,19,736,170,160,"51.50659035","-0.216104479","Queensdale Road, Shepherd's Bush",330
"14776",2020,19,737,507,517,"51.47993289","-0.19411695","Fulham Broadway, Walham Green",1024
"14777",2020,19,738,206,227,"51.47514228","-0.187278987","Imperial Road, Sands End",433
"14778",2020,19,739,317,329,"51.48176572","-0.185273723","Hortensia Road, West Brompton",646
"14779",2020,19,740,93,91,"51.51092871","-0.214594781","Sirdar Road, Avondale",184
"14780",2020,19,741,95,95,"51.5129814","-0.219486603","Freston Road, Avondale",190
"14781",2020,19,742,332,328,"51.51510818","-0.208565479","Blenheim Crescent, Ladbroke Grove",660
"14782",2020,19,743,156,169,"51.46079243","-0.212607684","Oxford Road, Putney",325
"14783",2020,19,744,144,149,"51.46745485","-0.172293499","Ingrave Street, Clapham Junction",293
"14784",2020,19,745,151,133,"51.47816972","-0.18243547","Upcerne Road, West Chelsea",284
"14785",2020,19,746,307,291,"51.4795738","-0.17903854","Lots Road, West Chelsea",598
"14786",2020,19,747,241,239,"51.48796408","-0.161765173","Ormonde Gate, Chelsea",480
"14787",2020,19,748,274,274,"51.53727795","-0.079201849","Hertford Road, De Beauvoir Town",548
"14788",2020,19,749,507,504,"51.53932857","-0.074284675","Haggerston Road, Haggerston",1011
"14789",2020,19,750,98,125,"51.4710956","-0.157850096","Culvert Road, Battersea",223
"14790",2020,19,751,58,43,"51.51612862","-0.120909408","Newton Street, Covent Garden",101
"14791",2020,19,754,77,66,"51.5129006","-0.214762686","Grenfell Road, Avondale",143
"14792",2020,19,755,351,376,"51.48512191","-0.174971902","The Vale, Chelsea",727
"14793",2020,19,756,162,171,"51.47515398","-0.159169801","Prince of Wales Drive, Battersea Park",333
"14794",2020,19,757,447,441,"51.48795853","-0.187404506","Harcourt Terrace, West Brompton",888
"14795",2020,19,758,355,347,"51.51787005","-0.201005397","Westbourne Park Road, Portobello",702
"14796",2020,19,759,64,68,"51.52456169","-0.165668686","Broadley Terrace, Marylebone",132
"14797",2020,19,760,108,89,"51.52526975","-0.163795009","Rossmore Road, Marylebone",197
"14798",2020,19,761,168,156,"51.48321729","-0.211860644","Humbolt Road, Fulham",324
"14799",2020,19,762,979,1019,"51.50070305","-0.129698963","Storey's Gate, Westminster",1998
"14800",2020,19,763,256,254,"51.52059714","-0.032566533","Mile End Park Leisure Centre, Mile End",510
"14801",2020,19,764,329,361,"51.46239255","-0.16829214","St. John's Road, Clapham Junction",690
"14802",2020,19,765,155,162,"51.46760141","-0.20682737","Ranelagh Gardens, Fulham",317
"14803",2020,19,766,329,339,"51.45752945","-0.192165613","Ram Street, Wandsworth",668
"14804",2020,19,767,126,116,"51.45705988","-0.200806304","Santos Road, Wandsworth",242
"14805",2020,19,768,1022,1045,"51.46134382","-0.159322467","Clapham Common North Side, Clapham Common",2067
"14806",2020,19,769,121,132,"51.473611","-0.191803","Sandilands Road, Walham Green",253
"14807",2020,19,770,237,229,"51.491026","-0.209121","Gwendwr Road, West Kensington",466
"14808",2020,19,771,99,94,"51.509224","-0.216016","Rifle Place, Avondale",193
"14809",2020,19,772,584,616,"51.47250956","-0.122831913","Binfield Road, Stockwell",1200
"14810",2020,19,773,181,183,"51.511891","-0.107349","Tallis Street, Temple",364
"14811",2020,19,774,133,139,"51.470131","-0.20464","Hurlingham Park, Parsons Green",272
"14812",2020,19,775,210,225,"51.496664","-0.223868","Little Brook Green, Brook Green",435
"14813",2020,19,776,378,380,"51.460333","-0.167029","Abyssinia Close, Clapham Junction",758
"14814",2020,19,777,172,165,"51.4619230679","-0.165297856693","Limburg Road, Clapham Junction",337
"14815",2020,19,779,82,67,"51.514449","-0.077178979","Houndsditch, Aldgate",149
"14816",2020,19,780,451,441,"51.474665","-0.18316517","Imperial Wharf Station, Sands End",892
"14817",2020,19,781,102,99,"51.495898","-0.173009","Victoria & Albert Museum, South Kensington",201
"14818",2020,19,782,377,373,"51.483911","-0.19760944","Halford Road, West Kensington",750
"14819",2020,19,783,236,227,"51.5403115","-0.021630359","Monier Road, Hackney Wick",463
"14820",2020,19,784,504,513,"51.546326","-0.00993526","East Village, Queen Elizabeth Olympic Park",1017
"14821",2020,19,785,887,930,"51.54094","-0.010510565","Aquatic Centre, Queen Elizabeth Olympic Park",1817
"14822",2020,19,786,801,832,"51.549369","-0.015717614","Lee Valley VeloPark, Queen Elizabeth Olympic Park",1633
"14823",2020,19,787,839,845,"51.546805","-0.01469126","Timber Lodge, Queen Elizabeth Olympic Park",1684
"14824",2020,19,789,937,933,"51.538718","-0.011889482","Podium, Queen Elizabeth Olympic Park",1870
"14825",2020,19,790,321,322,"51.541793","-0.00481","Stratford Station, Stratford",643
"14826",2020,19,792,201,208,"51.505461","-0.10454093","Blackfriars Road, Southwark",409
"14827",2020,19,793,138,126,"51.528279","-0.11955857","Cromer Street, Bloomsbury",264
"14828",2020,19,795,45,46,"51.527068","-0.13186102","Euston Square Gardens, Euston",91
"14829",2020,19,796,99,87,"51.524","-0.12640984","Coram Street, Bloomsbury",186
"14830",2020,19,797,106,100,"51.5293","-0.12827903","Ossulston Street, Somers Town",206
"14831",2020,19,798,110,103,"51.5301998755","-0.122299440803","Birkenhead Street, King's Cross",213
"14832",2020,19,799,81,79,"51.4976984561","-0.137598896295","Kings Gate House, Westminster",160
"14833",2020,19,801,169,146,"51.5052241745","-0.0980318118664","Lavington Street, Bankside",315
"14834",2020,19,802,446,437,"51.4765900593","-0.118256789081","Albert Square, Stockwell",883
"14835",2020,19,803,154,153,"51.5054099403","-0.0983410884509","Southwark Street, Bankside",307
"14836",2020,19,804,333,333,"51.5346677396","-0.125078652873","Good's Way, King's Cross",666
"14837",2020,19,806,224,219,"51.5372405623","-0.124807385707","Handyside Street, King's Cross",443
"14838",2020,19,807,408,422,"51.5212","-0.20888818","Bevington Road West, North Kensington",830
"14839",2020,19,809,108,92,"51.5162778834","-0.118272991635","Lincoln's Inn Fields, Holborn",200
"14840",2020,19,810,131,142,"51.5067252868","-0.0988072461627","Tate Modern, Bankside",273
"14841",2020,19,811,651,645,"51.5057030357","-0.0277727426235","Westferry Circus, Canary Wharf",1296
"14842",2020,19,812,407,414,"51.5487311915","-0.0226065549321","Here East North, Queen Elizabeth Olympic Park",821
"14843",2020,19,813,85,130,"51.4878074485","-0.122759625866","New Spring Gardens Walk, Vauxhall",215
"14844",2020,19,814,363,377,"51.4714330677","-0.123670735702","Clapham Road, Lingham Street, Stockwell",740
"14845",2020,19,815,484,487,"51.5000891978","-0.116628700672","Lambeth Palace Road, Waterloo",971
"14846",2020,19,816,157,173,"51.5465327935","-0.0205975904647","Here East South, Queen Elizabeth Olympic Park",330
"14847",2020,19,817,455,454,"51.4813354746","-0.138212295869","Riverlight South, Nine Elms",909
"14848",2020,19,818,1001,1011,"51.501513","-0.12382322","Westminster Pier, Westminster",2012
"14849",2020,19,819,195,193,"51.50621","-0.114842","Belvedere Road 2, South Bank",388
"14850",2020,19,820,199,200,"51.492807","-0.091938","Victory Place, Walworth",399
"14851",2020,19,821,744,770,"51.4835074867","-0.147714557371","Battersea Power Station, Battersea Park",1514
"14852",2020,19,826,231,228,"51.496863","-0.1429434","Allington Street, Victoria",459
"14853",2020,19,827,448,454,"51.479601","-0.11147178","Cranmer Road, Stockwell",902
"14854",2020,19,828,354,354,"51.473874","-0.11258096","Normandy Road, Stockwell",708
"14855",2020,19,829,177,191,"51.469217","-0.11268674","Wynne Road, Stockwell",368
"14856",2020,19,830,279,246,"51.469202","-0.11902256","Sidney Road, Stockwell",525
"14857",2020,19,831,306,354,"51.466232","-0.11317995","St John's Crescent, Brixton",660
"14858",2020,19,832,549,554,"51.464019","-0.11578197","Ferndale Road, Brixton",1103
"14859",2020,19,833,855,865,"51.460232","-0.11537509","Saltoun Road, Brixton",1720
"14860",2020,19,834,581,613,"51.477966","-0.14785703","Gas Holders, Battersea Park",1194
"14861",2020,19,835,147,156,"51.516785","-0.10494775","Farringdon Street, Holborn",303
"14862",2020,19,836,246,239,"51.541596","-0.12544145","York Way, Kings Cross",485
"14863",2020,19,838,66,57,"51.518093","-0.0914017","Fore Street Avenue, Guildhall",123
"14864",2020,19,839,244,251,"51.508033","-0.10682363","Sea Containers, South Bank",495
"14865",2020,20,1,146,156,"51.52916347","-0.109970527","River Street , Clerkenwell",302
"14866",2020,20,2,323,373,"51.49960695","-0.197574246","Phillimore Gardens, Kensington",696
"14867",2020,20,3,56,55,"51.52128377","-0.084605692","Christopher Street, Liverpool Street",111
"14868",2020,20,4,75,69,"51.53005939","-0.120973687","St. Chad's Street, King's Cross",144
"14869",2020,20,5,269,265,"51.49313","-0.156876","Sedding Street, Sloane Square",534
"14870",2020,20,6,188,183,"51.51811784","-0.144228881","Broadcasting House, Marylebone",371
"14871",2020,20,7,223,220,"51.53430039","-0.1680743","Charlbert Street, St. John's Wood",443
"14872",2020,20,8,617,641,"51.529857","-0.18348604","Maida Vale, Maida Vale",1258
"14873",2020,20,9,192,200,"51.5073853","-0.096440751","New Globe Walk, Bankside",392
"14874",2020,20,10,173,168,"51.50597426","-0.092754157","Park Street, Bankside",341
"14875",2020,20,11,188,175,"51.52395143","-0.122502346","Brunswick Square, Bloomsbury",363
"14876",2020,20,12,109,110,"51.52168078","-0.130431727","Malet Street, Bloomsbury",219
"14877",2020,20,13,82,82,"51.51991453","-0.136039674","Scala Street, Fitzrovia",164
"14878",2020,20,14,409,361,"51.52994371","-0.123616824","Belgrove Street , King's Cross",770
"14879",2020,20,15,133,125,"51.51772703","-0.127854211","Great Russell Street, Bloomsbury",258
"14880",2020,20,16,159,159,"51.52635795","-0.125979294","Cartwright Gardens , Bloomsbury",318
"14881",2020,20,17,259,257,"51.5216612","-0.109006325","Hatton Wall, Holborn",516
"14882",2020,20,18,265,252,"51.51477076","-0.12221963","Drury Lane, Covent Garden",517
"14883",2020,20,19,70,46,"51.52505093","-0.131161087","Taviton Street, Bloomsbury",116
"14884",2020,20,20,36,32,"51.527326","-0.13605286","Drummond Street , Euston",68
"14885",2020,20,21,72,68,"51.53007835","-0.13884627","Hampstead Road (Cartmel), Euston",140
"14886",2020,20,22,253,283,"51.5222641","-0.114079481","Northington Street , Holborn",536
"14887",2020,20,23,80,84,"51.51943538","-0.119123345","Red Lion Square, Holborn",164
"14888",2020,20,24,153,132,"51.51908011","-0.124678402","British Museum, Bloomsbury",285
"14889",2020,20,25,116,114,"51.5288338","-0.132250369","Doric Way , Somers Town",230
"14890",2020,20,26,145,140,"51.52728093","-0.11829517","Ampton Street , Clerkenwell",285
"14891",2020,20,27,78,79,"51.51382102","-0.107927706","Bouverie Street, Temple",157
"14892",2020,20,28,389,405,"51.52351808","-0.143613641","Bolsover Street, Fitzrovia",794
"14893",2020,20,29,269,269,"51.513735","-0.193487","Hereford Road, Bayswater",538
"14894",2020,20,30,259,251,"51.52915444","-0.093421615","Windsor Terrace, Hoxton",510
"14895",2020,20,31,211,219,"51.52953709","-0.083353323","Fanshaw Street, Hoxton",430
"14896",2020,20,32,221,200,"51.52469624","-0.084439283","Leonard Circus , Shoreditch",421
"14897",2020,20,33,168,174,"51.5156","-0.070056","Central House, Aldgate",342
"14898",2020,20,34,137,146,"51.5341235","-0.129386874","Pancras Road, King's Cross",283
"14899",2020,20,36,525,503,"51.50173726","-0.184980612","De Vere Gardens, Kensington",1028
"14900",2020,20,37,271,276,"51.49159394","-0.192369256","Penywern Road, Earl's Court",547
"14901",2020,20,38,178,186,"51.4973875","-0.197245586","Abingdon Villas, Kensington",364
"14902",2020,20,39,367,398,"51.5263778","-0.078130921","Shoreditch High Street, Shoreditch",765
"14903",2020,20,40,159,166,"51.52127071","-0.0755789","Commercial Street, Shoreditch",325
"14904",2020,20,41,40,36,"51.520955","-0.083493552","Pindar Street, Liverpool Street",76
"14905",2020,20,42,3,NA,"51.53099181","-0.093903825","Wenlock Road , Hoxton",NA
"14906",2020,20,43,299,290,"51.52026","-0.157183945","Crawford Street, Marylebone",589
"14907",2020,20,44,112,112,"51.51073687","-0.144165239","Bruton Street, Mayfair",224
"14908",2020,20,45,111,91,"51.522511","-0.162298","Boston Place, Marylebone",202
"14909",2020,20,46,135,116,"51.507131","-0.06691","Nesham Street, Wapping",251
"14910",2020,20,47,573,573,"51.52334476","-0.183846408","Warwick Avenue Station, Maida Vale",1146
"14911",2020,20,48,216,210,"51.51248445","-0.099141408","Godliman Street, St. Paul's",426
"14912",2020,20,49,170,164,"51.50706909","-0.145904427","Curzon Street, Mayfair",334
"14913",2020,20,50,110,87,"51.52867339","-0.087459376","East Road, Hoxton",197
"14914",2020,20,51,112,111,"51.52671796","-0.104298194","Finsbury Library , Finsbury",223
"14915",2020,20,52,151,153,"51.52295439","-0.094934859","Roscoe Street, St. Luke's",304
"14916",2020,20,53,88,91,"51.5099923","-0.143495266","Grafton Street, Mayfair",179
"14917",2020,20,54,183,180,"51.52174785","-0.094475072","Golden Lane, Barbican",363
"14918",2020,20,55,167,159,"51.51707521","-0.086685542","Finsbury Circus, Liverpool Street",326
"14919",2020,20,56,268,272,"51.52058381","-0.154701411","Paddington Street, Marylebone",540
"14920",2020,20,57,220,224,"51.52334672","-0.120202614","Guilford Street , Bloomsbury",444
"14921",2020,20,58,160,167,"51.52452699","-0.079248081","New Inn Yard, Shoreditch",327
"14922",2020,20,60,123,122,"51.52644828","-0.172190727","Lisson Grove, St. John's Wood",245
"14923",2020,20,61,189,188,"51.49738251","-0.089446947","Great Dover Street, The Borough",377
"14924",2020,20,62,158,146,"51.4907579","-0.106323685","Cotton Garden Estate, Kennington",304
"14925",2020,20,63,154,155,"51.53089041","-0.089782579","Murray Grove , Hoxton",309
"14926",2020,20,64,239,274,"51.50946212","-0.124749274","William IV Street, Strand",513
"14927",2020,20,65,3,4,NA,NA,NA,7
"14928",2020,20,66,160,145,"51.51795029","-0.108657431","Holborn Circus, Holborn",305
"14929",2020,20,67,99,99,"51.51882555","-0.108028472","Hatton Garden, Holborn",198
"14930",2020,20,68,207,214,"51.52059681","-0.116688468","Theobald's Road , Holborn",421
"14931",2020,20,69,83,70,"51.5262363","-0.134407652","Euston Road, Euston",153
"14932",2020,20,70,101,98,"51.53136059","-0.117069978","Calshot Street , King's Cross",199
"14933",2020,20,71,307,275,"51.5154186","-0.098850915","Newgate Street , St. Paul's",582
"14934",2020,20,72,60,62,"51.52352001","-0.108340165","Farringdon Lane, Clerkenwell",122
"14935",2020,20,73,255,265,"51.52572618","-0.088486188","Old Street Station, St. Luke's",520
"14936",2020,20,74,696,697,"51.48591714","-0.124469948","Vauxhall Cross, Vauxhall",1393
"14937",2020,20,75,159,160,"51.53219984","-0.105480698","Torrens Street, Angel",319
"14938",2020,20,76,201,195,"51.52559505","-0.144083893","Longford Street, The Regent's Park",396
"14939",2020,20,77,201,211,"51.52341837","-0.124121774","Russell Square Station, Bloomsbury",412
"14940",2020,20,78,146,139,"51.52486887","-0.099489485","Sadlers Sports Centre, Finsbury",285
"14941",2020,20,79,114,110,"51.511726","-0.11385596","Arundel Street, Temple",224
"14942",2020,20,80,196,170,"51.50069361","-0.102091246","Webber Street , Southwark",366
"14943",2020,20,81,169,162,"51.52025302","-0.141327271","Great Titchfield Street, Fitzrovia",331
"14944",2020,20,82,59,54,"51.514274","-0.111257","Chancery Lane, Holborn",113
"14945",2020,20,83,296,301,"51.50963938","-0.131510949","Panton Street, West End",597
"14946",2020,20,84,52,48,"51.51593725","-0.111778348","Breams Buildings, Holborn",100
"14947",2020,20,85,561,570,"51.50064702","-0.078600401","Tanner Street, Bermondsey",1131
"14948",2020,20,86,149,123,"51.48947903","-0.115156562","Sancroft Street, Vauxhall",272
"14949",2020,20,87,103,100,"51.51646835","-0.079684557","Devonshire Square, Liverpool Street",203
"14950",2020,20,88,239,248,"51.51858757","-0.132053392","Bayley Street , Bloomsbury",487
"14951",2020,20,89,175,173,"51.5262503","-0.123509611","Tavistock Place, Bloomsbury",348
"14952",2020,20,90,58,49,"51.53301907","-0.139174593","Harrington Square 1, Camden Town",107
"14953",2020,20,91,243,225,"51.49368637","-0.111014912","Walnut Tree Walk, Vauxhall",468
"14954",2020,20,92,183,185,"51.49889832","-0.100440521","Borough Road, Elephant & Castle",368
"14955",2020,20,93,217,236,"51.53440868","-0.109025404","Cloudesley Road, Angel",453
"14956",2020,20,94,409,429,"51.49506109","-0.085814489","Bricklayers Arms, Borough",838
"14957",2020,20,95,242,250,"51.5208417","-0.097340162","Aldersgate Street, Barbican",492
"14958",2020,20,96,164,160,"51.53095071","-0.078505384","Falkirk Street, Hoxton",324
"14959",2020,20,97,310,325,"51.49792478","-0.183834706","Gloucester Road (North), Kensington",635
"14960",2020,20,98,280,260,"51.52554222","-0.138231303","Hampstead Road, Euston",540
"14961",2020,20,99,472,474,"51.51457763","-0.158264483","Old Quebec Street, Marylebone",946
"14962",2020,20,100,248,242,"51.49043573","-0.122806861","Albert Embankment, Vauxhall",490
"14963",2020,20,101,287,292,"51.51155322","-0.0929401","Queen Street 1, Bank",579
"14964",2020,20,102,186,188,"51.51340693","-0.076793375","Jewry Street, Aldgate",374
"14965",2020,20,103,149,161,"51.50472376","-0.192538767","Vicarage Gate, Kensington",310
"14966",2020,20,104,201,202,"51.51159481","-0.077121322","Crosswall, Tower",403
"14967",2020,20,105,316,338,"51.51552971","-0.190240716","Westbourne Grove, Bayswater",654
"14968",2020,20,106,100,100,"51.51410514","-0.147301667","Woodstock Street, Mayfair",200
"14969",2020,20,107,230,225,"51.52600832","-0.096317627","Finsbury Leisure Centre, St. Luke's",455
"14970",2020,20,108,257,217,"51.49812559","-0.132102166","Abbey Orchard Street, Westminster",474
"14971",2020,20,109,257,261,"51.51563144","-0.132328837","Soho Square , Soho",518
"14972",2020,20,110,324,304,"51.53304322","-0.172528678","Wellington Road, St. John's Wood",628
"14973",2020,20,111,991,989,"51.5100172","-0.157275636","Park Lane , Hyde Park",1980
"14974",2020,20,112,62,60,"51.51580998","-0.105270275","Stonecutter Street, Holborn",122
"14975",2020,20,113,220,222,"51.49646288","-0.183289032","Gloucester Road (Central), South Kensington",442
"14976",2020,20,114,665,668,"51.52451738","-0.158963647","Park Road (Baker Street), The Regent's Park",1333
"14977",2020,20,115,315,332,"51.51423368","-0.073537654","Braham Street, Aldgate",647
"14978",2020,20,116,253,250,"51.51449962","-0.141423695","Little Argyll Street, West End",503
"14979",2020,20,117,176,166,"51.49288067","-0.114934001","Lollard Street, Vauxhall",342
"14980",2020,20,118,136,140,"51.49582705","-0.13547809","Rochester Row, Westminster",276
"14981",2020,20,119,281,279,"51.52589324","-0.090847761","Bath Street, St. Luke's",560
"14982",2020,20,120,69,65,"51.51573534","-0.093080779","The Guildhall, Guildhall",134
"14983",2020,20,121,130,129,"51.51891348","-0.156166631","Baker Street, Marylebone",259
"14984",2020,20,122,156,145,"51.52111369","-0.078869751","Norton Folgate, Liverpool Street",301
"14985",2020,20,123,120,121,"51.52836014","-0.104724625","St. John Street, Finsbury",241
"14986",2020,20,124,86,97,"51.49654462","-0.150905245","Eaton Square, Belgravia",183
"14987",2020,20,125,279,290,"51.50069491","-0.094524319","Borough High Street, The Borough",569
"14988",2020,20,126,90,92,"51.51782144","-0.096496865","Museum of London, Barbican",182
"14989",2020,20,127,78,71,"51.51700801","-0.09388536","Wood Street, Guildhall",149
"14990",2020,20,128,296,287,"51.49536226","-0.185296516","Emperor's Gate, South Kensington",583
"14991",2020,20,129,176,174,"51.5118973","-0.137043852","Golden Square, Soho",350
"14992",2020,20,130,839,840,"51.50950627","-0.075459482","Tower Gardens , Tower",1679
"14993",2020,20,131,149,156,"51.53300545","-0.136792671","Eversholt Street , Camden Town",305
"14994",2020,20,132,359,353,"51.52364804","-0.074754872","Bethnal Green Road, Shoreditch",712
"14995",2020,20,134,376,373,"51.504904","-0.06797","Wapping High Street, Wapping",749
"14996",2020,20,135,282,294,"51.52326004","-0.104708922","Clerkenwell Green, Clerkenwell",576
"14997",2020,20,136,293,297,"51.51196176","-0.097441687","Queen Victoria Street, St. Paul's",590
"14998",2020,20,138,365,367,"51.51227622","-0.157436972","Green Street, Mayfair",732
"14999",2020,20,139,159,160,"51.49488108","-0.117974901","Lambeth Road, Vauxhall",319
"15000",2020,20,140,120,115,"51.52096262","-0.085634242","Finsbury Square , Moorgate",235
"15001",2020,20,141,109,100,"51.51530805","-0.147203711","Chapel Place, Marylebone",209
"15002",2020,20,142,211,224,"51.49372451","-0.198286569","West Cromwell Road, Earl's Court",435
"15003",2020,20,143,258,253,"51.4968865","-0.161203828","Pont Street, Knightsbridge",511
"15004",2020,20,144,344,336,"51.48894022","-0.111435796","Kennington Cross, Kennington",680
"15005",2020,20,145,185,162,"51.50074359","-0.202759212","Ilchester Place, Kensington",347
"15006",2020,20,146,254,246,"51.48836528","-0.129361842","Vauxhall Bridge , Pimlico",500
"15007",2020,20,148,258,262,"51.49211134","-0.138364847","Tachbrook Street, Victoria",520
"15008",2020,20,149,364,360,"51.48478899","-0.110683213","Kennington Road Post Office, Oval",724
"15009",2020,20,150,190,190,"51.49705603","-0.168917077","Holy Trinity Brompton, Knightsbridge",380
"15010",2020,20,151,218,199,"51.51213691","-0.201554966","Chepstow Villas, Notting Hill",417
"15011",2020,20,152,325,326,"51.49217002","-0.101536865","Hampton Street, Walworth",651
"15012",2020,20,153,891,899,"51.511933","-0.174411","Bayswater Road, Hyde Park",1790
"15013",2020,20,154,103,103,"51.50379168","-0.11282408","Waterloo Station 3, Waterloo",206
"15014",2020,20,155,215,216,"51.49586666","-0.191933711","Lexham Gardens, Kensington",431
"15015",2020,20,156,181,200,"51.49443626","-0.092921165","New Kent Road, The Borough",381
"15016",2020,20,157,318,365,"51.50039792","-0.193068385","Wright's Lane, Kensington",683
"15017",2020,20,158,269,265,"51.49085368","-0.196170309","Trebovir Road, Earl's Court",534
"15018",2020,20,159,209,218,"51.51461995","-0.137841333","Great Marlborough Street, Soho",427
"15019",2020,20,160,348,348,"51.50663341","-0.131773845","Waterloo Place, St. James's",696
"15020",2020,20,161,158,170,"51.49234577","-0.141334487","Guildhouse Street, Victoria",328
"15021",2020,20,162,208,205,"51.51760685","-0.121328408","Southampton Place, Holborn",413
"15022",2020,20,163,309,309,"51.4931848","-0.167894973","Sloane Avenue, Knightsbridge",618
"15023",2020,20,164,172,166,"51.515607","-0.183118788","Cleveland Gardens, Bayswater",338
"15024",2020,20,165,14,21,"51.517932","-0.183716959","Orsett Terrace, Bayswater",35
"15025",2020,20,166,297,272,"51.50185512","-0.159237081","Seville Street, Knightsbridge",569
"15026",2020,20,167,171,159,"51.49395092","-0.147624377","Eccleston Place, Victoria",330
"15027",2020,20,168,255,274,"51.50040123","-0.195455928","Argyll Road, Kensington",529
"15028",2020,20,169,510,519,"51.51474612","-0.165164288","Porchester Place, Paddington",1029
"15029",2020,20,170,62,49,"51.52784273","-0.108068155","Hardwick Street, Clerkenwell",111
"15030",2020,20,171,248,249,"51.4916156","-0.186753859","Collingham Gardens, Earl's Court",497
"15031",2020,20,172,218,209,"51.49121192","-0.173715911","Sumner Place, South Kensington",427
"15032",2020,20,173,127,139,"51.50486","-0.113001","Waterloo Road, South Bank",266
"15033",2020,20,174,99,96,"51.512529","-0.115163","Strand, Strand",195
"15034",2020,20,175,44,36,"51.521668","-0.079608554","Worship Street, Shoreditch",80
"15035",2020,20,176,218,228,"51.51791921","-0.188098863","Gloucester Terrace, Bayswater",446
"15036",2020,20,177,203,196,"51.49616092","-0.140947636","Ashley Place, Victoria",399
"15037",2020,20,178,283,284,"51.48985626","-0.141923621","Warwick Square, Pimlico",567
"15038",2020,20,180,272,274,"51.5129118","-0.153645496","North Audley Street, Mayfair",546
"15039",2020,20,181,159,157,"51.49941247","-0.152317537","Belgrave Square, Belgravia",316
"15040",2020,20,182,149,151,"51.52202903","-0.165842551","Bell Street , Marylebone",300
"15041",2020,20,183,538,545,"51.482362","-0.13612398","Riverlight North, Nine Elms",1083
"15042",2020,20,184,259,256,"51.52071513","-0.14521173","Portland Place, Marylebone",515
"15043",2020,20,185,378,373,"51.48805753","-0.140741432","Alderney Street, Pimlico",751
"15044",2020,20,186,255,238,"51.51733558","-0.175810943","South Wharf Road, Paddington",493
"15045",2020,20,187,273,268,"51.49247977","-0.178433004","Queen's Gate (South), South Kensington",541
"15046",2020,20,188,93,93,"51.5165179","-0.164393768","Nutford Place, Marylebone",186
"15047",2020,20,189,136,125,"51.53166681","-0.109914711","Claremont Square, Angel",261
"15048",2020,20,190,243,247,"51.48997562","-0.132845681","Rampayne Street, Pimlico",490
"15049",2020,20,191,1583,1561,"51.50311799","-0.153520935","Hyde Park Corner, Hyde Park",3144
"15050",2020,20,192,403,409,"51.51251523","-0.133201961","Wardour Street, Soho",812
"15051",2020,20,193,151,123,"51.50581776","-0.100186337","Bankside Mix, Bankside",274
"15052",2020,20,194,971,1137,"51.50462759","-0.091773776","Hop Exchange, The Borough",2108
"15053",2020,20,195,219,231,"51.50724437","-0.106237501","Milroy Walk, South Bank",450
"15054",2020,20,196,117,99,"51.50368837","-0.098497684","Union Street, The Borough",216
"15055",2020,20,197,127,129,"51.50556905","-0.111606696","Stamford Street, South Bank",256
"15056",2020,20,199,201,197,"51.51048489","-0.082989638","Great Tower Street, Monument",398
"15057",2020,20,200,241,241,"51.51492456","-0.066078037","LMU Commercial Road, Whitechapel",482
"15058",2020,20,201,291,279,"51.5225965","-0.161113413","Dorset Square, Marylebone",570
"15059",2020,20,202,289,330,"51.51236389","-0.06954201","Leman Street, Aldgate",619
"15060",2020,20,203,176,169,"51.51821864","-0.100791005","West Smithfield Rotunda, Farringdon",345
"15061",2020,20,204,102,105,"51.52659961","-0.112432615","Margery Street, Clerkenwell",207
"15062",2020,20,206,189,195,"51.518154","-0.062697","New Road 1 , Whitechapel",384
"15063",2020,20,207,128,127,"51.50135267","-0.153194766","Grosvenor Crescent, Belgravia",255
"15064",2020,20,208,82,75,"51.52505151","-0.166304359","Mallory Street, Marylebone",157
"15065",2020,20,209,142,142,"51.49358391","-0.165101392","Denyer Street, Knightsbridge",284
"15066",2020,20,210,197,196,"51.51681444","-0.151926305","Hinde Street, Marylebone",393
"15067",2020,20,211,238,219,"51.49464523","-0.158105512","Cadogan Place, Knightsbridge",457
"15068",2020,20,212,99,81,"51.50658458","-0.199004026","Campden Hill Road, Notting Hill",180
"15069",2020,20,213,1190,1187,"51.50274025","-0.149569201","Wellington Arch, Hyde Park",2377
"15070",2020,20,214,108,98,"51.52683806","-0.130504336","Endsleigh Gardens, Euston",206
"15071",2020,20,215,124,93,"51.51906932","-0.088285377","Moorfields, Moorgate",217
"15072",2020,20,216,334,339,"51.49094565","-0.181190899","Old Brompton Road, South Kensington",673
"15073",2020,20,217,268,287,"51.51615461","-0.082422399","Wormwood Street, Liverpool Street",555
"15074",2020,20,218,279,298,"51.48971651","-0.170194408","St. Luke's Church, Chelsea",577
"15075",2020,20,219,442,440,"51.49016361","-0.19039362","Bramham Gardens, Earl's Court",882
"15076",2020,20,220,249,254,"51.49066456","-0.166485083","Chelsea Green, Chelsea",503
"15077",2020,20,221,179,207,"51.49481649","-0.13045856","Horseferry Road, Westminster",386
"15078",2020,20,222,335,314,"51.50275704","-0.155349725","Knightsbridge, Hyde Park",649
"15079",2020,20,223,350,369,"51.49148474","-0.090220911","Rodney Road , Walworth",719
"15080",2020,20,224,839,809,"51.51031","-0.18740235","Queensway, Kensington Gardens",1648
"15081",2020,20,225,333,303,"51.50935342","-0.196422","Notting Hill Gate Station, Notting Hill",636
"15082",2020,20,226,132,132,"51.50844614","-0.131961389","Charles II Street, West End",264
"15083",2020,20,227,141,144,"51.52891573","-0.115480888","Great Percy Street, Clerkenwell",285
"15084",2020,20,228,267,265,"51.50742485","-0.134621209","St. James's Square, St. James's",532
"15085",2020,20,229,488,488,"51.50654321","-0.123179697","Whitehall Place, Strand",976
"15086",2020,20,230,132,135,"51.50669284","-0.103137426","Poured Lines, Bankside",267
"15087",2020,20,231,227,221,"51.49396755","-0.17873226","Queen's Gate (Central), South Kensington",448
"15088",2020,20,232,29,28,"51.51501025","-0.112753217","Carey Street, Holborn",57
"15089",2020,20,233,493,505,"51.50777049","-0.130699733","Pall Mall East, West End",998
"15090",2020,20,234,329,334,"51.53450449","-0.106992706","Liverpool Road (N1 Centre), Angel",663
"15091",2020,20,235,229,239,"51.49571828","-0.110889274","Kennington Road  , Vauxhall",468
"15092",2020,20,236,95,83,"51.51838043","-0.073438925","Fashion Street, Whitechapel",178
"15093",2020,20,237,282,278,"51.5097860151","-0.0681619805156","Dock Street, Wapping",560
"15094",2020,20,238,169,189,"51.5233534","-0.175116099","Frampton Street, Paddington",358
"15095",2020,20,239,409,400,"51.52443845","-0.138019439","Warren Street Station, Euston",809
"15096",2020,20,240,26,22,"51.50545935","-0.10569204","Colombo Street, Southwark",48
"15097",2020,20,242,229,247,"51.52200801","-0.151359288","Beaumont Street, Marylebone",476
"15098",2020,20,243,295,281,"51.49096258","-0.139625122","Gloucester Street, Pimlico",576
"15099",2020,20,244,149,145,"51.51611887","-0.128585022","Earnshaw Street , Covent Garden",294
"15100",2020,20,245,230,190,"51.4853572","-0.142207481","Grosvenor Road, Pimlico",420
"15101",2020,20,246,221,219,"51.52285301","-0.099994052","Berry Street, Clerkenwell",440
"15102",2020,20,247,468,456,"51.530529","-0.167515","St. John's Wood Church, The Regent's Park",924
"15103",2020,20,248,1220,1209,"51.50645179","-0.170279555","Triangle Car Park, Hyde Park",2429
"15104",2020,20,249,170,130,"51.49859784","-0.096191134","Harper Road, The Borough",300
"15105",2020,20,250,154,162,"51.489932","-0.162727","Royal Avenue 1, Chelsea",316
"15106",2020,20,251,358,368,"51.518908","-0.079249","Brushfield Street, Liverpool Street",726
"15107",2020,20,252,499,471,"51.5046364","-0.116542278","Jubilee Gardens, South Bank",970
"15108",2020,20,253,497,491,"51.53404294","-0.086379717","Shoreditch Park, Hoxton",988
"15109",2020,20,254,168,173,"51.53051587","-0.106408455","Chadwell Street, Angel",341
"15110",2020,20,255,303,292,"51.52557531","-0.179592915","Clifton Road, Maida Vale",595
"15111",2020,20,256,34,23,"51.51362054","-0.116764211","Houghton Street, Strand",57
"15112",2020,20,257,204,201,"51.52248185","-0.154907218","Westminster University, Marylebone",405
"15113",2020,20,259,109,125,"51.490959","-0.1532331","Bourne Street, Belgravia",234
"15114",2020,20,260,171,159,"51.5136846","-0.135580879","Broadwick Street, Soho",330
"15115",2020,20,261,150,140,"51.5134891","-0.191351186","Princes Square, Bayswater",290
"15116",2020,20,262,190,190,"51.49874469","-0.103132904","LSBU (Borough Road), Elephant & Castle",380
"15117",2020,20,263,62,62,"51.51422502","-0.080660083","St. Mary Axe, Aldgate",124
"15118",2020,20,264,276,300,"51.52644342","-0.109256828","Tysoe Street, Clerkenwell",576
"15119",2020,20,265,171,168,"51.51595344","-0.169249375","Southwick Street, Paddington",339
"15120",2020,20,266,486,480,"51.50102668","-0.180246101","Queen's Gate (North), Kensington",966
"15121",2020,20,267,188,198,"51.49206037","-0.132224622","Regency Street, Westminster",386
"15122",2020,20,268,162,137,"51.49320445","-0.144132875","Belgrave Road, Victoria",299
"15123",2020,20,269,276,265,"51.50082346","-0.089740764","Empire Square, The Borough",541
"15124",2020,20,270,475,489,"51.4863434","-0.122492418","Kennington Lane Rail Bridge, Vauxhall",964
"15125",2020,20,271,475,465,"51.53583617","-0.156285395","London Zoo,  The Regent's Park",940
"15126",2020,20,272,276,297,"51.50144456","-0.110699309","Baylis Road, Waterloo",573
"15127",2020,20,273,179,152,"51.50613324","-0.114686385","Belvedere Road 1, South Bank",331
"15128",2020,20,274,303,280,"51.49671237","-0.20528437","Warwick Road, Olympia",583
"15129",2020,20,275,85,90,"51.52004497","-0.092176447","Barbican Centre, Barbican",175
"15130",2020,20,276,65,66,"51.50930161","-0.084985356","Lower Thames Street, Monument",131
"15131",2020,20,277,342,336,"51.50315739","-0.191496313","Kensington Church Street, Kensington",678
"15132",2020,20,278,920,937,"51.5034938","-0.07962099","Tooley Street, Bermondsey",1857
"15133",2020,20,279,135,129,"51.51862243","-0.176645823","North Wharf Road, Paddington",264
"15134",2020,20,280,217,218,"51.490083","-0.162418","Royal Avenue 2, Chelsea",435
"15135",2020,20,281,146,162,"51.49580589","-0.127575233","Smith Square, Westminster",308
"15136",2020,20,282,472,475,"51.51906446","-0.059642081","Royal London Hospital, Whitechapel",947
"15137",2020,20,283,60,49,"51.51440928","-0.118478757","Kingsway, Covent Garden",109
"15138",2020,20,284,173,174,"51.49914063","-0.112031483","Lambeth North Station, Waterloo",347
"15139",2020,20,286,170,190,"51.5272947","-0.174653609","St. John's Wood Road, St. John's Wood",360
"15140",2020,20,287,29,22,"51.52367314","-0.128377673","Bedford Way, Bloomsbury",51
"15141",2020,20,288,317,271,"51.49236962","-0.147478734","Elizabeth Bridge, Victoria",588
"15142",2020,20,289,86,80,"51.50923022","-0.151296092","South Audley Street, Mayfair",166
"15143",2020,20,290,279,269,"51.518268","-0.17110323","St Mary's Hospital, Paddington",548
"15144",2020,20,291,294,276,"51.48483991","-0.138089062","Claverton Street, Pimlico",570
"15145",2020,20,292,307,318,"51.49888404","-0.165471605","Montpelier Street, Knightsbridge",625
"15146",2020,20,293,132,125,"51.49815779","-0.209494128","Kensington Olympia Station, Olympia",257
"15147",2020,20,294,334,330,"51.488226","-0.135635511","St. George's Square, Pimlico",664
"15148",2020,20,295,153,153,"51.50029631","-0.092762704","Swan Street, The Borough",306
"15149",2020,20,296,239,247,"51.49363156","-0.190603326","Knaresborough Place, Earl's Court",486
"15150",2020,20,297,69,69,"51.49612799","-0.106000855","Geraldine Street, Elephant & Castle",138
"15151",2020,20,298,765,767,"51.50227992","-0.074189225","Curlew Street, Shad Thames",1532
"15152",2020,20,299,95,98,"51.49398524","-0.136928582","Vincent Square, Westminster",193
"15153",2020,20,300,985,962,"51.505014","-0.17306032","Serpentine Car Park, Hyde Park",1947
"15154",2020,20,301,377,370,"51.51475963","-0.148105415","Marylebone Lane, Marylebone",747
"15155",2020,20,302,368,405,"51.466907","-0.216573","Putney Pier, Wandsworth",773
"15156",2020,20,303,1114,1089,"51.50295379","-0.158456089","Albert Gate, Hyde Park",2203
"15157",2020,20,306,110,100,"51.51816295","-0.135025698","Rathbone Street, Fitzrovia",210
"15158",2020,20,307,932,927,"51.50990837","-0.187842717","Black Lion Gate, Kensington Gardens",1859
"15159",2020,20,308,236,238,"51.49907558","-0.085666316","Long Lane , Bermondsey",474
"15160",2020,20,309,164,166,"51.50963123","-0.119047563","Embankment (Savoy), Strand",330
"15161",2020,20,310,193,193,"51.4908679","-0.116911864","Black Prince Road, Vauxhall",386
"15162",2020,20,311,182,183,"51.51918144","-0.140485596","Foley Street, Fitzrovia",365
"15163",2020,20,312,376,393,"51.53088935","-0.176770502","Grove End Road, St. John's Wood",769
"15164",2020,20,313,138,140,"51.51734403","-0.138072691","Wells Street, Fitzrovia",278
"15165",2020,20,314,230,257,"51.50088934","-0.083159352","Tyers Gate, Bermondsey",487
"15166",2020,20,315,501,486,"51.52536703","-0.153463612","The Tennis Courts, The Regent's Park",987
"15167",2020,20,316,330,318,NA,NA,NA,648
"15168",2020,20,317,83,111,"51.49679128","-0.093913472","Dickens Square, Borough",194
"15169",2020,20,318,156,156,"51.51004801","-0.138846453","Sackville Street, Mayfair",312
"15170",2020,20,319,207,210,"51.52702563","-0.088542771","Baldwin Street, St. Luke's",417
"15171",2020,20,320,245,244,"51.49357351","-0.139956043","Queen Mother Sports Centre, Victoria",489
"15172",2020,20,321,527,524,"51.49785559","-0.081608045","Bermondsey Street, Bermondsey",1051
"15173",2020,20,322,151,121,"51.526293","-0.073955","Palissy Street, Shoreditch",272
"15174",2020,20,323,36,34,"51.523196","-0.083067","Clifton Street, Shoreditch",70
"15175",2020,20,324,240,232,"51.49652013","-0.101384068","Ontario Street, Elephant & Castle",472
"15176",2020,20,325,62,61,"51.50908747","-0.129697889","St. Martin's Street, West End",123
"15177",2020,20,326,340,343,"51.53266186","-0.099981142","Graham Street, Angel",683
"15178",2020,20,327,103,64,"51.53095","-0.085603","New North Road 1, Hoxton",167
"15179",2020,20,328,100,107,"51.53114","-0.086016","New North Road 2, Hoxton",207
"15180",2020,20,329,785,797,"51.53589283","-0.160854428","Prince Albert Road, The Regent's Park",1582
"15181",2020,20,330,158,104,"51.51641749","-0.179135079","Eastbourne Mews, Paddington",262
"15182",2020,20,331,189,195,"51.52085887","-0.089887855","Bunhill Row, Moorgate",384
"15183",2020,20,332,167,173,"51.49334336","-0.194757949","Nevern Place, Earl's Court",340
"15184",2020,20,333,274,265,"51.50860544","-0.193764092","Palace Gardens Terrace, Notting Hill",539
"15185",2020,20,334,54,61,"51.505044","-0.115851","Concert Hall Approach 1, South Bank",115
"15186",2020,20,335,126,123,"51.51196803","-0.120718759","Tavistock Street, Covent Garden",249
"15187",2020,20,336,118,117,"51.504942","-0.115533","Concert Hall Approach 2, South Bank",235
"15188",2020,20,337,145,137,"51.51108452","-0.197524944","Pembridge Villas, Notting Hill",282
"15189",2020,20,338,229,220,"51.51175646","-0.119643424","Wellington Street , Strand",449
"15190",2020,20,339,116,92,"51.5333196","-0.1117812","Risinghill Street, Angel",208
"15191",2020,20,340,184,177,"51.51444134","-0.087587447","Bank of England Museum, Bank",361
"15192",2020,20,341,405,426,"51.50810309","-0.12602103","Craven Street, Strand",831
"15193",2020,20,343,261,249,"51.53692216","-0.150181444","London Zoo Car Park, The Regent's Park",510
"15194",2020,20,344,76,66,"51.528246","-0.10102611","Goswell Road (City Uni), Finsbury",142
"15195",2020,20,345,363,345,"51.48802358","-0.166878535","Flood Street, Chelsea",708
"15196",2020,20,347,183,198,"51.50013942","-0.113936001","Lower Marsh, Waterloo",381
"15197",2020,20,348,197,202,"51.51217033","-0.150481272","Grosvenor Square, Mayfair",399
"15198",2020,20,349,115,116,"51.51196","-0.142783033","St. George Street, Mayfair",231
"15199",2020,20,350,680,657,"51.5017154373867","-0.1798541843891","Queen's Gate, Kensington Gardens",1337
"15200",2020,20,351,195,207,"51.529423","-0.097122","Macclesfield Rd, St Lukes",402
"15201",2020,20,352,185,177,"51.486965","-0.116625","Vauxhall Street, Vauxhall",362
"15202",2020,20,353,91,90,"51.49459148","-0.134234258","Greycoat Street , Westminster",181
"15203",2020,20,354,231,227,"51.506767","-0.123702","Northumberland Avenue, Strand",458
"15204",2020,20,356,382,385,"51.494412","-0.173881","South Kensington Station, South Kensington",767
"15205",2020,20,357,152,151,"51.520994","-0.139016","Howland Street, Fitzrovia",303
"15206",2020,20,358,106,98,"51.516226","-0.124826","High Holborn , Covent Garden",204
"15207",2020,20,359,110,103,"51.49782999","-0.135440826","Butler Place, Westminster",213
"15208",2020,20,360,127,118,"51.49675303","-0.138733562","Howick Place, Westminster",245
"15209",2020,20,361,92,76,"51.50391973","-0.11342629","Waterloo Station 2, Waterloo",168
"15210",2020,20,362,175,160,"51.536264","-0.133952","Royal College Street, Camden Town",335
"15211",2020,20,363,85,60,"51.5291212008901","-0.171185284853","Lord's, St. John's Wood",145
"15212",2020,20,364,120,110,"51.519656","-0.132339","Alfred Place, Bloomsbury",230
"15213",2020,20,365,141,137,"51.530344","-0.100168","City Road, Angel",278
"15214",2020,20,366,92,84,"51.5109192966489","-0.1511263847351","Millennium Hotel, Mayfair",176
"15215",2020,20,367,236,243,"51.5173721","-0.1642075","Harrowby Street, Marylebone",479
"15216",2020,20,368,261,256,"51.50024195","-0.15934065","Harriet Street, Knightsbridge",517
"15217",2020,20,370,74,66,"51.520205","-0.174593","Paddington Green, Paddington",140
"15218",2020,20,371,58,53,"51.49775","-0.10988","King Edward Walk, Waterloo",111
"15219",2020,20,372,26,21,"51.515208","-0.117863","Sardinia Street, Holborn",47
"15220",2020,20,373,50,30,"51.49980661","-0.176415994","Prince Consort Road, Knightsbridge",80
"15221",2020,20,374,159,141,"51.50402794","-0.11386436","Waterloo Station 1, Waterloo",300
"15222",2020,20,375,155,165,"51.50194596","-0.194392952","Kensington Town Hall, Kensington",320
"15223",2020,20,376,296,311,"51.49188409","-0.125674815","Millbank Tower, Pimlico",607
"15224",2020,20,377,118,127,"51.50535447","-0.113656543","Waterloo Bridge, South Bank",245
"15225",2020,20,378,57,71,"51.49559291","-0.179077626","Natural History Museum, South Kensington",128
"15226",2020,20,379,248,270,"51.51431171","-0.200838199","Turquoise Island, Notting Hill",518
"15227",2020,20,380,67,63,"51.50686435","-0.150666888","Stanhope Gate, Mayfair",130
"15228",2020,20,381,158,170,"51.51953043","-0.13577731","Charlotte Street, Fitzrovia",328
"15229",2020,20,382,84,90,"51.50935171","-0.14744969","Farm Street, Mayfair",174
"15230",2020,20,383,215,215,"51.51310333","-0.13121385","Frith Street, Soho",430
"15231",2020,20,384,132,153,"51.496481","-0.192404","Marloes Road, Kensington",285
"15232",2020,20,386,342,345,"51.51352755","-0.130110822","Moor Street, Soho",687
"15233",2020,20,387,316,313,"51.49369988","-0.121394101","Fire Brigade Pier, Vauxhall",629
"15234",2020,20,388,154,167,"51.51070161","-0.121723604","Southampton Street, Strand",321
"15235",2020,20,389,124,116,"51.51013066","-0.155757901","Upper Grosvenor Street, Mayfair",240
"15236",2020,20,390,126,128,"51.521776","-0.068856","Buxton Street 1, Shoreditch",254
"15237",2020,20,392,207,203,"51.49942855","-0.179702476","Imperial College, Knightsbridge",410
"15238",2020,20,393,107,103,"51.51733427","-0.103604248","Snow Hill, Farringdon",210
"15239",2020,20,394,154,156,"51.524826","-0.176268","Aberdeen Place, St. John's Wood",310
"15240",2020,20,395,295,296,"51.492462","-0.159919","Cadogan Gardens, Chelsea",591
"15241",2020,20,396,171,183,"51.51809","-0.163609","Shouldham Street, Marylebone",354
"15242",2020,20,397,345,337,"51.51348","-0.17977","Devonshire Terrace, Bayswater",682
"15243",2020,20,398,305,251,"51.502319","-0.200742","Holland Park, Kensington",556
"15244",2020,20,399,226,219,"51.52261762","-0.071653961","Brick Lane Market, Shoreditch",445
"15245",2020,20,400,175,200,"51.517703","-0.154106","George Street, Marylebone",375
"15246",2020,20,401,286,266,"51.528187","-0.075375","Columbia Road, Shoreditch",552
"15247",2020,20,402,113,104,"51.52289229","-0.171681991","Penfold Street, Marylebone",217
"15248",2020,20,403,200,204,"51.51689296","-0.158249929","George Place Mews, Marylebone",404
"15249",2020,20,404,913,899,"51.50204238","-0.184400221","Palace Gate, Kensington Gardens",1812
"15250",2020,20,405,354,363,"51.49418566","-0.18267094","Gloucester Road Station, South Kensington",717
"15251",2020,20,409,348,355,"51.493146","-0.099828","Strata, Elephant & Castle",703
"15252",2020,20,410,326,289,"51.519968","-0.169774","Edgware Road Station, Marylebone",615
"15253",2020,20,411,456,504,"51.49337264","-0.09968067","Walworth Road, Elephant & Castle",960
"15254",2020,20,412,151,145,"51.488105","-0.110121","Cleaver Street, Kennington",296
"15255",2020,20,419,576,574,"51.485821","-0.149004","Chelsea Bridge, Pimlico",1150
"15256",2020,20,420,99,108,"51.504043","-0.105312","Southwark Station 1, Southwark",207
"15257",2020,20,421,75,80,"51.504044","-0.104778","Southwark Station 2, Southwark",155
"15258",2020,20,423,246,228,"51.49456127","-0.15393398","Eaton Square (South), Belgravia",474
"15259",2020,20,424,268,254,"51.490491","-0.149186","Ebury Bridge, Pimlico",522
"15260",2020,20,425,128,122,"51.533379","-0.139159","Harrington Square 2, Camden Town",250
"15261",2020,20,426,186,194,"51.493072","-0.129925","Vincent Street, Pimlico",380
"15262",2020,20,427,291,279,"51.51397065","-0.09294031","Cheapside, Bank",570
"15263",2020,20,428,417,388,"51.499917","-0.174554","Exhibition Road, Knightsbridge",805
"15264",2020,20,430,157,169,"51.48902","-0.17524","South Parade, Chelsea",326
"15265",2020,20,431,92,97,"51.534474","-0.122203","Crinan Street, King's Cross",189
"15266",2020,20,432,178,164,"51.496957","-0.173894","Exhibition Road Museums, South Kensington",342
"15267",2020,20,433,108,103,"51.524564","-0.116279","Wren Street, Holborn",211
"15268",2020,20,435,236,223,"51.488852","-0.105593","Kennington Station, Kennington",459
"15269",2020,20,436,151,132,"51.51824","-0.11655","Red Lion Street, Holborn",283
"15270",2020,20,437,238,216,"51.488124","-0.120903","Vauxhall Walk, Vauxhall",454
"15271",2020,20,439,74,76,"51.5338","-0.118677","Killick Street, King's Cross",150
"15272",2020,20,440,373,380,"51.483145","-0.113134","Kennington Oval, Oval",753
"15273",2020,20,441,258,220,"51.495656","-0.114605","Sail Street, Vauxhall",478
"15274",2020,20,442,133,127,"51.510101","-0.211358","Walmer Road, Avondale",260
"15275",2020,20,443,193,199,"51.515256","-0.058641","Philpot Street, Whitechapel",392
"15276",2020,20,444,164,155,"51.52568","-0.055312","Bethnal Green Garden, Bethnal Green",319
"15277",2020,20,445,136,134,"51.52388","-0.065076","Cheshire Street, Bethnal Green",270
"15278",2020,20,446,174,173,"51.528936","-0.055894","York Hall, Bethnal Green",347
"15279",2020,20,447,103,87,"51.493381","-0.007542","Jubilee Crescent, Cubitt Town",190
"15280",2020,20,448,263,277,"51.50623","-0.02296","Fisherman's Walk West, Canary Wharf",540
"15281",2020,20,449,296,248,"51.511088","-0.057159","Shadwell Station, Shadwell",544
"15282",2020,20,450,198,155,"51.515975","-0.053177","Jubilee Street, Stepney",353
"15283",2020,20,451,203,201,"51.504719","-0.063531","Hermitage Court, Wapping",404
"15284",2020,20,452,241,244,"51.505697","-0.070542","St. Katharine's Way, Tower",485
"15285",2020,20,453,211,199,"51.508447","-0.055167","Garnet Street, Shadwell",410
"15286",2020,20,454,266,270,"51.487679","-0.021582","Napier Avenue, Millwall",536
"15287",2020,20,455,210,205,"51.49447","-0.014409","East Ferry Road, Cubitt Town",415
"15288",2020,20,456,246,278,"51.538071","-0.144664","Parkway, Camden Town",524
"15289",2020,20,458,321,317,"51.504749","-0.057544","Wapping Lane, Wapping",638
"15290",2020,20,459,336,325,"51.535179","-0.03338","Gunmakers Lane, Old Ford",661
"15291",2020,20,460,239,237,"51.516196","-0.029138","Burdett Road, Mile End",476
"15292",2020,20,461,128,98,"51.516","-0.038775","Aston Street, Stepney",226
"15293",2020,20,462,506,557,"51.541603","-0.138853","Bonny Street, Camden Town",1063
"15294",2020,20,463,134,118,"51.534776","-0.071881","Thurtle Road, Haggerston",252
"15295",2020,20,464,78,62,"51.51417","-0.052099","St. Mary & St. Michael Church, Stepney",140
"15296",2020,20,465,212,222,"51.53558","-0.08249","Pitfield Street North,Hoxton",434
"15297",2020,20,466,129,131,"51.534464","-0.076341","Whiston Road, Haggerston",260
"15298",2020,20,467,157,157,"51.523538","-0.030556","Southern Grove, Bow",314
"15299",2020,20,468,89,67,"51.521564","-0.022694","Cantrell Road, Bow",156
"15300",2020,20,469,182,175,"51.513757","-0.020467","Lindfield Street, Poplar",357
"15301",2020,20,470,232,200,"51.530535","-0.025492","Mostyn Grove, Bow",432
"15302",2020,20,471,158,163,"51.533283","-0.028155","Hewison Street, Old Ford",321
"15303",2020,20,472,61,54,"51.529452","-0.027616","Malmesbury Road, Bow",115
"15304",2020,20,473,183,202,"51.496137","-0.019355","Millharbour, Millwall",385
"15305",2020,20,475,306,332,"51.499041","-0.020157","Lightermans Road, Millwall",638
"15306",2020,20,476,154,143,"51.489096","-0.009205","Stebondale Street, Cubitt Town",297
"15307",2020,20,477,194,188,"51.49109","-0.018716","Spindrift Avenue, Millwall",382
"15308",2020,20,478,314,296,"51.521889","-0.04667","Stepney Green Station, Stepney",610
"15309",2020,20,479,218,232,"51.527152","-0.058005","Pott Street, Bethnal Green",450
"15310",2020,20,480,535,542,"51.5128711","-0.0389866","Flamborough Street, Limehouse",1077
"15311",2020,20,481,585,604,"51.487129","-0.009001","Saunders Ness Road, Cubitt Town",1189
"15312",2020,20,483,244,238,"51.51328","-0.047784","Albert Gardens, Stepney",482
"15313",2020,20,484,178,180,"51.528828","-0.013258","Bromley High Street, Bow",358
"15314",2020,20,485,306,294,"51.531127","-0.048017","Old Ford Road, Bethnal Green",600
"15315",2020,20,486,314,300,"51.525645","-0.069543","Granby Street, Shoreditch",614
"15316",2020,20,487,154,141,"51.511811","-0.025626","Canton Street, Poplar",295
"15317",2020,20,488,221,213,"51.506946","-0.058681","Reardon Street, Wapping",434
"15318",2020,20,489,202,194,"51.513074","-0.064094","Christian Street, Whitechapel",396
"15319",2020,20,490,91,74,"51.508622","-0.065006","Pennington Street, Wapping",165
"15320",2020,20,491,199,167,"51.522507","-0.041378","Queen Mary's, Mile End",366
"15321",2020,20,492,266,229,"51.525501","-0.032267204","Maplin Street, Mile End",495
"15322",2020,20,494,49,45,"51.50196","-0.016251","South Quay East, Canary Wharf",94
"15323",2020,20,495,387,400,"51.528169","-0.018703","Bow Church Station, Bow",787
"15324",2020,20,496,269,264,"51.52512","-0.015578","Devons Road, Bow",533
"15325",2020,20,497,135,122,"51.526149","-0.027396845","Merchant Street, Bow",257
"15326",2020,20,498,207,189,"51.527058","-0.025296","Bow Road Station, Bow",396
"15327",2020,20,499,290,262,"51.519265","-0.021345","Furze Green, Bow",552
"15328",2020,20,500,353,354,"51.519806","-0.055731","Ansell House, Stepney",707
"15329",2020,20,501,161,148,"51.522561","-0.054883","Cephas Street, Bethnal Green",309
"15330",2020,20,502,422,426,"51.53341","-0.049591815","Bonner Gate, Victoria Park",848
"15331",2020,20,503,333,312,"51.520893","-0.051394","Cleveland Way, Stepney",645
"15332",2020,20,504,112,103,"51.496454","-0.009506","St. John's Park, Cubitt Town",215
"15333",2020,20,505,158,152,"51.520398","-0.026768","Ackroyd Drive, Bow",310
"15334",2020,20,506,156,160,"51.517475","-0.075855","Bell Lane, Liverpool Street",316
"15335",2020,20,507,107,91,"51.528692","-0.059091","Clarkson Street, Bethnal Green",198
"15336",2020,20,508,166,171,"51.519362","-0.074431","Fournier Street, Whitechapel",337
"15337",2020,20,509,48,48,"51.517842","-0.090075","Fore Street, Guildhall",96
"15338",2020,20,510,497,516,"51.509303","-0.025996","Westferry DLR, Limehouse",1013
"15339",2020,20,511,436,413,"51.511066","-0.053558","Sutton Street, Shadwell",849
"15340",2020,20,512,279,290,"51.532091","-0.06142","Pritchard's Road, Bethnal Green",569
"15341",2020,20,513,215,197,"51.5142228","-0.055656","Watney Market, Stepney",412
"15342",2020,20,514,176,170,"51.516204","-0.155525","Portman Square, Marylebone",346
"15343",2020,20,515,122,118,"51.500088","-0.211316","Russell Gardens, Olympia",240
"15344",2020,20,516,151,168,"51.5112","-0.014438","Chrisp Street Market, Poplar",319
"15345",2020,20,517,177,171,"51.532513","-0.033085","Ford Road, Old Ford",348
"15346",2020,20,518,198,177,"51.528224","-0.037471","Antill Road, Mile End",375
"15347",2020,20,519,94,75,"51.518811","-0.011662","Teviot Street, Poplar",169
"15348",2020,20,520,156,140,"51.526041","-0.047218","Bancroft Road, Bethnal Green",296
"15349",2020,20,521,274,282,"51.534137","-0.037366","Driffield Road, Old Ford",556
"15350",2020,20,522,322,327,"51.525941","-0.036017","Clinton Road, Mile End",649
"15351",2020,20,523,132,143,"51.51549","-0.013475","Langdon Park, Poplar",275
"15352",2020,20,524,274,201,"51.511654","-0.179668","Lancaster Gate , Bayswater",475
"15353",2020,20,526,105,108,"51.503143","-0.008428","Lancaster Drive, Blackwall",213
"15354",2020,20,527,180,202,"51.503802","-0.215808","Hansard Mews, Holland Park",382
"15355",2020,20,528,44,48,"51.507326","-0.145827","Clarges Street, Mayfair",92
"15356",2020,20,529,234,227,"51.486892","-0.170983","Manresa Road, Chelsea",461
"15357",2020,20,530,172,182,"51.508896","-0.012413","Newby Place, Poplar",354
"15358",2020,20,531,367,366,"51.530326","-0.042744","Twig Folly Bridge, Mile End",733
"15359",2020,20,532,213,216,"51.50357","-0.020068","Jubilee Plaza, Canary Wharf",429
"15360",2020,20,533,165,146,"51.528222","-0.069743","Wellington Row, Bethnal Green",311
"15361",2020,20,534,342,360,"51.531864","-0.066035","Goldsmith's Row, Haggerston",702
"15362",2020,20,535,328,329,"51.537349","-0.147154","Gloucester Avenue, Camden Town",657
"15363",2020,20,536,76,67,"51.53385","-0.06992","Queensbridge Road, Haggerston",143
"15364",2020,20,537,248,249,"51.51793","-0.067937","Old Montague Street, Whitechapel",497
"15365",2020,20,538,220,230,"51.508981","-0.00699","Naval Row, Blackwall",450
"15366",2020,20,540,367,361,"51.528302","-0.144466","Albany Street, The Regent's Park",728
"15367",2020,20,541,669,662,"51.506613","-0.142844","Green Park Station, Mayfair",1331
"15368",2020,20,542,280,278,"51.514115","-0.033828","Salmon Lane, Limehouse",558
"15369",2020,20,543,99,84,"51.509591","-0.204666","Lansdowne Walk, Ladbroke Grove",183
"15370",2020,20,544,101,93,"51.526153","-0.102208","Percival Street, Finsbury",194
"15371",2020,20,545,164,196,"51.539957","-0.145246","Arlington Road, Camden Town",360
"15372",2020,20,546,129,134,"51.517428","-0.107987","New Fetter Lane, Holborn",263
"15373",2020,20,547,396,453,"51.509474","-0.002275","East India DLR, Blackwall",849
"15374",2020,20,548,58,58,"51.498386","-0.107913","Westminster Bridge Road, Elephant & Castle",116
"15375",2020,20,549,221,190,"51.49605","-0.104193","Gaywood  Street, Elephant & Castle",411
"15376",2020,20,550,146,135,"51.521564","-0.039264","Harford Street, Mile End",281
"15377",2020,20,551,103,101,"51.505772","-0.016460175","Import Dock, Canary Wharf",204
"15378",2020,20,552,198,198,"51.511542","-0.056667","Watney Street, Shadwell",396
"15379",2020,20,553,1021,1018,"51.535678","-0.062546","Regent's Row , Haggerston",2039
"15380",2020,20,554,122,127,"51.513548","-0.005659","Aberfeldy Street, Poplar",249
"15381",2020,20,556,116,113,"51.502661","-0.021596","Heron Quays DLR, Canary Wharf",229
"15382",2020,20,557,117,114,"51.51601","-0.0985","King Edward Street, St Pauls",231
"15383",2020,20,558,180,189,"51.493978","-0.127554","Page Street, Westminster",369
"15384",2020,20,559,188,177,"51.501391","-0.205991","Abbotsbury Road, Holland Park",365
"15385",2020,20,560,82,67,"51.511624","-0.205921","Ladbroke Grove Central, Ladbroke Grove",149
"15386",2020,20,561,149,142,"51.518369","-0.043371","Rectory Square, Stepney",291
"15387",2020,20,562,104,99,"51.51746","-0.12335","Bury Place, Holborn",203
"15388",2020,20,563,158,160,"51.499286","-0.009152","Preston's Road, Cubitt Town",318
"15389",2020,20,564,634,682,"51.509943","-0.117619","Somerset House, Strand",1316
"15390",2020,20,565,59,57,"51.521905","-0.063386","Selby Street, Whitechapel",116
"15391",2020,20,566,247,268,"51.509158","-0.224103","Westfield Ariel Way, White City",515
"15392",2020,20,568,371,380,"51.51616","-0.18697","Bishop's Bridge Road West, Bayswater",751
"15393",2020,20,569,15,20,"51.53213","-0.08299","Pitfield Street Central, Hoxton",35
"15394",2020,20,570,240,238,"51.503083","-0.017676","Upper Bank Street, Canary Wharf",478
"15395",2020,20,571,117,117,"51.506256","-0.218337","Westfield Southern Terrace ,Shepherd's Bush",234
"15396",2020,20,572,327,362,"51.539099","-0.141728","Greenland Road, Camden Town",689
"15397",2020,20,573,425,435,"51.485587","-0.18119","Limerston Street, West Chelsea",860
"15398",2020,20,574,357,355,"51.53356","-0.09315","Eagle Wharf Road, Hoxton",712
"15399",2020,20,576,86,75,"51.497304","-0.022793","Alpha Grove, Millwall",161
"15400",2020,20,577,269,269,"51.528869","-0.047548","Globe Town Market, Bethnal Green",538
"15401",2020,20,578,80,77,"51.527607","-0.057133","Hollybush Gardens, Bethnal Green",157
"15402",2020,20,579,490,480,"51.511246","-0.093051","Queen Street 2, Bank",970
"15403",2020,20,580,341,328,"51.48692917","-0.102996299","Doddington Grove, Kennington",669
"15404",2020,20,581,243,244,"51.519167","-0.147983","New Cavendish Street, Marylebone",487
"15405",2020,20,583,390,400,"51.497622","-0.125978","Abingdon Green, Westminster",790
"15406",2020,20,584,247,251,"51.51244","-0.19096","Ilchester Gardens, Bayswater",498
"15407",2020,20,586,78,75,"51.490645","-0.014582","Mudchute DLR, Cubitt Town",153
"15408",2020,20,587,357,357,"51.50964","-0.08497","Monument Street, Monument",714
"15409",2020,20,588,130,132,"51.52959","-0.0801","Hoxton Street, Hoxton",262
"15410",2020,20,589,448,471,"51.487196","-0.179369","Drayton Gardens, West Chelsea",919
"15411",2020,20,590,124,105,"51.53256","-0.16862","Greenberry Street, St.John's Wood",229
"15412",2020,20,592,144,154,"51.5171","-0.18377","Bishop's Bridge Road East, Bayswater",298
"15413",2020,20,593,95,99,"51.531066","-0.11934","Northdown Street, King's Cross",194
"15414",2020,20,594,68,69,"51.513875","-0.117774","Kingsway Southbound, Strand",137
"15415",2020,20,595,231,236,"51.493267","-0.21985","Hammersmith Road, Hammersmith",467
"15416",2020,20,596,334,336,"51.472817","-0.199783","Parson's Green , Parson's Green",670
"15417",2020,20,597,225,224,"51.473471","-0.20782","Fulham Park Road, Fulham",449
"15418",2020,20,598,265,270,"51.494499","-0.228188","Southerton Road, Hammersmith",535
"15419",2020,20,599,168,173,"51.485743","-0.223616","Manbre Road, Hammersmith",341
"15420",2020,20,600,423,427,"51.481747","-0.124642","South Lambeth Road, Vauxhall",850
"15421",2020,20,601,301,308,"51.514767","-0.225787","BBC White City, White City",609
"15422",2020,20,602,318,326,"51.472993","-0.133972","Union Grove, Wandsworth Road",644
"15423",2020,20,603,365,357,"51.477839","-0.116493","Caldwell Street, Stockwell",722
"15424",2020,20,604,156,142,"51.538792","-0.138535","St Martins Close, Camden Town",298
"15425",2020,20,605,225,218,"51.520331","-0.163667","Seymour Place, Marylebone",443
"15426",2020,20,606,110,123,"51.504199","-0.210941","Addison Road, Holland Park",233
"15427",2020,20,607,263,260,"51.468814","-0.210279","Putney Bridge Station, Fulham",523
"15428",2020,20,608,41,37,"51.491093","-0.216493","Colet Gardens, Hammersmith",78
"15429",2020,20,609,239,238,"51.46512358","-0.157788279","Sugden Road, Clapham",477
"15430",2020,20,610,388,367,"51.48256792","-0.172078187","Danvers Street, West Chelsea",755
"15431",2020,20,611,186,199,"51.50646524","-0.208486599","Princedale Road , Holland Park",385
"15432",2020,20,612,279,321,"51.46925984","-0.141812513","Wandsworth Rd, Isley Court, Wandsworth Road",600
"15433",2020,20,613,346,361,"51.50403821","-0.217400093","Woodstock Grove, Shepherd's Bush",707
"15434",2020,20,614,175,166,"51.47817208","-0.144690541","Bradmead, Battersea Park",341
"15435",2020,20,615,243,226,"51.4768851","-0.215895601","Finlay Street, Fulham",469
"15436",2020,20,616,207,211,"51.48102131","-0.209973497","Aintree Street, Fulham",418
"15437",2020,20,617,123,121,"51.47107905","-0.207842908","Elysium Place, Fulham",244
"15438",2020,20,618,397,380,"51.47625965","-0.193254007","Eel Brook Common, Walham Green",777
"15439",2020,20,619,241,240,"51.4737636","-0.197010096","Irene Road, Parsons Green",481
"15440",2020,20,620,236,239,"51.47518024","-0.167160736","Surrey Lane, Battersea",475
"15441",2020,20,621,309,349,"51.46086446","-0.187427294","Wandsworth Town Station, Wandsworth",658
"15442",2020,20,622,323,340,"51.50748124","-0.205535908","Lansdowne Road, Ladbroke Grove",663
"15443",2020,20,623,108,129,"51.46193072","-0.180791784","Nantes Close, Wandsworth",237
"15444",2020,20,624,355,334,"51.4729184","-0.132102704","Courland Grove, Wandsworth Road",689
"15445",2020,20,625,1138,1141,"51.47761941","-0.149551631","Queen's Circus, Battersea Park",2279
"15446",2020,20,626,284,291,"51.48438657","-0.20481514","Normand Park, West Kensington",575
"15447",2020,20,627,141,137,"51.4687905","-0.158230901","Holden Street, Battersea",278
"15448",2020,20,628,283,278,"51.46881971","-0.184318843","William Morris Way, Sands End",561
"15449",2020,20,629,106,123,"51.45995384","-0.190184054","Morie Street, Wandsworth",229
"15450",2020,20,630,317,297,"51.47073264","-0.126994068","Clarence Walk, Stockwell",614
"15451",2020,20,631,253,259,"51.4795017","-0.141770709","Battersea Park Road, Nine Elms",512
"15452",2020,20,632,142,157,"51.47053858","-0.163041605","Sheepcote Lane, Battersea",299
"15453",2020,20,633,381,390,"51.48959104","-0.209378594","Vereker Road, West Kensington",771
"15454",2020,20,634,181,180,"51.49434708","-0.215804559","Brook Green South, Brook Green",361
"15455",2020,20,635,278,291,"51.48606206","-0.214428378","Greyhound Road, Hammersmith",569
"15456",2020,20,636,150,135,"51.46706414","-0.193502076","South Park, Sands End",285
"15457",2020,20,637,321,318,"51.45787019","-0.174691623","Spencer Park, Wandsworth Common",639
"15458",2020,20,638,290,302,"51.46663393","-0.169821175","Falcon Road, Clapham Junction",592
"15459",2020,20,639,211,212,"51.48357068","-0.202038682","Coomer Place, West Kensington",423
"15460",2020,20,640,250,272,"51.47286577","-0.148059277","Silverthorne Road, Battersea",522
"15461",2020,20,641,247,235,"51.49824168","-0.117495865","Archbishop's Park, Waterloo",482
"15462",2020,20,642,105,106,"51.46916161","-0.174485792","Fawcett Close, Battersea",211
"15463",2020,20,643,233,245,"51.5190427","-0.204764421","All Saints' Road, Portobello",478
"15464",2020,20,644,221,208,"51.48373225","-0.223852256","Rainville Road, Hammersmith",429
"15465",2020,20,645,138,146,"51.50173215","-0.100292412","Great Suffolk Street, The Borough",284
"15466",2020,20,646,419,450,"51.49886563","-0.137424571","Buckingham Gate, Westminster",869
"15467",2020,20,647,264,262,"51.50035306","-0.217515071","Richmond Way, Shepherd's Bush",526
"15468",2020,20,648,145,154,"51.46904022","-0.19627483","Peterborough Road, Sands End",299
"15469",2020,20,649,315,333,"51.48180515","-0.18027465","World's End Place, West Chelsea",648
"15470",2020,20,650,303,288,"51.51687069","-0.213872396","St. Mark's Road, North Kensington",591
"15471",2020,20,651,182,180,"51.48089844","-0.183853573","Thorndike Close, West Chelsea",362
"15472",2020,20,652,75,102,"51.51148696","-0.218190203","Evesham Street, Avondale",177
"15473",2020,20,653,297,314,"51.47084722","-0.17070367","Simpson Street, Clapham Junction",611
"15474",2020,20,654,247,231,"51.48267821","-0.117661574","Ashmole Estate, Oval",478
"15475",2020,20,655,147,141,"51.48294452","-0.219346128","Crabtree Lane, Fulham",288
"15476",2020,20,656,114,100,"51.46841875","-0.199135704","Broomhouse Lane, Parsons Green",214
"15477",2020,20,657,221,224,"51.4996806","-0.221791552","Blythe Road West, Shepherd's Bush",445
"15478",2020,20,658,846,833,"51.47729232","-0.16478637","Ethelburga Estate, Battersea Park",1679
"15479",2020,20,659,211,214,"51.511934","-0.10307894","Blackfriars Station, St. Paul's",425
"15480",2020,20,660,159,166,"51.49087074","-0.206029743","West Kensington Station, West Kensington",325
"15481",2020,20,661,403,431,"51.51632095","-0.202608612","All Saints Church, Portobello",834
"15482",2020,20,662,382,377,"51.48498496","-0.167919869","Phene Street, Chelsea",759
"15483",2020,20,663,126,135,"51.51323001","-0.211593602","Clarendon Road, Avondale",261
"15484",2020,20,664,340,343,"51.474376","-0.155442787","Austin Road, Battersea Park",683
"15485",2020,20,665,225,226,"51.46108367","-0.191722864","Smugglers Way, Wandsworth",451
"15486",2020,20,666,261,253,"51.49610093","-0.208158259","Olympia Way, Olympia",514
"15487",2020,20,667,321,306,"51.5015946","-0.222293381","Shepherd's Bush Road North, Shepherd's Bush",627
"15488",2020,20,668,662,676,"51.49422354","-0.236769936","Ravenscourt Park Station, Hammersmith",1338
"15489",2020,20,669,181,182,"51.47614939","-0.1232585","Teversham Lane, Stockwell",363
"15490",2020,20,670,278,277,"51.46718562","-0.152248582","Ashley Crescent, Battersea",555
"15491",2020,20,671,196,205,"51.475089","-0.201968","Parsons Green Station, Parsons Green",401
"15492",2020,20,673,386,393,"51.46517078","-0.18038939","Hibbert Street, Battersea",779
"15493",2020,20,674,164,164,"51.53546778","-0.11619105","Carnegie Street, King's Cross",328
"15494",2020,20,675,224,227,"51.46348914","-0.182126248","Usk Road, Clapham Junction",451
"15495",2020,20,676,307,291,"51.47787084","-0.126874471","Hartington Road, Stockwell",598
"15496",2020,20,677,215,221,"51.46866929","-0.146544642","Heath Road, Battersea",436
"15497",2020,20,678,117,116,"51.46231278","-0.211468596","Esmond Street, Putney",233
"15498",2020,20,679,143,145,"51.47453545","-0.170210533","Orbel Street, Battersea",288
"15499",2020,20,680,323,328,"51.47768469","-0.170329317","Westbridge Road, Battersea",651
"15500",2020,20,681,415,426,"51.47303687","-0.214749808","Bishop's Avenue, Fulham",841
"15501",2020,20,682,527,518,"51.48810829","-0.22660621","Crisp Road, Hammersmith",1045
"15502",2020,20,683,247,259,"51.46506424","-0.163750945","Dorothy Road, Clapham Junction",506
"15503",2020,20,684,420,422,"51.45475251","-0.195197203","Neville Gill Close, Wandsworth",842
"15504",2020,20,685,183,194,"51.46067005","-0.198735357","Osiers Road, Wandsworth",377
"15505",2020,20,686,143,142,"51.48814438","-0.222456468","Beryl Road, Hammersmith",285
"15506",2020,20,687,248,250,"51.49760804","-0.21145598","Maclise Road, Olympia",498
"15507",2020,20,688,153,153,"51.46095151","-0.20066766","Northfields, Wandsworth",306
"15508",2020,20,689,126,140,"51.45922541","-0.180884959","Spanish Road, Clapham Junction",266
"15509",2020,20,690,144,159,"51.47047503","-0.152130083","Stanley Grove, Battersea",303
"15510",2020,20,691,372,401,"51.47946386","-0.195777222","Erin Close, Walham Green",773
"15511",2020,20,692,253,282,"51.54211855","-0.028941601","Cadogan Close, Victoria Park",535
"15512",2020,20,693,246,244,"51.464786","-0.215618902","Felsham Road, Putney",490
"15513",2020,20,694,277,273,"51.46071722","-0.216526155","Putney Rail Station, Putney",550
"15514",2020,20,695,731,748,"51.53638435","-0.102757578","Islington Green, Angel",1479
"15515",2020,20,696,158,145,"51.48728535","-0.217995921","Charing Cross Hospital, Hammersmith",303
"15516",2020,20,697,195,197,"51.53639219","-0.112721065","Charlotte Terrace, Angel",392
"15517",2020,20,698,279,268,"51.53908372","-0.070329419","Shoreditch Court, Haggerston",547
"15518",2020,20,699,129,121,"51.5366541","-0.07023031","Belford House, Haggerston",250
"15519",2020,20,700,275,268,"51.47696496","-0.174347066","Battersea Church Road, Battersea",543
"15520",2020,20,701,300,296,"51.47287627","-0.176267008","Vicarage Crescent, Battersea",596
"15521",2020,20,702,172,167,"51.52868155","-0.065550321","Durant Street, Bethnal Green",339
"15522",2020,20,703,163,150,"51.51505991","-0.10534448","St. Bride Street, Holborn",313
"15523",2020,20,704,170,166,"51.45682071","-0.202802098","Mexfield Road, East Putney",336
"15524",2020,20,705,238,253,NA,NA,NA,491
"15525",2020,20,706,239,254,"51.50215353","-0.083632928","Snowsfields, London Bridge",493
"15526",2020,20,707,195,199,"51.49021762","-0.215087092","Barons Court Station, West Kensington",394
"15527",2020,20,708,137,177,"51.46161068","-0.21614583","Disraeli Road, Putney",314
"15528",2020,20,709,113,118,"51.46321128","-0.215550761","Montserrat Road , Putney",231
"15529",2020,20,710,600,587,"51.47439218","-0.163347594","Albert Bridge Road, Battersea Park",1187
"15530",2020,20,711,174,172,"51.48335692","-0.216305546","Everington Street, Fulham",346
"15531",2020,20,712,277,259,"51.51854104","-0.034903714","Mile End Stadium, Mile End",536
"15532",2020,20,713,355,367,"51.54100708","-0.14326094","Hawley Crescent, Camden Town",722
"15533",2020,20,714,148,134,"51.47311696","-0.137235175","Stewart's Road, Wandsworth Road",282
"15534",2020,20,715,108,105,"51.51563007","-0.049067243","Aylward Street, Stepney",213
"15535",2020,20,716,171,179,"51.51542791","-0.02356501","Stainsby Road , Poplar",350
"15536",2020,20,717,462,464,"51.53658514","-0.075885686","Dunston Road , Haggerston",926
"15537",2020,20,718,199,249,"51.53571683","-0.060291813","Ada Street, Hackney Central",448
"15538",2020,20,719,530,576,"51.53642464","-0.054162264","Victoria Park Road, Hackney Central",1106
"15539",2020,20,720,230,232,"51.48724429","-0.205279052","Star Road, West Kensington",462
"15540",2020,20,721,230,220,"51.53603947","-0.026262677","Wendon Street, Old Ford",450
"15541",2020,20,722,129,128,"51.52458353","-0.058631453","Finnis Street, Bethnal Green",257
"15542",2020,20,723,405,426,"51.46822047","-0.190346493","Stephendale Road, Sands End",831
"15543",2020,20,724,139,129,"51.45799126","-0.184806157","Alma Road, Wandsworth",268
"15544",2020,20,725,370,374,"51.491327","-0.096518684","Walworth Square, Walworth",744
"15545",2020,20,726,248,244,"51.47505096","-0.150908371","Alfreda Street, Battersea Park",492
"15546",2020,20,727,327,339,"51.47569809","-0.20587627","Chesilton Road, Fulham",666
"15547",2020,20,728,195,187,"51.46199911","-0.206240805","Putney Bridge Road, East Putney",382
"15548",2020,20,729,281,270,"51.47893931","-0.208485293","St. Peter's Terrace, Fulham",551
"15549",2020,20,730,376,386,"51.49208492","-0.229116862","Bridge Avenue, Hammersmith",762
"15550",2020,20,731,134,124,"51.47727637","-0.189210466","Michael Road, Walham Green",258
"15551",2020,20,732,549,577,"51.50630441","-0.087262995","Duke Street Hill, London Bridge",1126
"15552",2020,20,733,155,145,"51.50542628","-0.150817316","Park Lane, Mayfair",300
"15553",2020,20,734,173,177,"51.46230566","-0.175407201","Plough Terrace, Clapham Junction",350
"15554",2020,20,735,114,127,"51.46489445","-0.17302926","Grant Road East, Clapham Junction",241
"15555",2020,20,736,157,157,"51.50659035","-0.216104479","Queensdale Road, Shepherd's Bush",314
"15556",2020,20,737,405,405,"51.47993289","-0.19411695","Fulham Broadway, Walham Green",810
"15557",2020,20,738,190,181,"51.47514228","-0.187278987","Imperial Road, Sands End",371
"15558",2020,20,739,285,285,"51.48176572","-0.185273723","Hortensia Road, West Brompton",570
"15559",2020,20,740,73,72,"51.51092871","-0.214594781","Sirdar Road, Avondale",145
"15560",2020,20,741,98,111,"51.5129814","-0.219486603","Freston Road, Avondale",209
"15561",2020,20,742,317,341,"51.51510818","-0.208565479","Blenheim Crescent, Ladbroke Grove",658
"15562",2020,20,743,99,119,"51.46079243","-0.212607684","Oxford Road, Putney",218
"15563",2020,20,744,100,119,"51.46745485","-0.172293499","Ingrave Street, Clapham Junction",219
"15564",2020,20,745,187,177,"51.47816972","-0.18243547","Upcerne Road, West Chelsea",364
"15565",2020,20,746,253,265,"51.4795738","-0.17903854","Lots Road, West Chelsea",518
"15566",2020,20,747,222,227,"51.48796408","-0.161765173","Ormonde Gate, Chelsea",449
"15567",2020,20,748,261,259,"51.53727795","-0.079201849","Hertford Road, De Beauvoir Town",520
"15568",2020,20,749,574,593,"51.53932857","-0.074284675","Haggerston Road, Haggerston",1167
"15569",2020,20,750,115,120,"51.4710956","-0.157850096","Culvert Road, Battersea",235
"15570",2020,20,751,46,40,"51.51612862","-0.120909408","Newton Street, Covent Garden",86
"15571",2020,20,754,59,60,"51.5129006","-0.214762686","Grenfell Road, Avondale",119
"15572",2020,20,755,295,287,"51.48512191","-0.174971902","The Vale, Chelsea",582
"15573",2020,20,756,417,427,"51.47515398","-0.159169801","Prince of Wales Drive, Battersea Park",844
"15574",2020,20,757,417,412,"51.48795853","-0.187404506","Harcourt Terrace, West Brompton",829
"15575",2020,20,758,312,322,"51.51787005","-0.201005397","Westbourne Park Road, Portobello",634
"15576",2020,20,759,84,67,"51.52456169","-0.165668686","Broadley Terrace, Marylebone",151
"15577",2020,20,760,109,98,"51.52526975","-0.163795009","Rossmore Road, Marylebone",207
"15578",2020,20,761,158,152,"51.48321729","-0.211860644","Humbolt Road, Fulham",310
"15579",2020,20,762,829,895,"51.50070305","-0.129698963","Storey's Gate, Westminster",1724
"15580",2020,20,763,251,241,"51.52059714","-0.032566533","Mile End Park Leisure Centre, Mile End",492
"15581",2020,20,764,303,317,"51.46239255","-0.16829214","St. John's Road, Clapham Junction",620
"15582",2020,20,765,117,141,"51.46760141","-0.20682737","Ranelagh Gardens, Fulham",258
"15583",2020,20,766,277,296,"51.45752945","-0.192165613","Ram Street, Wandsworth",573
"15584",2020,20,767,82,82,"51.45705988","-0.200806304","Santos Road, Wandsworth",164
"15585",2020,20,768,891,911,"51.46134382","-0.159322467","Clapham Common North Side, Clapham Common",1802
"15586",2020,20,769,96,128,"51.473611","-0.191803","Sandilands Road, Walham Green",224
"15587",2020,20,770,192,171,"51.491026","-0.209121","Gwendwr Road, West Kensington",363
"15588",2020,20,771,79,81,"51.509224","-0.216016","Rifle Place, Avondale",160
"15589",2020,20,772,449,482,"51.47250956","-0.122831913","Binfield Road, Stockwell",931
"15590",2020,20,773,179,188,"51.511891","-0.107349","Tallis Street, Temple",367
"15591",2020,20,774,162,148,"51.470131","-0.20464","Hurlingham Park, Parsons Green",310
"15592",2020,20,775,221,239,"51.496664","-0.223868","Little Brook Green, Brook Green",460
"15593",2020,20,776,365,373,"51.460333","-0.167029","Abyssinia Close, Clapham Junction",738
"15594",2020,20,777,150,154,"51.4619230679","-0.165297856693","Limburg Road, Clapham Junction",304
"15595",2020,20,779,105,94,"51.514449","-0.077178979","Houndsditch, Aldgate",199
"15596",2020,20,780,437,443,"51.474665","-0.18316517","Imperial Wharf Station, Sands End",880
"15597",2020,20,781,118,138,"51.495898","-0.173009","Victoria & Albert Museum, South Kensington",256
"15598",2020,20,782,334,342,"51.483911","-0.19760944","Halford Road, West Kensington",676
"15599",2020,20,783,305,299,"51.5403115","-0.021630359","Monier Road, Hackney Wick",604
"15600",2020,20,784,552,564,"51.546326","-0.00993526","East Village, Queen Elizabeth Olympic Park",1116
"15601",2020,20,785,930,927,"51.54094","-0.010510565","Aquatic Centre, Queen Elizabeth Olympic Park",1857
"15602",2020,20,786,678,656,"51.549369","-0.015717614","Lee Valley VeloPark, Queen Elizabeth Olympic Park",1334
"15603",2020,20,787,507,516,"51.546805","-0.01469126","Timber Lodge, Queen Elizabeth Olympic Park",1023
"15604",2020,20,789,735,731,"51.538718","-0.011889482","Podium, Queen Elizabeth Olympic Park",1466
"15605",2020,20,790,347,347,"51.541793","-0.00481","Stratford Station, Stratford",694
"15606",2020,20,792,159,156,"51.505461","-0.10454093","Blackfriars Road, Southwark",315
"15607",2020,20,793,133,102,"51.528279","-0.11955857","Cromer Street, Bloomsbury",235
"15608",2020,20,795,33,32,"51.527068","-0.13186102","Euston Square Gardens, Euston",65
"15609",2020,20,796,93,94,"51.524","-0.12640984","Coram Street, Bloomsbury",187
"15610",2020,20,797,95,76,"51.5293","-0.12827903","Ossulston Street, Somers Town",171
"15611",2020,20,798,139,139,"51.5301998755","-0.122299440803","Birkenhead Street, King's Cross",278
"15612",2020,20,799,81,82,"51.4976984561","-0.137598896295","Kings Gate House, Westminster",163
"15613",2020,20,801,129,120,"51.5052241745","-0.0980318118664","Lavington Street, Bankside",249
"15614",2020,20,802,401,402,"51.4765900593","-0.118256789081","Albert Square, Stockwell",803
"15615",2020,20,803,135,141,"51.5054099403","-0.0983410884509","Southwark Street, Bankside",276
"15616",2020,20,804,315,323,"51.5346677396","-0.125078652873","Good's Way, King's Cross",638
"15617",2020,20,806,202,197,"51.5372405623","-0.124807385707","Handyside Street, King's Cross",399
"15618",2020,20,807,282,295,"51.5212","-0.20888818","Bevington Road West, North Kensington",577
"15619",2020,20,809,97,90,"51.5162778834","-0.118272991635","Lincoln's Inn Fields, Holborn",187
"15620",2020,20,810,124,147,"51.5067252868","-0.0988072461627","Tate Modern, Bankside",271
"15621",2020,20,811,546,554,"51.5057030357","-0.0277727426235","Westferry Circus, Canary Wharf",1100
"15622",2020,20,812,324,322,"51.5487311915","-0.0226065549321","Here East North, Queen Elizabeth Olympic Park",646
"15623",2020,20,813,56,123,"51.4878074485","-0.122759625866","New Spring Gardens Walk, Vauxhall",179
"15624",2020,20,814,362,362,"51.4714330677","-0.123670735702","Clapham Road, Lingham Street, Stockwell",724
"15625",2020,20,815,522,510,"51.5000891978","-0.116628700672","Lambeth Palace Road, Waterloo",1032
"15626",2020,20,816,145,140,"51.5465327935","-0.0205975904647","Here East South, Queen Elizabeth Olympic Park",285
"15627",2020,20,817,347,366,"51.4813354746","-0.138212295869","Riverlight South, Nine Elms",713
"15628",2020,20,818,1211,1192,"51.501513","-0.12382322","Westminster Pier, Westminster",2403
"15629",2020,20,819,185,174,"51.50621","-0.114842","Belvedere Road 2, South Bank",359
"15630",2020,20,820,204,192,"51.492807","-0.091938","Victory Place, Walworth",396
"15631",2020,20,821,882,890,"51.4835074867","-0.147714557371","Battersea Power Station, Battersea Park",1772
"15632",2020,20,826,209,210,"51.496863","-0.1429434","Allington Street, Victoria",419
"15633",2020,20,827,361,373,"51.479601","-0.11147178","Cranmer Road, Stockwell",734
"15634",2020,20,828,314,317,"51.473874","-0.11258096","Normandy Road, Stockwell",631
"15635",2020,20,829,177,164,"51.469217","-0.11268674","Wynne Road, Stockwell",341
"15636",2020,20,830,296,296,"51.469202","-0.11902256","Sidney Road, Stockwell",592
"15637",2020,20,831,281,339,"51.466232","-0.11317995","St John's Crescent, Brixton",620
"15638",2020,20,832,605,614,"51.464019","-0.11578197","Ferndale Road, Brixton",1219
"15639",2020,20,833,748,830,"51.460232","-0.11537509","Saltoun Road, Brixton",1578
"15640",2020,20,834,499,507,"51.477966","-0.14785703","Gas Holders, Battersea Park",1006
"15641",2020,20,835,136,132,"51.516785","-0.10494775","Farringdon Street, Holborn",268
"15642",2020,20,836,240,252,"51.541596","-0.12544145","York Way, Kings Cross",492
"15643",2020,20,838,68,72,"51.518093","-0.0914017","Fore Street Avenue, Guildhall",140
"15644",2020,20,839,252,251,"51.508033","-0.10682363","Sea Containers, South Bank",503
"15645",2020,21,1,159,117,"51.52916347","-0.109970527","River Street , Clerkenwell",276
"15646",2020,21,2,504,508,"51.49960695","-0.197574246","Phillimore Gardens, Kensington",1012
"15647",2020,21,3,84,82,"51.52128377","-0.084605692","Christopher Street, Liverpool Street",166
"15648",2020,21,4,113,94,"51.53005939","-0.120973687","St. Chad's Street, King's Cross",207
"15649",2020,21,5,335,313,"51.49313","-0.156876","Sedding Street, Sloane Square",648
"15650",2020,21,6,270,273,"51.51811784","-0.144228881","Broadcasting House, Marylebone",543
"15651",2020,21,7,387,397,"51.53430039","-0.1680743","Charlbert Street, St. John's Wood",784
"15652",2020,21,8,945,967,"51.529857","-0.18348604","Maida Vale, Maida Vale",1912
"15653",2020,21,9,339,326,"51.5073853","-0.096440751","New Globe Walk, Bankside",665
"15654",2020,21,10,195,195,"51.50597426","-0.092754157","Park Street, Bankside",390
"15655",2020,21,11,220,208,"51.52395143","-0.122502346","Brunswick Square, Bloomsbury",428
"15656",2020,21,12,174,158,"51.52168078","-0.130431727","Malet Street, Bloomsbury",332
"15657",2020,21,13,99,93,"51.51991453","-0.136039674","Scala Street, Fitzrovia",192
"15658",2020,21,14,509,507,"51.52994371","-0.123616824","Belgrove Street , King's Cross",1016
"15659",2020,21,15,183,163,"51.51772703","-0.127854211","Great Russell Street, Bloomsbury",346
"15660",2020,21,16,240,237,"51.52635795","-0.125979294","Cartwright Gardens , Bloomsbury",477
"15661",2020,21,17,326,323,"51.5216612","-0.109006325","Hatton Wall, Holborn",649
"15662",2020,21,18,331,328,"51.51477076","-0.12221963","Drury Lane, Covent Garden",659
"15663",2020,21,19,83,73,"51.52505093","-0.131161087","Taviton Street, Bloomsbury",156
"15664",2020,21,20,37,39,"51.527326","-0.13605286","Drummond Street , Euston",76
"15665",2020,21,21,91,78,"51.53007835","-0.13884627","Hampstead Road (Cartmel), Euston",169
"15666",2020,21,22,280,301,"51.5222641","-0.114079481","Northington Street , Holborn",581
"15667",2020,21,23,111,86,"51.51943538","-0.119123345","Red Lion Square, Holborn",197
"15668",2020,21,24,231,198,"51.51908011","-0.124678402","British Museum, Bloomsbury",429
"15669",2020,21,25,170,151,"51.5288338","-0.132250369","Doric Way , Somers Town",321
"15670",2020,21,26,187,185,"51.52728093","-0.11829517","Ampton Street , Clerkenwell",372
"15671",2020,21,27,101,133,"51.51382102","-0.107927706","Bouverie Street, Temple",234
"15672",2020,21,28,581,586,"51.52351808","-0.143613641","Bolsover Street, Fitzrovia",1167
"15673",2020,21,29,303,303,"51.513735","-0.193487","Hereford Road, Bayswater",606
"15674",2020,21,30,213,172,"51.52915444","-0.093421615","Windsor Terrace, Hoxton",385
"15675",2020,21,31,230,315,"51.52953709","-0.083353323","Fanshaw Street, Hoxton",545
"15676",2020,21,32,257,261,"51.52469624","-0.084439283","Leonard Circus , Shoreditch",518
"15677",2020,21,33,295,295,"51.5156","-0.070056","Central House, Aldgate",590
"15678",2020,21,34,191,174,"51.5341235","-0.129386874","Pancras Road, King's Cross",365
"15679",2020,21,36,704,712,"51.50173726","-0.184980612","De Vere Gardens, Kensington",1416
"15680",2020,21,37,336,351,"51.49159394","-0.192369256","Penywern Road, Earl's Court",687
"15681",2020,21,38,228,216,"51.4973875","-0.197245586","Abingdon Villas, Kensington",444
"15682",2020,21,39,495,475,"51.5263778","-0.078130921","Shoreditch High Street, Shoreditch",970
"15683",2020,21,40,250,256,"51.52127071","-0.0755789","Commercial Street, Shoreditch",506
"15684",2020,21,41,69,60,"51.520955","-0.083493552","Pindar Street, Liverpool Street",129
"15685",2020,21,42,190,174,"51.53099181","-0.093903825","Wenlock Road , Hoxton",364
"15686",2020,21,43,371,358,"51.52026","-0.157183945","Crawford Street, Marylebone",729
"15687",2020,21,44,141,142,"51.51073687","-0.144165239","Bruton Street, Mayfair",283
"15688",2020,21,45,156,120,"51.522511","-0.162298","Boston Place, Marylebone",276
"15689",2020,21,46,262,257,"51.507131","-0.06691","Nesham Street, Wapping",519
"15690",2020,21,47,845,851,"51.52334476","-0.183846408","Warwick Avenue Station, Maida Vale",1696
"15691",2020,21,48,303,268,"51.51248445","-0.099141408","Godliman Street, St. Paul's",571
"15692",2020,21,49,228,244,"51.50706909","-0.145904427","Curzon Street, Mayfair",472
"15693",2020,21,50,139,139,"51.52867339","-0.087459376","East Road, Hoxton",278
"15694",2020,21,51,165,149,"51.52671796","-0.104298194","Finsbury Library , Finsbury",314
"15695",2020,21,52,194,186,"51.52295439","-0.094934859","Roscoe Street, St. Luke's",380
"15696",2020,21,53,98,98,"51.5099923","-0.143495266","Grafton Street, Mayfair",196
"15697",2020,21,54,204,186,"51.52174785","-0.094475072","Golden Lane, Barbican",390
"15698",2020,21,55,212,225,"51.51707521","-0.086685542","Finsbury Circus, Liverpool Street",437
"15699",2020,21,56,400,412,"51.52058381","-0.154701411","Paddington Street, Marylebone",812
"15700",2020,21,57,232,262,"51.52334672","-0.120202614","Guilford Street , Bloomsbury",494
"15701",2020,21,58,246,227,"51.52452699","-0.079248081","New Inn Yard, Shoreditch",473
"15702",2020,21,60,192,183,"51.52644828","-0.172190727","Lisson Grove, St. John's Wood",375
"15703",2020,21,61,219,249,"51.49738251","-0.089446947","Great Dover Street, The Borough",468
"15704",2020,21,62,204,185,"51.4907579","-0.106323685","Cotton Garden Estate, Kennington",389
"15705",2020,21,63,174,174,"51.53089041","-0.089782579","Murray Grove , Hoxton",348
"15706",2020,21,64,383,405,"51.50946212","-0.124749274","William IV Street, Strand",788
"15707",2020,21,66,211,205,"51.51795029","-0.108657431","Holborn Circus, Holborn",416
"15708",2020,21,67,144,126,"51.51882555","-0.108028472","Hatton Garden, Holborn",270
"15709",2020,21,68,296,289,"51.52059681","-0.116688468","Theobald's Road , Holborn",585
"15710",2020,21,69,118,98,"51.5262363","-0.134407652","Euston Road, Euston",216
"15711",2020,21,70,139,132,"51.53136059","-0.117069978","Calshot Street , King's Cross",271
"15712",2020,21,71,334,303,"51.5154186","-0.098850915","Newgate Street , St. Paul's",637
"15713",2020,21,72,5,8,"51.52352001","-0.108340165","Farringdon Lane, Clerkenwell",13
"15714",2020,21,73,315,315,"51.52572618","-0.088486188","Old Street Station, St. Luke's",630
"15715",2020,21,74,992,990,"51.48591714","-0.124469948","Vauxhall Cross, Vauxhall",1982
"15716",2020,21,75,213,216,"51.53219984","-0.105480698","Torrens Street, Angel",429
"15717",2020,21,76,293,293,"51.52559505","-0.144083893","Longford Street, The Regent's Park",586
"15718",2020,21,77,291,265,"51.52341837","-0.124121774","Russell Square Station, Bloomsbury",556
"15719",2020,21,78,163,149,"51.52486887","-0.099489485","Sadlers Sports Centre, Finsbury",312
"15720",2020,21,79,117,118,"51.511726","-0.11385596","Arundel Street, Temple",235
"15721",2020,21,80,261,252,"51.50069361","-0.102091246","Webber Street , Southwark",513
"15722",2020,21,81,259,254,"51.52025302","-0.141327271","Great Titchfield Street, Fitzrovia",513
"15723",2020,21,82,111,108,"51.514274","-0.111257","Chancery Lane, Holborn",219
"15724",2020,21,83,418,430,"51.50963938","-0.131510949","Panton Street, West End",848
"15725",2020,21,84,87,63,"51.51593725","-0.111778348","Breams Buildings, Holborn",150
"15726",2020,21,85,742,783,"51.50064702","-0.078600401","Tanner Street, Bermondsey",1525
"15727",2020,21,86,157,152,"51.48947903","-0.115156562","Sancroft Street, Vauxhall",309
"15728",2020,21,87,110,105,"51.51646835","-0.079684557","Devonshire Square, Liverpool Street",215
"15729",2020,21,88,337,335,"51.51858757","-0.132053392","Bayley Street , Bloomsbury",672
"15730",2020,21,89,206,188,"51.5262503","-0.123509611","Tavistock Place, Bloomsbury",394
"15731",2020,21,90,71,53,"51.53301907","-0.139174593","Harrington Square 1, Camden Town",124
"15732",2020,21,91,278,279,"51.49368637","-0.111014912","Walnut Tree Walk, Vauxhall",557
"15733",2020,21,92,251,261,"51.49889832","-0.100440521","Borough Road, Elephant & Castle",512
"15734",2020,21,93,321,300,"51.53440868","-0.109025404","Cloudesley Road, Angel",621
"15735",2020,21,94,731,746,"51.49506109","-0.085814489","Bricklayers Arms, Borough",1477
"15736",2020,21,95,309,313,"51.5208417","-0.097340162","Aldersgate Street, Barbican",622
"15737",2020,21,96,176,194,"51.53095071","-0.078505384","Falkirk Street, Hoxton",370
"15738",2020,21,97,347,358,"51.49792478","-0.183834706","Gloucester Road (North), Kensington",705
"15739",2020,21,98,361,348,"51.52554222","-0.138231303","Hampstead Road, Euston",709
"15740",2020,21,99,663,679,"51.51457763","-0.158264483","Old Quebec Street, Marylebone",1342
"15741",2020,21,100,354,329,"51.49043573","-0.122806861","Albert Embankment, Vauxhall",683
"15742",2020,21,101,350,352,"51.51155322","-0.0929401","Queen Street 1, Bank",702
"15743",2020,21,102,241,241,"51.51340693","-0.076793375","Jewry Street, Aldgate",482
"15744",2020,21,103,192,172,"51.50472376","-0.192538767","Vicarage Gate, Kensington",364
"15745",2020,21,104,287,289,"51.51159481","-0.077121322","Crosswall, Tower",576
"15746",2020,21,105,416,420,"51.51552971","-0.190240716","Westbourne Grove, Bayswater",836
"15747",2020,21,106,156,146,"51.51410514","-0.147301667","Woodstock Street, Mayfair",302
"15748",2020,21,107,226,234,"51.52600832","-0.096317627","Finsbury Leisure Centre, St. Luke's",460
"15749",2020,21,108,281,284,"51.49812559","-0.132102166","Abbey Orchard Street, Westminster",565
"15750",2020,21,109,462,402,"51.51563144","-0.132328837","Soho Square , Soho",864
"15751",2020,21,110,407,406,"51.53304322","-0.172528678","Wellington Road, St. John's Wood",813
"15752",2020,21,111,1589,1635,"51.5100172","-0.157275636","Park Lane , Hyde Park",3224
"15753",2020,21,112,70,73,"51.51580998","-0.105270275","Stonecutter Street, Holborn",143
"15754",2020,21,113,325,297,"51.49646288","-0.183289032","Gloucester Road (Central), South Kensington",622
"15755",2020,21,114,961,923,"51.52451738","-0.158963647","Park Road (Baker Street), The Regent's Park",1884
"15756",2020,21,115,381,414,"51.51423368","-0.073537654","Braham Street, Aldgate",795
"15757",2020,21,116,416,430,"51.51449962","-0.141423695","Little Argyll Street, West End",846
"15758",2020,21,117,200,195,"51.49288067","-0.114934001","Lollard Street, Vauxhall",395
"15759",2020,21,118,250,260,"51.49582705","-0.13547809","Rochester Row, Westminster",510
"15760",2020,21,119,334,359,"51.52589324","-0.090847761","Bath Street, St. Luke's",693
"15761",2020,21,120,77,75,"51.51573534","-0.093080779","The Guildhall, Guildhall",152
"15762",2020,21,121,144,135,"51.51891348","-0.156166631","Baker Street, Marylebone",279
"15763",2020,21,122,136,127,"51.52111369","-0.078869751","Norton Folgate, Liverpool Street",263
"15764",2020,21,123,137,128,"51.52836014","-0.104724625","St. John Street, Finsbury",265
"15765",2020,21,124,111,93,"51.49654462","-0.150905245","Eaton Square, Belgravia",204
"15766",2020,21,125,324,326,"51.50069491","-0.094524319","Borough High Street, The Borough",650
"15767",2020,21,126,115,108,"51.51782144","-0.096496865","Museum of London, Barbican",223
"15768",2020,21,127,91,83,"51.51700801","-0.09388536","Wood Street, Guildhall",174
"15769",2020,21,128,359,359,"51.49536226","-0.185296516","Emperor's Gate, South Kensington",718
"15770",2020,21,129,267,265,"51.5118973","-0.137043852","Golden Square, Soho",532
"15771",2020,21,130,1104,1137,"51.50950627","-0.075459482","Tower Gardens , Tower",2241
"15772",2020,21,131,201,213,"51.53300545","-0.136792671","Eversholt Street , Camden Town",414
"15773",2020,21,132,555,562,"51.52364804","-0.074754872","Bethnal Green Road, Shoreditch",1117
"15774",2020,21,134,581,563,"51.504904","-0.06797","Wapping High Street, Wapping",1144
"15775",2020,21,135,356,356,"51.52326004","-0.104708922","Clerkenwell Green, Clerkenwell",712
"15776",2020,21,136,361,340,"51.51196176","-0.097441687","Queen Victoria Street, St. Paul's",701
"15777",2020,21,138,598,602,"51.51227622","-0.157436972","Green Street, Mayfair",1200
"15778",2020,21,139,241,233,"51.49488108","-0.117974901","Lambeth Road, Vauxhall",474
"15779",2020,21,140,155,172,"51.52096262","-0.085634242","Finsbury Square , Moorgate",327
"15780",2020,21,141,136,141,"51.51530805","-0.147203711","Chapel Place, Marylebone",277
"15781",2020,21,142,268,270,"51.49372451","-0.198286569","West Cromwell Road, Earl's Court",538
"15782",2020,21,143,344,355,"51.4968865","-0.161203828","Pont Street, Knightsbridge",699
"15783",2020,21,144,485,476,"51.48894022","-0.111435796","Kennington Cross, Kennington",961
"15784",2020,21,145,254,232,"51.50074359","-0.202759212","Ilchester Place, Kensington",486
"15785",2020,21,146,315,337,"51.48836528","-0.129361842","Vauxhall Bridge , Pimlico",652
"15786",2020,21,148,368,365,"51.49211134","-0.138364847","Tachbrook Street, Victoria",733
"15787",2020,21,149,580,602,"51.48478899","-0.110683213","Kennington Road Post Office, Oval",1182
"15788",2020,21,150,233,253,"51.49705603","-0.168917077","Holy Trinity Brompton, Knightsbridge",486
"15789",2020,21,151,308,262,"51.51213691","-0.201554966","Chepstow Villas, Notting Hill",570
"15790",2020,21,152,440,443,"51.49217002","-0.101536865","Hampton Street, Walworth",883
"15791",2020,21,153,1166,1161,"51.511933","-0.174411","Bayswater Road, Hyde Park",2327
"15792",2020,21,154,166,141,"51.50379168","-0.11282408","Waterloo Station 3, Waterloo",307
"15793",2020,21,155,298,295,"51.49586666","-0.191933711","Lexham Gardens, Kensington",593
"15794",2020,21,156,328,353,"51.49443626","-0.092921165","New Kent Road, The Borough",681
"15795",2020,21,157,449,473,"51.50039792","-0.193068385","Wright's Lane, Kensington",922
"15796",2020,21,158,348,333,"51.49085368","-0.196170309","Trebovir Road, Earl's Court",681
"15797",2020,21,159,295,304,"51.51461995","-0.137841333","Great Marlborough Street, Soho",599
"15798",2020,21,160,340,362,"51.50663341","-0.131773845","Waterloo Place, St. James's",702
"15799",2020,21,161,176,176,"51.49234577","-0.141334487","Guildhouse Street, Victoria",352
"15800",2020,21,162,215,208,"51.51760685","-0.121328408","Southampton Place, Holborn",423
"15801",2020,21,163,434,420,"51.4931848","-0.167894973","Sloane Avenue, Knightsbridge",854
"15802",2020,21,164,253,244,"51.515607","-0.183118788","Cleveland Gardens, Bayswater",497
"15803",2020,21,165,86,82,"51.517932","-0.183716959","Orsett Terrace, Bayswater",168
"15804",2020,21,166,430,435,"51.50185512","-0.159237081","Seville Street, Knightsbridge",865
"15805",2020,21,167,228,220,"51.49395092","-0.147624377","Eccleston Place, Victoria",448
"15806",2020,21,168,363,364,"51.50040123","-0.195455928","Argyll Road, Kensington",727
"15807",2020,21,169,713,713,"51.51474612","-0.165164288","Porchester Place, Paddington",1426
"15808",2020,21,170,79,64,"51.52784273","-0.108068155","Hardwick Street, Clerkenwell",143
"15809",2020,21,171,364,351,"51.4916156","-0.186753859","Collingham Gardens, Earl's Court",715
"15810",2020,21,172,273,294,"51.49121192","-0.173715911","Sumner Place, South Kensington",567
"15811",2020,21,173,140,142,"51.50486","-0.113001","Waterloo Road, South Bank",282
"15812",2020,21,174,111,105,"51.512529","-0.115163","Strand, Strand",216
"15813",2020,21,175,90,94,"51.521668","-0.079608554","Worship Street, Shoreditch",184
"15814",2020,21,176,323,315,"51.51791921","-0.188098863","Gloucester Terrace, Bayswater",638
"15815",2020,21,177,217,210,"51.49616092","-0.140947636","Ashley Place, Victoria",427
"15816",2020,21,178,406,380,"51.48985626","-0.141923621","Warwick Square, Pimlico",786
"15817",2020,21,180,317,355,"51.5129118","-0.153645496","North Audley Street, Mayfair",672
"15818",2020,21,181,265,250,"51.49941247","-0.152317537","Belgrave Square, Belgravia",515
"15819",2020,21,182,210,198,"51.52202903","-0.165842551","Bell Street , Marylebone",408
"15820",2020,21,183,623,616,"51.482362","-0.13612398","Riverlight North, Nine Elms",1239
"15821",2020,21,184,300,296,"51.52071513","-0.14521173","Portland Place, Marylebone",596
"15822",2020,21,185,454,443,"51.48805753","-0.140741432","Alderney Street, Pimlico",897
"15823",2020,21,186,333,334,"51.51733558","-0.175810943","South Wharf Road, Paddington",667
"15824",2020,21,187,402,399,"51.49247977","-0.178433004","Queen's Gate (South), South Kensington",801
"15825",2020,21,188,115,109,"51.5165179","-0.164393768","Nutford Place, Marylebone",224
"15826",2020,21,189,188,166,"51.53166681","-0.109914711","Claremont Square, Angel",354
"15827",2020,21,190,403,413,"51.48997562","-0.132845681","Rampayne Street, Pimlico",816
"15828",2020,21,191,2877,2900,"51.50311799","-0.153520935","Hyde Park Corner, Hyde Park",5777
"15829",2020,21,192,522,527,"51.51251523","-0.133201961","Wardour Street, Soho",1049
"15830",2020,21,193,190,169,"51.50581776","-0.100186337","Bankside Mix, Bankside",359
"15831",2020,21,194,1144,1338,"51.50462759","-0.091773776","Hop Exchange, The Borough",2482
"15832",2020,21,195,332,333,"51.50724437","-0.106237501","Milroy Walk, South Bank",665
"15833",2020,21,196,137,130,"51.50368837","-0.098497684","Union Street, The Borough",267
"15834",2020,21,197,217,215,"51.50556905","-0.111606696","Stamford Street, South Bank",432
"15835",2020,21,199,413,396,"51.51048489","-0.082989638","Great Tower Street, Monument",809
"15836",2020,21,200,306,304,"51.51492456","-0.066078037","LMU Commercial Road, Whitechapel",610
"15837",2020,21,201,390,371,"51.5225965","-0.161113413","Dorset Square, Marylebone",761
"15838",2020,21,202,437,452,"51.51236389","-0.06954201","Leman Street, Aldgate",889
"15839",2020,21,203,199,210,"51.51821864","-0.100791005","West Smithfield Rotunda, Farringdon",409
"15840",2020,21,204,153,156,"51.52659961","-0.112432615","Margery Street, Clerkenwell",309
"15841",2020,21,206,364,345,"51.518154","-0.062697","New Road 1 , Whitechapel",709
"15842",2020,21,207,190,173,"51.50135267","-0.153194766","Grosvenor Crescent, Belgravia",363
"15843",2020,21,208,116,108,"51.52505151","-0.166304359","Mallory Street, Marylebone",224
"15844",2020,21,209,188,192,"51.49358391","-0.165101392","Denyer Street, Knightsbridge",380
"15845",2020,21,210,274,271,"51.51681444","-0.151926305","Hinde Street, Marylebone",545
"15846",2020,21,211,330,326,"51.49464523","-0.158105512","Cadogan Place, Knightsbridge",656
"15847",2020,21,212,142,122,"51.50658458","-0.199004026","Campden Hill Road, Notting Hill",264
"15848",2020,21,213,1629,1643,"51.50274025","-0.149569201","Wellington Arch, Hyde Park",3272
"15849",2020,21,214,147,137,"51.52683806","-0.130504336","Endsleigh Gardens, Euston",284
"15850",2020,21,215,134,104,"51.51906932","-0.088285377","Moorfields, Moorgate",238
"15851",2020,21,216,470,470,"51.49094565","-0.181190899","Old Brompton Road, South Kensington",940
"15852",2020,21,217,423,454,"51.51615461","-0.082422399","Wormwood Street, Liverpool Street",877
"15853",2020,21,218,345,343,"51.48971651","-0.170194408","St. Luke's Church, Chelsea",688
"15854",2020,21,219,580,567,"51.49016361","-0.19039362","Bramham Gardens, Earl's Court",1147
"15855",2020,21,220,358,346,"51.49066456","-0.166485083","Chelsea Green, Chelsea",704
"15856",2020,21,221,252,260,"51.49481649","-0.13045856","Horseferry Road, Westminster",512
"15857",2020,21,222,424,390,"51.50275704","-0.155349725","Knightsbridge, Hyde Park",814
"15858",2020,21,223,674,684,"51.49148474","-0.090220911","Rodney Road , Walworth",1358
"15859",2020,21,224,929,920,"51.51031","-0.18740235","Queensway, Kensington Gardens",1849
"15860",2020,21,225,478,435,"51.50935342","-0.196422","Notting Hill Gate Station, Notting Hill",913
"15861",2020,21,226,165,164,"51.50844614","-0.131961389","Charles II Street, West End",329
"15862",2020,21,227,206,211,"51.52891573","-0.115480888","Great Percy Street, Clerkenwell",417
"15863",2020,21,228,345,384,"51.50742485","-0.134621209","St. James's Square, St. James's",729
"15864",2020,21,229,656,661,"51.50654321","-0.123179697","Whitehall Place, Strand",1317
"15865",2020,21,230,167,155,"51.50669284","-0.103137426","Poured Lines, Bankside",322
"15866",2020,21,231,343,305,"51.49396755","-0.17873226","Queen's Gate (Central), South Kensington",648
"15867",2020,21,232,22,23,"51.51501025","-0.112753217","Carey Street, Holborn",45
"15868",2020,21,233,737,723,"51.50777049","-0.130699733","Pall Mall East, West End",1460
"15869",2020,21,234,388,397,"51.53450449","-0.106992706","Liverpool Road (N1 Centre), Angel",785
"15870",2020,21,235,316,293,"51.49571828","-0.110889274","Kennington Road  , Vauxhall",609
"15871",2020,21,236,122,107,"51.51838043","-0.073438925","Fashion Street, Whitechapel",229
"15872",2020,21,237,391,407,"51.5097860151","-0.0681619805156","Dock Street, Wapping",798
"15873",2020,21,238,262,279,"51.5233534","-0.175116099","Frampton Street, Paddington",541
"15874",2020,21,239,543,528,"51.52443845","-0.138019439","Warren Street Station, Euston",1071
"15875",2020,21,240,42,36,"51.50545935","-0.10569204","Colombo Street, Southwark",78
"15876",2020,21,242,381,376,"51.52200801","-0.151359288","Beaumont Street, Marylebone",757
"15877",2020,21,243,378,366,"51.49096258","-0.139625122","Gloucester Street, Pimlico",744
"15878",2020,21,244,177,178,"51.51611887","-0.128585022","Earnshaw Street , Covent Garden",355
"15879",2020,21,245,250,204,"51.4853572","-0.142207481","Grosvenor Road, Pimlico",454
"15880",2020,21,246,270,270,"51.52285301","-0.099994052","Berry Street, Clerkenwell",540
"15881",2020,21,247,493,450,"51.530529","-0.167515","St. John's Wood Church, The Regent's Park",943
"15882",2020,21,248,2150,2164,"51.50645179","-0.170279555","Triangle Car Park, Hyde Park",4314
"15883",2020,21,249,254,187,"51.49859784","-0.096191134","Harper Road, The Borough",441
"15884",2020,21,250,236,242,"51.489932","-0.162727","Royal Avenue 1, Chelsea",478
"15885",2020,21,251,518,491,"51.518908","-0.079249","Brushfield Street, Liverpool Street",1009
"15886",2020,21,252,742,781,"51.5046364","-0.116542278","Jubilee Gardens, South Bank",1523
"15887",2020,21,253,706,677,"51.53404294","-0.086379717","Shoreditch Park, Hoxton",1383
"15888",2020,21,254,292,287,"51.53051587","-0.106408455","Chadwell Street, Angel",579
"15889",2020,21,255,416,428,"51.52557531","-0.179592915","Clifton Road, Maida Vale",844
"15890",2020,21,256,60,59,"51.51362054","-0.116764211","Houghton Street, Strand",119
"15891",2020,21,257,314,312,"51.52248185","-0.154907218","Westminster University, Marylebone",626
"15892",2020,21,259,293,303,"51.490959","-0.1532331","Bourne Street, Belgravia",596
"15893",2020,21,260,210,204,"51.5136846","-0.135580879","Broadwick Street, Soho",414
"15894",2020,21,261,197,195,"51.5134891","-0.191351186","Princes Square, Bayswater",392
"15895",2020,21,262,218,227,"51.49874469","-0.103132904","LSBU (Borough Road), Elephant & Castle",445
"15896",2020,21,263,83,83,"51.51422502","-0.080660083","St. Mary Axe, Aldgate",166
"15897",2020,21,264,307,332,"51.52644342","-0.109256828","Tysoe Street, Clerkenwell",639
"15898",2020,21,265,265,260,"51.51595344","-0.169249375","Southwick Street, Paddington",525
"15899",2020,21,266,590,669,"51.50102668","-0.180246101","Queen's Gate (North), Kensington",1259
"15900",2020,21,267,257,247,"51.49206037","-0.132224622","Regency Street, Westminster",504
"15901",2020,21,268,202,189,"51.49320445","-0.144132875","Belgrave Road, Victoria",391
"15902",2020,21,269,303,350,"51.50082346","-0.089740764","Empire Square, The Borough",653
"15903",2020,21,270,671,660,"51.4863434","-0.122492418","Kennington Lane Rail Bridge, Vauxhall",1331
"15904",2020,21,271,663,743,"51.53583617","-0.156285395","London Zoo,  The Regent's Park",1406
"15905",2020,21,272,348,362,"51.50144456","-0.110699309","Baylis Road, Waterloo",710
"15906",2020,21,273,201,200,"51.50613324","-0.114686385","Belvedere Road 1, South Bank",401
"15907",2020,21,274,370,369,"51.49671237","-0.20528437","Warwick Road, Olympia",739
"15908",2020,21,275,156,154,"51.52004497","-0.092176447","Barbican Centre, Barbican",310
"15909",2020,21,276,175,179,"51.50930161","-0.084985356","Lower Thames Street, Monument",354
"15910",2020,21,277,458,449,"51.50315739","-0.191496313","Kensington Church Street, Kensington",907
"15911",2020,21,278,1605,1643,"51.5034938","-0.07962099","Tooley Street, Bermondsey",3248
"15912",2020,21,279,177,148,"51.51862243","-0.176645823","North Wharf Road, Paddington",325
"15913",2020,21,280,287,294,"51.490083","-0.162418","Royal Avenue 2, Chelsea",581
"15914",2020,21,281,209,214,"51.49580589","-0.127575233","Smith Square, Westminster",423
"15915",2020,21,282,597,581,"51.51906446","-0.059642081","Royal London Hospital, Whitechapel",1178
"15916",2020,21,283,61,58,"51.51440928","-0.118478757","Kingsway, Covent Garden",119
"15917",2020,21,284,244,252,"51.49914063","-0.112031483","Lambeth North Station, Waterloo",496
"15918",2020,21,286,216,223,"51.5272947","-0.174653609","St. John's Wood Road, St. John's Wood",439
"15919",2020,21,287,50,42,"51.52367314","-0.128377673","Bedford Way, Bloomsbury",92
"15920",2020,21,288,379,377,"51.49236962","-0.147478734","Elizabeth Bridge, Victoria",756
"15921",2020,21,289,110,107,"51.50923022","-0.151296092","South Audley Street, Mayfair",217
"15922",2020,21,290,453,449,"51.518268","-0.17110323","St Mary's Hospital, Paddington",902
"15923",2020,21,291,368,338,"51.48483991","-0.138089062","Claverton Street, Pimlico",706
"15924",2020,21,292,428,429,"51.49888404","-0.165471605","Montpelier Street, Knightsbridge",857
"15925",2020,21,293,165,149,"51.49815779","-0.209494128","Kensington Olympia Station, Olympia",314
"15926",2020,21,294,480,463,"51.488226","-0.135635511","St. George's Square, Pimlico",943
"15927",2020,21,295,189,164,"51.50029631","-0.092762704","Swan Street, The Borough",353
"15928",2020,21,296,342,348,"51.49363156","-0.190603326","Knaresborough Place, Earl's Court",690
"15929",2020,21,297,93,94,"51.49612799","-0.106000855","Geraldine Street, Elephant & Castle",187
"15930",2020,21,298,993,999,"51.50227992","-0.074189225","Curlew Street, Shad Thames",1992
"15931",2020,21,299,77,74,"51.49398524","-0.136928582","Vincent Square, Westminster",151
"15932",2020,21,300,1760,1755,"51.505014","-0.17306032","Serpentine Car Park, Hyde Park",3515
"15933",2020,21,301,398,415,"51.51475963","-0.148105415","Marylebone Lane, Marylebone",813
"15934",2020,21,302,627,655,"51.466907","-0.216573","Putney Pier, Wandsworth",1282
"15935",2020,21,303,1519,1550,"51.50295379","-0.158456089","Albert Gate, Hyde Park",3069
"15936",2020,21,306,131,132,"51.51816295","-0.135025698","Rathbone Street, Fitzrovia",263
"15937",2020,21,307,1848,1847,"51.50990837","-0.187842717","Black Lion Gate, Kensington Gardens",3695
"15938",2020,21,308,296,295,"51.49907558","-0.085666316","Long Lane , Bermondsey",591
"15939",2020,21,309,277,273,"51.50963123","-0.119047563","Embankment (Savoy), Strand",550
"15940",2020,21,310,231,219,"51.4908679","-0.116911864","Black Prince Road, Vauxhall",450
"15941",2020,21,311,210,211,"51.51918144","-0.140485596","Foley Street, Fitzrovia",421
"15942",2020,21,312,527,497,"51.53088935","-0.176770502","Grove End Road, St. John's Wood",1024
"15943",2020,21,313,208,215,"51.51734403","-0.138072691","Wells Street, Fitzrovia",423
"15944",2020,21,314,288,297,"51.50088934","-0.083159352","Tyers Gate, Bermondsey",585
"15945",2020,21,315,838,844,"51.52536703","-0.153463612","The Tennis Courts, The Regent's Park",1682
"15946",2020,21,316,502,470,NA,NA,NA,972
"15947",2020,21,317,108,160,"51.49679128","-0.093913472","Dickens Square, Borough",268
"15948",2020,21,318,225,227,"51.51004801","-0.138846453","Sackville Street, Mayfair",452
"15949",2020,21,319,285,265,"51.52702563","-0.088542771","Baldwin Street, St. Luke's",550
"15950",2020,21,320,377,353,"51.49357351","-0.139956043","Queen Mother Sports Centre, Victoria",730
"15951",2020,21,321,669,670,"51.49785559","-0.081608045","Bermondsey Street, Bermondsey",1339
"15952",2020,21,322,240,192,"51.526293","-0.073955","Palissy Street, Shoreditch",432
"15953",2020,21,323,75,47,"51.523196","-0.083067","Clifton Street, Shoreditch",122
"15954",2020,21,324,383,361,"51.49652013","-0.101384068","Ontario Street, Elephant & Castle",744
"15955",2020,21,325,67,69,"51.50908747","-0.129697889","St. Martin's Street, West End",136
"15956",2020,21,326,491,458,"51.53266186","-0.099981142","Graham Street, Angel",949
"15957",2020,21,327,125,86,"51.53095","-0.085603","New North Road 1, Hoxton",211
"15958",2020,21,328,167,141,"51.53114","-0.086016","New North Road 2, Hoxton",308
"15959",2020,21,329,1123,1155,"51.53589283","-0.160854428","Prince Albert Road, The Regent's Park",2278
"15960",2020,21,330,208,171,"51.51641749","-0.179135079","Eastbourne Mews, Paddington",379
"15961",2020,21,331,214,205,"51.52085887","-0.089887855","Bunhill Row, Moorgate",419
"15962",2020,21,332,213,220,"51.49334336","-0.194757949","Nevern Place, Earl's Court",433
"15963",2020,21,333,353,330,"51.50860544","-0.193764092","Palace Gardens Terrace, Notting Hill",683
"15964",2020,21,334,174,157,"51.505044","-0.115851","Concert Hall Approach 1, South Bank",331
"15965",2020,21,335,173,176,"51.51196803","-0.120718759","Tavistock Street, Covent Garden",349
"15966",2020,21,336,133,128,"51.504942","-0.115533","Concert Hall Approach 2, South Bank",261
"15967",2020,21,337,241,232,"51.51108452","-0.197524944","Pembridge Villas, Notting Hill",473
"15968",2020,21,338,307,314,"51.51175646","-0.119643424","Wellington Street , Strand",621
"15969",2020,21,339,158,142,"51.5333196","-0.1117812","Risinghill Street, Angel",300
"15970",2020,21,340,249,248,"51.51444134","-0.087587447","Bank of England Museum, Bank",497
"15971",2020,21,341,625,640,"51.50810309","-0.12602103","Craven Street, Strand",1265
"15972",2020,21,343,508,524,"51.53692216","-0.150181444","London Zoo Car Park, The Regent's Park",1032
"15973",2020,21,344,95,79,"51.528246","-0.10102611","Goswell Road (City Uni), Finsbury",174
"15974",2020,21,345,352,406,"51.48802358","-0.166878535","Flood Street, Chelsea",758
"15975",2020,21,347,271,275,"51.50013942","-0.113936001","Lower Marsh, Waterloo",546
"15976",2020,21,348,310,339,"51.51217033","-0.150481272","Grosvenor Square, Mayfair",649
"15977",2020,21,349,139,147,"51.51196","-0.142783033","St. George Street, Mayfair",286
"15978",2020,21,350,1187,1196,"51.5017154373867","-0.1798541843891","Queen's Gate, Kensington Gardens",2383
"15979",2020,21,351,255,258,"51.529423","-0.097122","Macclesfield Rd, St Lukes",513
"15980",2020,21,352,213,219,"51.486965","-0.116625","Vauxhall Street, Vauxhall",432
"15981",2020,21,353,108,99,"51.49459148","-0.134234258","Greycoat Street , Westminster",207
"15982",2020,21,354,390,378,"51.506767","-0.123702","Northumberland Avenue, Strand",768
"15983",2020,21,356,590,586,"51.494412","-0.173881","South Kensington Station, South Kensington",1176
"15984",2020,21,357,192,201,"51.520994","-0.139016","Howland Street, Fitzrovia",393
"15985",2020,21,358,106,106,"51.516226","-0.124826","High Holborn , Covent Garden",212
"15986",2020,21,359,180,180,"51.49782999","-0.135440826","Butler Place, Westminster",360
"15987",2020,21,360,163,159,"51.49675303","-0.138733562","Howick Place, Westminster",322
"15988",2020,21,361,112,77,"51.50391973","-0.11342629","Waterloo Station 2, Waterloo",189
"15989",2020,21,362,221,204,"51.536264","-0.133952","Royal College Street, Camden Town",425
"15990",2020,21,363,89,89,"51.5291212008901","-0.171185284853","Lord's, St. John's Wood",178
"15991",2020,21,364,109,113,"51.519656","-0.132339","Alfred Place, Bloomsbury",222
"15992",2020,21,365,170,152,"51.530344","-0.100168","City Road, Angel",322
"15993",2020,21,366,99,87,"51.5109192966489","-0.1511263847351","Millennium Hotel, Mayfair",186
"15994",2020,21,367,343,346,"51.5173721","-0.1642075","Harrowby Street, Marylebone",689
"15995",2020,21,368,394,377,"51.50024195","-0.15934065","Harriet Street, Knightsbridge",771
"15996",2020,21,370,119,105,"51.520205","-0.174593","Paddington Green, Paddington",224
"15997",2020,21,371,91,86,"51.49775","-0.10988","King Edward Walk, Waterloo",177
"15998",2020,21,372,40,33,"51.515208","-0.117863","Sardinia Street, Holborn",73
"15999",2020,21,373,74,53,"51.49980661","-0.176415994","Prince Consort Road, Knightsbridge",127
"16000",2020,21,374,354,388,"51.50402794","-0.11386436","Waterloo Station 1, Waterloo",742
"16001",2020,21,375,166,165,"51.50194596","-0.194392952","Kensington Town Hall, Kensington",331
"16002",2020,21,376,352,359,"51.49188409","-0.125674815","Millbank Tower, Pimlico",711
"16003",2020,21,377,133,124,"51.50535447","-0.113656543","Waterloo Bridge, South Bank",257
"16004",2020,21,378,76,89,"51.49559291","-0.179077626","Natural History Museum, South Kensington",165
"16005",2020,21,379,314,322,"51.51431171","-0.200838199","Turquoise Island, Notting Hill",636
"16006",2020,21,380,115,112,"51.50686435","-0.150666888","Stanhope Gate, Mayfair",227
"16007",2020,21,381,262,270,"51.51953043","-0.13577731","Charlotte Street, Fitzrovia",532
"16008",2020,21,382,126,126,"51.50935171","-0.14744969","Farm Street, Mayfair",252
"16009",2020,21,383,341,343,"51.51310333","-0.13121385","Frith Street, Soho",684
"16010",2020,21,384,200,188,"51.496481","-0.192404","Marloes Road, Kensington",388
"16011",2020,21,386,462,468,"51.51352755","-0.130110822","Moor Street, Soho",930
"16012",2020,21,387,497,479,"51.49369988","-0.121394101","Fire Brigade Pier, Vauxhall",976
"16013",2020,21,388,273,278,"51.51070161","-0.121723604","Southampton Street, Strand",551
"16014",2020,21,389,136,134,"51.51013066","-0.155757901","Upper Grosvenor Street, Mayfair",270
"16015",2020,21,390,159,154,"51.521776","-0.068856","Buxton Street 1, Shoreditch",313
"16016",2020,21,392,301,290,"51.49942855","-0.179702476","Imperial College, Knightsbridge",591
"16017",2020,21,393,112,110,"51.51733427","-0.103604248","Snow Hill, Farringdon",222
"16018",2020,21,394,221,199,"51.524826","-0.176268","Aberdeen Place, St. John's Wood",420
"16019",2020,21,395,310,326,"51.492462","-0.159919","Cadogan Gardens, Chelsea",636
"16020",2020,21,396,262,250,"51.51809","-0.163609","Shouldham Street, Marylebone",512
"16021",2020,21,397,522,504,"51.51348","-0.17977","Devonshire Terrace, Bayswater",1026
"16022",2020,21,398,483,453,"51.502319","-0.200742","Holland Park, Kensington",936
"16023",2020,21,399,365,379,"51.52261762","-0.071653961","Brick Lane Market, Shoreditch",744
"16024",2020,21,400,249,234,"51.517703","-0.154106","George Street, Marylebone",483
"16025",2020,21,401,378,372,"51.528187","-0.075375","Columbia Road, Shoreditch",750
"16026",2020,21,402,159,160,"51.52289229","-0.171681991","Penfold Street, Marylebone",319
"16027",2020,21,403,249,247,"51.51689296","-0.158249929","George Place Mews, Marylebone",496
"16028",2020,21,404,1378,1384,"51.50204238","-0.184400221","Palace Gate, Kensington Gardens",2762
"16029",2020,21,405,544,553,"51.49418566","-0.18267094","Gloucester Road Station, South Kensington",1097
"16030",2020,21,409,581,636,"51.493146","-0.099828","Strata, Elephant & Castle",1217
"16031",2020,21,410,353,388,"51.519968","-0.169774","Edgware Road Station, Marylebone",741
"16032",2020,21,411,749,772,"51.49337264","-0.09968067","Walworth Road, Elephant & Castle",1521
"16033",2020,21,412,192,195,"51.488105","-0.110121","Cleaver Street, Kennington",387
"16034",2020,21,419,731,715,"51.485821","-0.149004","Chelsea Bridge, Pimlico",1446
"16035",2020,21,420,167,155,"51.504043","-0.105312","Southwark Station 1, Southwark",322
"16036",2020,21,421,107,102,"51.504044","-0.104778","Southwark Station 2, Southwark",209
"16037",2020,21,423,355,325,"51.49456127","-0.15393398","Eaton Square (South), Belgravia",680
"16038",2020,21,424,317,297,"51.490491","-0.149186","Ebury Bridge, Pimlico",614
"16039",2020,21,425,165,168,"51.533379","-0.139159","Harrington Square 2, Camden Town",333
"16040",2020,21,426,271,272,"51.493072","-0.129925","Vincent Street, Pimlico",543
"16041",2020,21,427,490,476,"51.51397065","-0.09294031","Cheapside, Bank",966
"16042",2020,21,428,487,487,"51.499917","-0.174554","Exhibition Road, Knightsbridge",974
"16043",2020,21,430,213,198,"51.48902","-0.17524","South Parade, Chelsea",411
"16044",2020,21,431,164,158,"51.534474","-0.122203","Crinan Street, King's Cross",322
"16045",2020,21,432,155,156,"51.496957","-0.173894","Exhibition Road Museums, South Kensington",311
"16046",2020,21,433,219,185,"51.524564","-0.116279","Wren Street, Holborn",404
"16047",2020,21,435,350,344,"51.488852","-0.105593","Kennington Station, Kennington",694
"16048",2020,21,436,223,206,"51.51824","-0.11655","Red Lion Street, Holborn",429
"16049",2020,21,437,257,274,"51.488124","-0.120903","Vauxhall Walk, Vauxhall",531
"16050",2020,21,439,96,90,"51.5338","-0.118677","Killick Street, King's Cross",186
"16051",2020,21,440,504,513,"51.483145","-0.113134","Kennington Oval, Oval",1017
"16052",2020,21,441,275,261,"51.495656","-0.114605","Sail Street, Vauxhall",536
"16053",2020,21,442,195,189,"51.510101","-0.211358","Walmer Road, Avondale",384
"16054",2020,21,443,241,257,"51.515256","-0.058641","Philpot Street, Whitechapel",498
"16055",2020,21,444,212,232,"51.52568","-0.055312","Bethnal Green Garden, Bethnal Green",444
"16056",2020,21,445,225,223,"51.52388","-0.065076","Cheshire Street, Bethnal Green",448
"16057",2020,21,446,271,293,"51.528936","-0.055894","York Hall, Bethnal Green",564
"16058",2020,21,447,161,156,"51.493381","-0.007542","Jubilee Crescent, Cubitt Town",317
"16059",2020,21,448,427,417,"51.50623","-0.02296","Fisherman's Walk West, Canary Wharf",844
"16060",2020,21,449,507,500,"51.511088","-0.057159","Shadwell Station, Shadwell",1007
"16061",2020,21,450,288,248,"51.515975","-0.053177","Jubilee Street, Stepney",536
"16062",2020,21,451,252,251,"51.504719","-0.063531","Hermitage Court, Wapping",503
"16063",2020,21,452,449,389,"51.505697","-0.070542","St. Katharine's Way, Tower",838
"16064",2020,21,453,330,302,"51.508447","-0.055167","Garnet Street, Shadwell",632
"16065",2020,21,454,287,289,"51.487679","-0.021582","Napier Avenue, Millwall",576
"16066",2020,21,455,291,299,"51.49447","-0.014409","East Ferry Road, Cubitt Town",590
"16067",2020,21,456,362,424,"51.538071","-0.144664","Parkway, Camden Town",786
"16068",2020,21,457,545,541,"51.542138","-0.145393","Castlehaven Road, Camden Town",1086
"16069",2020,21,458,386,373,"51.504749","-0.057544","Wapping Lane, Wapping",759
"16070",2020,21,459,454,471,"51.535179","-0.03338","Gunmakers Lane, Old Ford",925
"16071",2020,21,460,361,342,"51.516196","-0.029138","Burdett Road, Mile End",703
"16072",2020,21,461,148,140,"51.516","-0.038775","Aston Street, Stepney",288
"16073",2020,21,462,630,657,"51.541603","-0.138853","Bonny Street, Camden Town",1287
"16074",2020,21,463,149,139,"51.534776","-0.071881","Thurtle Road, Haggerston",288
"16075",2020,21,464,81,72,"51.51417","-0.052099","St. Mary & St. Michael Church, Stepney",153
"16076",2020,21,465,293,270,"51.53558","-0.08249","Pitfield Street North,Hoxton",563
"16077",2020,21,466,217,209,"51.534464","-0.076341","Whiston Road, Haggerston",426
"16078",2020,21,467,232,217,"51.523538","-0.030556","Southern Grove, Bow",449
"16079",2020,21,468,173,120,"51.521564","-0.022694","Cantrell Road, Bow",293
"16080",2020,21,469,232,222,"51.513757","-0.020467","Lindfield Street, Poplar",454
"16081",2020,21,470,280,253,"51.530535","-0.025492","Mostyn Grove, Bow",533
"16082",2020,21,471,158,160,"51.533283","-0.028155","Hewison Street, Old Ford",318
"16083",2020,21,472,84,64,"51.529452","-0.027616","Malmesbury Road, Bow",148
"16084",2020,21,473,198,187,"51.496137","-0.019355","Millharbour, Millwall",385
"16085",2020,21,475,410,429,"51.499041","-0.020157","Lightermans Road, Millwall",839
"16086",2020,21,476,285,279,"51.489096","-0.009205","Stebondale Street, Cubitt Town",564
"16087",2020,21,477,254,254,"51.49109","-0.018716","Spindrift Avenue, Millwall",508
"16088",2020,21,478,428,422,"51.521889","-0.04667","Stepney Green Station, Stepney",850
"16089",2020,21,479,395,383,"51.527152","-0.058005","Pott Street, Bethnal Green",778
"16090",2020,21,480,761,745,"51.5128711","-0.0389866","Flamborough Street, Limehouse",1506
"16091",2020,21,481,1056,1153,"51.487129","-0.009001","Saunders Ness Road, Cubitt Town",2209
"16092",2020,21,483,358,324,"51.51328","-0.047784","Albert Gardens, Stepney",682
"16093",2020,21,484,281,279,"51.528828","-0.013258","Bromley High Street, Bow",560
"16094",2020,21,485,381,399,"51.531127","-0.048017","Old Ford Road, Bethnal Green",780
"16095",2020,21,486,403,423,"51.525645","-0.069543","Granby Street, Shoreditch",826
"16096",2020,21,487,264,236,"51.511811","-0.025626","Canton Street, Poplar",500
"16097",2020,21,488,233,239,"51.506946","-0.058681","Reardon Street, Wapping",472
"16098",2020,21,489,270,233,"51.513074","-0.064094","Christian Street, Whitechapel",503
"16099",2020,21,490,117,100,"51.508622","-0.065006","Pennington Street, Wapping",217
"16100",2020,21,491,253,229,"51.522507","-0.041378","Queen Mary's, Mile End",482
"16101",2020,21,492,401,415,"51.525501","-0.032267204","Maplin Street, Mile End",816
"16102",2020,21,494,38,26,"51.50196","-0.016251","South Quay East, Canary Wharf",64
"16103",2020,21,495,592,561,"51.528169","-0.018703","Bow Church Station, Bow",1153
"16104",2020,21,496,414,386,"51.52512","-0.015578","Devons Road, Bow",800
"16105",2020,21,497,209,183,"51.526149","-0.027396845","Merchant Street, Bow",392
"16106",2020,21,498,383,340,"51.527058","-0.025296","Bow Road Station, Bow",723
"16107",2020,21,499,408,405,"51.519265","-0.021345","Furze Green, Bow",813
"16108",2020,21,500,514,493,"51.519806","-0.055731","Ansell House, Stepney",1007
"16109",2020,21,501,304,275,"51.522561","-0.054883","Cephas Street, Bethnal Green",579
"16110",2020,21,502,790,824,"51.53341","-0.049591815","Bonner Gate, Victoria Park",1614
"16111",2020,21,503,405,408,"51.520893","-0.051394","Cleveland Way, Stepney",813
"16112",2020,21,504,173,156,"51.496454","-0.009506","St. John's Park, Cubitt Town",329
"16113",2020,21,505,242,214,"51.520398","-0.026768","Ackroyd Drive, Bow",456
"16114",2020,21,506,270,271,"51.517475","-0.075855","Bell Lane, Liverpool Street",541
"16115",2020,21,507,140,125,"51.528692","-0.059091","Clarkson Street, Bethnal Green",265
"16116",2020,21,508,287,286,"51.519362","-0.074431","Fournier Street, Whitechapel",573
"16117",2020,21,509,45,40,"51.517842","-0.090075","Fore Street, Guildhall",85
"16118",2020,21,510,634,696,"51.509303","-0.025996","Westferry DLR, Limehouse",1330
"16119",2020,21,511,597,595,"51.511066","-0.053558","Sutton Street, Shadwell",1192
"16120",2020,21,512,377,390,"51.532091","-0.06142","Pritchard's Road, Bethnal Green",767
"16121",2020,21,513,276,253,"51.5142228","-0.055656","Watney Market, Stepney",529
"16122",2020,21,514,197,196,"51.516204","-0.155525","Portman Square, Marylebone",393
"16123",2020,21,515,146,150,"51.500088","-0.211316","Russell Gardens, Olympia",296
"16124",2020,21,516,310,291,"51.5112","-0.014438","Chrisp Street Market, Poplar",601
"16125",2020,21,517,240,246,"51.532513","-0.033085","Ford Road, Old Ford",486
"16126",2020,21,518,334,330,"51.528224","-0.037471","Antill Road, Mile End",664
"16127",2020,21,519,135,123,"51.518811","-0.011662","Teviot Street, Poplar",258
"16128",2020,21,520,212,191,"51.526041","-0.047218","Bancroft Road, Bethnal Green",403
"16129",2020,21,521,522,543,"51.534137","-0.037366","Driffield Road, Old Ford",1065
"16130",2020,21,522,484,489,"51.525941","-0.036017","Clinton Road, Mile End",973
"16131",2020,21,523,197,193,"51.51549","-0.013475","Langdon Park, Poplar",390
"16132",2020,21,524,377,316,"51.511654","-0.179668","Lancaster Gate , Bayswater",693
"16133",2020,21,526,188,191,"51.503143","-0.008428","Lancaster Drive, Blackwall",379
"16134",2020,21,527,237,268,"51.503802","-0.215808","Hansard Mews, Holland Park",505
"16135",2020,21,528,77,75,"51.507326","-0.145827","Clarges Street, Mayfair",152
"16136",2020,21,529,279,261,"51.486892","-0.170983","Manresa Road, Chelsea",540
"16137",2020,21,530,258,260,"51.508896","-0.012413","Newby Place, Poplar",518
"16138",2020,21,531,487,459,"51.530326","-0.042744","Twig Folly Bridge, Mile End",946
"16139",2020,21,532,372,378,"51.50357","-0.020068","Jubilee Plaza, Canary Wharf",750
"16140",2020,21,533,215,194,"51.528222","-0.069743","Wellington Row, Bethnal Green",409
"16141",2020,21,534,445,455,"51.531864","-0.066035","Goldsmith's Row, Haggerston",900
"16142",2020,21,535,527,513,"51.537349","-0.147154","Gloucester Avenue, Camden Town",1040
"16143",2020,21,536,224,225,"51.53385","-0.06992","Queensbridge Road, Haggerston",449
"16144",2020,21,537,371,361,"51.51793","-0.067937","Old Montague Street, Whitechapel",732
"16145",2020,21,538,273,276,"51.508981","-0.00699","Naval Row, Blackwall",549
"16146",2020,21,540,548,532,"51.528302","-0.144466","Albany Street, The Regent's Park",1080
"16147",2020,21,541,1052,1054,"51.506613","-0.142844","Green Park Station, Mayfair",2106
"16148",2020,21,542,485,461,"51.514115","-0.033828","Salmon Lane, Limehouse",946
"16149",2020,21,543,122,119,"51.509591","-0.204666","Lansdowne Walk, Ladbroke Grove",241
"16150",2020,21,544,156,156,"51.526153","-0.102208","Percival Street, Finsbury",312
"16151",2020,21,545,277,268,"51.539957","-0.145246","Arlington Road, Camden Town",545
"16152",2020,21,546,190,185,"51.517428","-0.107987","New Fetter Lane, Holborn",375
"16153",2020,21,547,677,733,"51.509474","-0.002275","East India DLR, Blackwall",1410
"16154",2020,21,548,73,68,"51.498386","-0.107913","Westminster Bridge Road, Elephant & Castle",141
"16155",2020,21,549,262,223,"51.49605","-0.104193","Gaywood  Street, Elephant & Castle",485
"16156",2020,21,550,200,176,"51.521564","-0.039264","Harford Street, Mile End",376
"16157",2020,21,551,101,98,"51.505772","-0.016460175","Import Dock, Canary Wharf",199
"16158",2020,21,552,241,228,"51.511542","-0.056667","Watney Street, Shadwell",469
"16159",2020,21,553,1413,1441,"51.535678","-0.062546","Regent's Row , Haggerston",2854
"16160",2020,21,554,174,179,"51.513548","-0.005659","Aberfeldy Street, Poplar",353
"16161",2020,21,556,148,138,"51.502661","-0.021596","Heron Quays DLR, Canary Wharf",286
"16162",2020,21,557,151,149,"51.51601","-0.0985","King Edward Street, St Pauls",300
"16163",2020,21,558,247,269,"51.493978","-0.127554","Page Street, Westminster",516
"16164",2020,21,559,249,258,"51.501391","-0.205991","Abbotsbury Road, Holland Park",507
"16165",2020,21,560,125,75,"51.511624","-0.205921","Ladbroke Grove Central, Ladbroke Grove",200
"16166",2020,21,561,209,220,"51.518369","-0.043371","Rectory Square, Stepney",429
"16167",2020,21,562,148,141,"51.51746","-0.12335","Bury Place, Holborn",289
"16168",2020,21,563,165,156,"51.499286","-0.009152","Preston's Road, Cubitt Town",321
"16169",2020,21,564,991,1054,"51.509943","-0.117619","Somerset House, Strand",2045
"16170",2020,21,565,94,86,"51.521905","-0.063386","Selby Street, Whitechapel",180
"16171",2020,21,566,415,444,"51.509158","-0.224103","Westfield Ariel Way, White City",859
"16172",2020,21,568,470,475,"51.51616","-0.18697","Bishop's Bridge Road West, Bayswater",945
"16173",2020,21,569,245,235,"51.53213","-0.08299","Pitfield Street Central, Hoxton",480
"16174",2020,21,570,424,413,"51.503083","-0.017676","Upper Bank Street, Canary Wharf",837
"16175",2020,21,571,161,169,"51.506256","-0.218337","Westfield Southern Terrace ,Shepherd's Bush",330
"16176",2020,21,572,417,469,"51.539099","-0.141728","Greenland Road, Camden Town",886
"16177",2020,21,573,522,518,"51.485587","-0.18119","Limerston Street, West Chelsea",1040
"16178",2020,21,574,484,442,"51.53356","-0.09315","Eagle Wharf Road, Hoxton",926
"16179",2020,21,576,268,287,"51.497304","-0.022793","Alpha Grove, Millwall",555
"16180",2020,21,577,393,390,"51.528869","-0.047548","Globe Town Market, Bethnal Green",783
"16181",2020,21,578,111,105,"51.527607","-0.057133","Hollybush Gardens, Bethnal Green",216
"16182",2020,21,579,706,734,"51.511246","-0.093051","Queen Street 2, Bank",1440
"16183",2020,21,580,487,493,"51.48692917","-0.102996299","Doddington Grove, Kennington",980
"16184",2020,21,581,307,307,"51.519167","-0.147983","New Cavendish Street, Marylebone",614
"16185",2020,21,583,549,579,"51.497622","-0.125978","Abingdon Green, Westminster",1128
"16186",2020,21,584,281,281,"51.51244","-0.19096","Ilchester Gardens, Bayswater",562
"16187",2020,21,586,157,162,"51.490645","-0.014582","Mudchute DLR, Cubitt Town",319
"16188",2020,21,587,504,501,"51.50964","-0.08497","Monument Street, Monument",1005
"16189",2020,21,588,209,184,"51.52959","-0.0801","Hoxton Street, Hoxton",393
"16190",2020,21,589,580,603,"51.487196","-0.179369","Drayton Gardens, West Chelsea",1183
"16191",2020,21,590,140,128,"51.53256","-0.16862","Greenberry Street, St.John's Wood",268
"16192",2020,21,592,194,174,"51.5171","-0.18377","Bishop's Bridge Road East, Bayswater",368
"16193",2020,21,593,148,150,"51.531066","-0.11934","Northdown Street, King's Cross",298
"16194",2020,21,594,64,64,"51.513875","-0.117774","Kingsway Southbound, Strand",128
"16195",2020,21,595,274,287,"51.493267","-0.21985","Hammersmith Road, Hammersmith",561
"16196",2020,21,596,530,525,"51.472817","-0.199783","Parson's Green , Parson's Green",1055
"16197",2020,21,597,301,300,"51.473471","-0.20782","Fulham Park Road, Fulham",601
"16198",2020,21,598,422,450,"51.494499","-0.228188","Southerton Road, Hammersmith",872
"16199",2020,21,599,193,201,"51.485743","-0.223616","Manbre Road, Hammersmith",394
"16200",2020,21,600,571,585,"51.481747","-0.124642","South Lambeth Road, Vauxhall",1156
"16201",2020,21,601,427,456,"51.514767","-0.225787","BBC White City, White City",883
"16202",2020,21,602,450,468,"51.472993","-0.133972","Union Grove, Wandsworth Road",918
"16203",2020,21,603,459,481,"51.477839","-0.116493","Caldwell Street, Stockwell",940
"16204",2020,21,604,135,131,"51.538792","-0.138535","St Martins Close, Camden Town",266
"16205",2020,21,605,271,277,"51.520331","-0.163667","Seymour Place, Marylebone",548
"16206",2020,21,606,158,143,"51.504199","-0.210941","Addison Road, Holland Park",301
"16207",2020,21,607,345,356,"51.468814","-0.210279","Putney Bridge Station, Fulham",701
"16208",2020,21,608,49,44,"51.491093","-0.216493","Colet Gardens, Hammersmith",93
"16209",2020,21,609,292,304,"51.46512358","-0.157788279","Sugden Road, Clapham",596
"16210",2020,21,610,641,621,"51.48256792","-0.172078187","Danvers Street, West Chelsea",1262
"16211",2020,21,611,325,326,"51.50646524","-0.208486599","Princedale Road , Holland Park",651
"16212",2020,21,612,549,563,"51.46925984","-0.141812513","Wandsworth Rd, Isley Court, Wandsworth Road",1112
"16213",2020,21,613,453,456,"51.50403821","-0.217400093","Woodstock Grove, Shepherd's Bush",909
"16214",2020,21,614,182,185,"51.47817208","-0.144690541","Bradmead, Battersea Park",367
"16215",2020,21,615,396,400,"51.4768851","-0.215895601","Finlay Street, Fulham",796
"16216",2020,21,616,327,320,"51.48102131","-0.209973497","Aintree Street, Fulham",647
"16217",2020,21,617,156,152,"51.47107905","-0.207842908","Elysium Place, Fulham",308
"16218",2020,21,618,510,498,"51.47625965","-0.193254007","Eel Brook Common, Walham Green",1008
"16219",2020,21,619,275,295,"51.4737636","-0.197010096","Irene Road, Parsons Green",570
"16220",2020,21,620,272,297,"51.47518024","-0.167160736","Surrey Lane, Battersea",569
"16221",2020,21,621,349,358,"51.46086446","-0.187427294","Wandsworth Town Station, Wandsworth",707
"16222",2020,21,622,429,437,"51.50748124","-0.205535908","Lansdowne Road, Ladbroke Grove",866
"16223",2020,21,623,192,211,"51.46193072","-0.180791784","Nantes Close, Wandsworth",403
"16224",2020,21,624,446,451,"51.4729184","-0.132102704","Courland Grove, Wandsworth Road",897
"16225",2020,21,625,1501,1543,"51.47761941","-0.149551631","Queen's Circus, Battersea Park",3044
"16226",2020,21,626,466,448,"51.48438657","-0.20481514","Normand Park, West Kensington",914
"16227",2020,21,627,159,165,"51.4687905","-0.158230901","Holden Street, Battersea",324
"16228",2020,21,628,308,308,"51.46881971","-0.184318843","William Morris Way, Sands End",616
"16229",2020,21,629,117,117,"51.45995384","-0.190184054","Morie Street, Wandsworth",234
"16230",2020,21,630,364,355,"51.47073264","-0.126994068","Clarence Walk, Stockwell",719
"16231",2020,21,631,273,267,"51.4795017","-0.141770709","Battersea Park Road, Nine Elms",540
"16232",2020,21,632,155,161,"51.47053858","-0.163041605","Sheepcote Lane, Battersea",316
"16233",2020,21,633,505,479,"51.48959104","-0.209378594","Vereker Road, West Kensington",984
"16234",2020,21,634,222,229,"51.49434708","-0.215804559","Brook Green South, Brook Green",451
"16235",2020,21,635,363,344,"51.48606206","-0.214428378","Greyhound Road, Hammersmith",707
"16236",2020,21,636,182,169,"51.46706414","-0.193502076","South Park, Sands End",351
"16237",2020,21,637,454,463,"51.45787019","-0.174691623","Spencer Park, Wandsworth Common",917
"16238",2020,21,638,351,374,"51.46663393","-0.169821175","Falcon Road, Clapham Junction",725
"16239",2020,21,639,277,272,"51.48357068","-0.202038682","Coomer Place, West Kensington",549
"16240",2020,21,640,356,373,"51.47286577","-0.148059277","Silverthorne Road, Battersea",729
"16241",2020,21,641,278,268,"51.49824168","-0.117495865","Archbishop's Park, Waterloo",546
"16242",2020,21,642,180,172,"51.46916161","-0.174485792","Fawcett Close, Battersea",352
"16243",2020,21,643,311,302,"51.5190427","-0.204764421","All Saints' Road, Portobello",613
"16244",2020,21,644,310,304,"51.48373225","-0.223852256","Rainville Road, Hammersmith",614
"16245",2020,21,645,126,127,"51.50173215","-0.100292412","Great Suffolk Street, The Borough",253
"16246",2020,21,646,445,454,"51.49886563","-0.137424571","Buckingham Gate, Westminster",899
"16247",2020,21,647,347,364,"51.50035306","-0.217515071","Richmond Way, Shepherd's Bush",711
"16248",2020,21,648,192,180,"51.46904022","-0.19627483","Peterborough Road, Sands End",372
"16249",2020,21,649,433,431,"51.48180515","-0.18027465","World's End Place, West Chelsea",864
"16250",2020,21,650,446,448,"51.51687069","-0.213872396","St. Mark's Road, North Kensington",894
"16251",2020,21,651,166,182,"51.48089844","-0.183853573","Thorndike Close, West Chelsea",348
"16252",2020,21,652,110,97,"51.51148696","-0.218190203","Evesham Street, Avondale",207
"16253",2020,21,653,404,410,"51.47084722","-0.17070367","Simpson Street, Clapham Junction",814
"16254",2020,21,654,292,284,"51.48267821","-0.117661574","Ashmole Estate, Oval",576
"16255",2020,21,655,210,210,"51.48294452","-0.219346128","Crabtree Lane, Fulham",420
"16256",2020,21,656,112,106,"51.46841875","-0.199135704","Broomhouse Lane, Parsons Green",218
"16257",2020,21,657,287,296,"51.4996806","-0.221791552","Blythe Road West, Shepherd's Bush",583
"16258",2020,21,658,1374,1420,"51.47729232","-0.16478637","Ethelburga Estate, Battersea Park",2794
"16259",2020,21,659,323,309,"51.511934","-0.10307894","Blackfriars Station, St. Paul's",632
"16260",2020,21,660,268,271,"51.49087074","-0.206029743","West Kensington Station, West Kensington",539
"16261",2020,21,661,500,513,"51.51632095","-0.202608612","All Saints Church, Portobello",1013
"16262",2020,21,662,447,420,"51.48498496","-0.167919869","Phene Street, Chelsea",867
"16263",2020,21,663,210,206,"51.51323001","-0.211593602","Clarendon Road, Avondale",416
"16264",2020,21,664,411,425,"51.474376","-0.155442787","Austin Road, Battersea Park",836
"16265",2020,21,665,284,290,"51.46108367","-0.191722864","Smugglers Way, Wandsworth",574
"16266",2020,21,666,366,349,"51.49610093","-0.208158259","Olympia Way, Olympia",715
"16267",2020,21,667,437,449,"51.5015946","-0.222293381","Shepherd's Bush Road North, Shepherd's Bush",886
"16268",2020,21,668,946,966,"51.49422354","-0.236769936","Ravenscourt Park Station, Hammersmith",1912
"16269",2020,21,669,238,249,"51.47614939","-0.1232585","Teversham Lane, Stockwell",487
"16270",2020,21,670,383,390,"51.46718562","-0.152248582","Ashley Crescent, Battersea",773
"16271",2020,21,671,277,277,"51.475089","-0.201968","Parsons Green Station, Parsons Green",554
"16272",2020,21,673,466,479,"51.46517078","-0.18038939","Hibbert Street, Battersea",945
"16273",2020,21,674,269,238,"51.53546778","-0.11619105","Carnegie Street, King's Cross",507
"16274",2020,21,675,242,266,"51.46348914","-0.182126248","Usk Road, Clapham Junction",508
"16275",2020,21,676,437,442,"51.47787084","-0.126874471","Hartington Road, Stockwell",879
"16276",2020,21,677,180,206,"51.46866929","-0.146544642","Heath Road, Battersea",386
"16277",2020,21,678,86,132,"51.46231278","-0.211468596","Esmond Street, Putney",218
"16278",2020,21,679,151,157,"51.47453545","-0.170210533","Orbel Street, Battersea",308
"16279",2020,21,680,467,494,"51.47768469","-0.170329317","Westbridge Road, Battersea",961
"16280",2020,21,681,502,537,"51.47303687","-0.214749808","Bishop's Avenue, Fulham",1039
"16281",2020,21,682,680,703,"51.48810829","-0.22660621","Crisp Road, Hammersmith",1383
"16282",2020,21,683,295,314,"51.46506424","-0.163750945","Dorothy Road, Clapham Junction",609
"16283",2020,21,684,489,522,"51.45475251","-0.195197203","Neville Gill Close, Wandsworth",1011
"16284",2020,21,685,329,334,"51.46067005","-0.198735357","Osiers Road, Wandsworth",663
"16285",2020,21,686,230,235,"51.48814438","-0.222456468","Beryl Road, Hammersmith",465
"16286",2020,21,687,349,347,"51.49760804","-0.21145598","Maclise Road, Olympia",696
"16287",2020,21,688,238,264,"51.46095151","-0.20066766","Northfields, Wandsworth",502
"16288",2020,21,689,185,186,"51.45922541","-0.180884959","Spanish Road, Clapham Junction",371
"16289",2020,21,690,175,163,"51.47047503","-0.152130083","Stanley Grove, Battersea",338
"16290",2020,21,691,568,581,"51.47946386","-0.195777222","Erin Close, Walham Green",1149
"16291",2020,21,692,752,772,"51.54211855","-0.028941601","Cadogan Close, Victoria Park",1524
"16292",2020,21,693,229,241,"51.464786","-0.215618902","Felsham Road, Putney",470
"16293",2020,21,694,359,390,"51.46071722","-0.216526155","Putney Rail Station, Putney",749
"16294",2020,21,695,1095,1106,"51.53638435","-0.102757578","Islington Green, Angel",2201
"16295",2020,21,696,201,200,"51.48728535","-0.217995921","Charing Cross Hospital, Hammersmith",401
"16296",2020,21,697,315,285,"51.53639219","-0.112721065","Charlotte Terrace, Angel",600
"16297",2020,21,698,456,457,"51.53908372","-0.070329419","Shoreditch Court, Haggerston",913
"16298",2020,21,699,227,230,"51.5366541","-0.07023031","Belford House, Haggerston",457
"16299",2020,21,700,300,278,"51.47696496","-0.174347066","Battersea Church Road, Battersea",578
"16300",2020,21,701,443,439,"51.47287627","-0.176267008","Vicarage Crescent, Battersea",882
"16301",2020,21,702,228,211,"51.52868155","-0.065550321","Durant Street, Bethnal Green",439
"16302",2020,21,703,196,188,"51.51505991","-0.10534448","St. Bride Street, Holborn",384
"16303",2020,21,704,201,205,"51.45682071","-0.202802098","Mexfield Road, East Putney",406
"16304",2020,21,705,288,283,NA,NA,NA,571
"16305",2020,21,706,361,370,"51.50215353","-0.083632928","Snowsfields, London Bridge",731
"16306",2020,21,707,221,227,"51.49021762","-0.215087092","Barons Court Station, West Kensington",448
"16307",2020,21,708,229,223,"51.46161068","-0.21614583","Disraeli Road, Putney",452
"16308",2020,21,709,183,236,"51.46321128","-0.215550761","Montserrat Road , Putney",419
"16309",2020,21,710,725,739,"51.47439218","-0.163347594","Albert Bridge Road, Battersea Park",1464
"16310",2020,21,711,238,227,"51.48335692","-0.216305546","Everington Street, Fulham",465
"16311",2020,21,712,384,360,"51.51854104","-0.034903714","Mile End Stadium, Mile End",744
"16312",2020,21,713,300,306,"51.54100708","-0.14326094","Hawley Crescent, Camden Town",606
"16313",2020,21,714,149,142,"51.47311696","-0.137235175","Stewart's Road, Wandsworth Road",291
"16314",2020,21,715,156,142,"51.51563007","-0.049067243","Aylward Street, Stepney",298
"16315",2020,21,716,275,262,"51.51542791","-0.02356501","Stainsby Road , Poplar",537
"16316",2020,21,717,629,645,"51.53658514","-0.075885686","Dunston Road , Haggerston",1274
"16317",2020,21,718,332,347,"51.53571683","-0.060291813","Ada Street, Hackney Central",679
"16318",2020,21,719,795,822,"51.53642464","-0.054162264","Victoria Park Road, Hackney Central",1617
"16319",2020,21,720,306,281,"51.48724429","-0.205279052","Star Road, West Kensington",587
"16320",2020,21,721,270,270,"51.53603947","-0.026262677","Wendon Street, Old Ford",540
"16321",2020,21,722,206,201,"51.52458353","-0.058631453","Finnis Street, Bethnal Green",407
"16322",2020,21,723,506,523,"51.46822047","-0.190346493","Stephendale Road, Sands End",1029
"16323",2020,21,724,211,197,"51.45799126","-0.184806157","Alma Road, Wandsworth",408
"16324",2020,21,725,462,468,"51.491327","-0.096518684","Walworth Square, Walworth",930
"16325",2020,21,726,334,348,"51.47505096","-0.150908371","Alfreda Street, Battersea Park",682
"16326",2020,21,727,407,412,"51.47569809","-0.20587627","Chesilton Road, Fulham",819
"16327",2020,21,728,295,309,"51.46199911","-0.206240805","Putney Bridge Road, East Putney",604
"16328",2020,21,729,383,362,"51.47893931","-0.208485293","St. Peter's Terrace, Fulham",745
"16329",2020,21,730,585,606,"51.49208492","-0.229116862","Bridge Avenue, Hammersmith",1191
"16330",2020,21,731,175,196,"51.47727637","-0.189210466","Michael Road, Walham Green",371
"16331",2020,21,732,838,892,"51.50630441","-0.087262995","Duke Street Hill, London Bridge",1730
"16332",2020,21,733,230,257,"51.50542628","-0.150817316","Park Lane, Mayfair",487
"16333",2020,21,734,173,171,"51.46230566","-0.175407201","Plough Terrace, Clapham Junction",344
"16334",2020,21,735,190,212,"51.46489445","-0.17302926","Grant Road East, Clapham Junction",402
"16335",2020,21,736,216,222,"51.50659035","-0.216104479","Queensdale Road, Shepherd's Bush",438
"16336",2020,21,737,413,432,"51.47993289","-0.19411695","Fulham Broadway, Walham Green",845
"16337",2020,21,738,235,221,"51.47514228","-0.187278987","Imperial Road, Sands End",456
"16338",2020,21,739,333,330,"51.48176572","-0.185273723","Hortensia Road, West Brompton",663
"16339",2020,21,740,90,88,"51.51092871","-0.214594781","Sirdar Road, Avondale",178
"16340",2020,21,741,149,147,"51.5129814","-0.219486603","Freston Road, Avondale",296
"16341",2020,21,742,443,454,"51.51510818","-0.208565479","Blenheim Crescent, Ladbroke Grove",897
"16342",2020,21,743,130,162,"51.46079243","-0.212607684","Oxford Road, Putney",292
"16343",2020,21,744,170,193,"51.46745485","-0.172293499","Ingrave Street, Clapham Junction",363
"16344",2020,21,745,197,175,"51.47816972","-0.18243547","Upcerne Road, West Chelsea",372
"16345",2020,21,746,361,340,"51.4795738","-0.17903854","Lots Road, West Chelsea",701
"16346",2020,21,747,308,313,"51.48796408","-0.161765173","Ormonde Gate, Chelsea",621
"16347",2020,21,748,312,322,"51.53727795","-0.079201849","Hertford Road, De Beauvoir Town",634
"16348",2020,21,749,761,791,"51.53932857","-0.074284675","Haggerston Road, Haggerston",1552
"16349",2020,21,750,112,127,"51.4710956","-0.157850096","Culvert Road, Battersea",239
"16350",2020,21,751,68,58,"51.51612862","-0.120909408","Newton Street, Covent Garden",126
"16351",2020,21,754,82,83,"51.5129006","-0.214762686","Grenfell Road, Avondale",165
"16352",2020,21,755,486,457,"51.48512191","-0.174971902","The Vale, Chelsea",943
"16353",2020,21,756,750,744,"51.47515398","-0.159169801","Prince of Wales Drive, Battersea Park",1494
"16354",2020,21,757,526,523,"51.48795853","-0.187404506","Harcourt Terrace, West Brompton",1049
"16355",2020,21,758,403,401,"51.51787005","-0.201005397","Westbourne Park Road, Portobello",804
"16356",2020,21,759,103,105,"51.52456169","-0.165668686","Broadley Terrace, Marylebone",208
"16357",2020,21,760,144,115,"51.52526975","-0.163795009","Rossmore Road, Marylebone",259
"16358",2020,21,761,205,191,"51.48321729","-0.211860644","Humbolt Road, Fulham",396
"16359",2020,21,762,1203,1263,"51.50070305","-0.129698963","Storey's Gate, Westminster",2466
"16360",2020,21,763,406,365,"51.52059714","-0.032566533","Mile End Park Leisure Centre, Mile End",771
"16361",2020,21,764,406,489,"51.46239255","-0.16829214","St. John's Road, Clapham Junction",895
"16362",2020,21,765,187,188,"51.46760141","-0.20682737","Ranelagh Gardens, Fulham",375
"16363",2020,21,766,433,453,"51.45752945","-0.192165613","Ram Street, Wandsworth",886
"16364",2020,21,767,130,146,"51.45705988","-0.200806304","Santos Road, Wandsworth",276
"16365",2020,21,768,1602,1607,"51.46134382","-0.159322467","Clapham Common North Side, Clapham Common",3209
"16366",2020,21,769,141,159,"51.473611","-0.191803","Sandilands Road, Walham Green",300
"16367",2020,21,770,273,266,"51.491026","-0.209121","Gwendwr Road, West Kensington",539
"16368",2020,21,771,154,160,"51.509224","-0.216016","Rifle Place, Avondale",314
"16369",2020,21,772,654,661,"51.47250956","-0.122831913","Binfield Road, Stockwell",1315
"16370",2020,21,773,246,250,"51.511891","-0.107349","Tallis Street, Temple",496
"16371",2020,21,774,219,212,"51.470131","-0.20464","Hurlingham Park, Parsons Green",431
"16372",2020,21,775,224,246,"51.496664","-0.223868","Little Brook Green, Brook Green",470
"16373",2020,21,776,404,424,"51.460333","-0.167029","Abyssinia Close, Clapham Junction",828
"16374",2020,21,777,162,165,"51.4619230679","-0.165297856693","Limburg Road, Clapham Junction",327
"16375",2020,21,779,151,153,"51.514449","-0.077178979","Houndsditch, Aldgate",304
"16376",2020,21,780,543,546,"51.474665","-0.18316517","Imperial Wharf Station, Sands End",1089
"16377",2020,21,781,125,123,"51.495898","-0.173009","Victoria & Albert Museum, South Kensington",248
"16378",2020,21,782,474,472,"51.483911","-0.19760944","Halford Road, West Kensington",946
"16379",2020,21,783,437,454,"51.5403115","-0.021630359","Monier Road, Hackney Wick",891
"16380",2020,21,784,925,891,"51.546326","-0.00993526","East Village, Queen Elizabeth Olympic Park",1816
"16381",2020,21,785,1549,1560,"51.54094","-0.010510565","Aquatic Centre, Queen Elizabeth Olympic Park",3109
"16382",2020,21,786,857,872,"51.549369","-0.015717614","Lee Valley VeloPark, Queen Elizabeth Olympic Park",1729
"16383",2020,21,787,1179,1187,"51.546805","-0.01469126","Timber Lodge, Queen Elizabeth Olympic Park",2366
"16384",2020,21,789,1239,1268,"51.538718","-0.011889482","Podium, Queen Elizabeth Olympic Park",2507
"16385",2020,21,790,536,532,"51.541793","-0.00481","Stratford Station, Stratford",1068
"16386",2020,21,792,259,238,"51.505461","-0.10454093","Blackfriars Road, Southwark",497
"16387",2020,21,793,117,118,"51.528279","-0.11955857","Cromer Street, Bloomsbury",235
"16388",2020,21,795,86,86,"51.527068","-0.13186102","Euston Square Gardens, Euston",172
"16389",2020,21,796,134,128,"51.524","-0.12640984","Coram Street, Bloomsbury",262
"16390",2020,21,797,165,139,"51.5293","-0.12827903","Ossulston Street, Somers Town",304
"16391",2020,21,798,207,221,"51.5301998755","-0.122299440803","Birkenhead Street, King's Cross",428
"16392",2020,21,799,152,157,"51.4976984561","-0.137598896295","Kings Gate House, Westminster",309
"16393",2020,21,800,391,417,"51.4811219398","-0.149035374873","Sopwith Way, Battersea Park",808
"16394",2020,21,801,189,184,"51.5052241745","-0.0980318118664","Lavington Street, Bankside",373
"16395",2020,21,802,425,468,"51.4765900593","-0.118256789081","Albert Square, Stockwell",893
"16396",2020,21,803,177,175,"51.5054099403","-0.0983410884509","Southwark Street, Bankside",352
"16397",2020,21,804,447,432,"51.5346677396","-0.125078652873","Good's Way, King's Cross",879
"16398",2020,21,806,242,239,"51.5372405623","-0.124807385707","Handyside Street, King's Cross",481
"16399",2020,21,807,625,635,"51.5212","-0.20888818","Bevington Road West, North Kensington",1260
"16400",2020,21,809,169,153,"51.5162778834","-0.118272991635","Lincoln's Inn Fields, Holborn",322
"16401",2020,21,810,145,169,"51.5067252868","-0.0988072461627","Tate Modern, Bankside",314
"16402",2020,21,811,864,857,"51.5057030357","-0.0277727426235","Westferry Circus, Canary Wharf",1721
"16403",2020,21,812,632,595,"51.5487311915","-0.0226065549321","Here East North, Queen Elizabeth Olympic Park",1227
"16404",2020,21,813,129,216,"51.4878074485","-0.122759625866","New Spring Gardens Walk, Vauxhall",345
"16405",2020,21,814,444,441,"51.4714330677","-0.123670735702","Clapham Road, Lingham Street, Stockwell",885
"16406",2020,21,815,711,711,"51.5000891978","-0.116628700672","Lambeth Palace Road, Waterloo",1422
"16407",2020,21,816,239,221,"51.5465327935","-0.0205975904647","Here East South, Queen Elizabeth Olympic Park",460
"16408",2020,21,817,599,599,"51.4813354746","-0.138212295869","Riverlight South, Nine Elms",1198
"16409",2020,21,818,1385,1379,"51.501513","-0.12382322","Westminster Pier, Westminster",2764
"16410",2020,21,819,272,272,"51.50621","-0.114842","Belvedere Road 2, South Bank",544
"16411",2020,21,820,288,288,"51.492807","-0.091938","Victory Place, Walworth",576
"16412",2020,21,821,1104,1095,"51.4835074867","-0.147714557371","Battersea Power Station, Battersea Park",2199
"16413",2020,21,826,380,372,"51.496863","-0.1429434","Allington Street, Victoria",752
"16414",2020,21,827,535,531,"51.479601","-0.11147178","Cranmer Road, Stockwell",1066
"16415",2020,21,828,461,480,"51.473874","-0.11258096","Normandy Road, Stockwell",941
"16416",2020,21,829,237,257,"51.469217","-0.11268674","Wynne Road, Stockwell",494
"16417",2020,21,830,342,355,"51.469202","-0.11902256","Sidney Road, Stockwell",697
"16418",2020,21,831,464,486,"51.466232","-0.11317995","St John's Crescent, Brixton",950
"16419",2020,21,832,776,781,"51.464019","-0.11578197","Ferndale Road, Brixton",1557
"16420",2020,21,833,1287,1335,"51.460232","-0.11537509","Saltoun Road, Brixton",2622
"16421",2020,21,834,719,762,"51.477966","-0.14785703","Gas Holders, Battersea Park",1481
"16422",2020,21,835,142,142,"51.516785","-0.10494775","Farringdon Street, Holborn",284
"16423",2020,21,836,349,345,"51.541596","-0.12544145","York Way, Kings Cross",694
"16424",2020,21,838,66,54,"51.518093","-0.0914017","Fore Street Avenue, Guildhall",120
"16425",2020,21,839,365,374,"51.508033","-0.10682363","Sea Containers, South Bank",739
"16426",2020,22,1,62,63,"51.52916347","-0.109970527","River Street , Clerkenwell",125
"16427",2020,22,2,223,220,"51.49960695","-0.197574246","Phillimore Gardens, Kensington",443
"16428",2020,22,3,27,30,"51.52128377","-0.084605692","Christopher Street, Liverpool Street",57
"16429",2020,22,4,32,28,"51.53005939","-0.120973687","St. Chad's Street, King's Cross",60
"16430",2020,22,5,111,108,"51.49313","-0.156876","Sedding Street, Sloane Square",219
"16431",2020,22,6,86,82,"51.51811784","-0.144228881","Broadcasting House, Marylebone",168
"16432",2020,22,7,220,215,"51.53430039","-0.1680743","Charlbert Street, St. John's Wood",435
"16433",2020,22,8,350,356,"51.529857","-0.18348604","Maida Vale, Maida Vale",706
"16434",2020,22,9,108,110,"51.5073853","-0.096440751","New Globe Walk, Bankside",218
"16435",2020,22,10,45,44,"51.50597426","-0.092754157","Park Street, Bankside",89
"16436",2020,22,11,84,87,"51.52395143","-0.122502346","Brunswick Square, Bloomsbury",171
"16437",2020,22,12,46,44,"51.52168078","-0.130431727","Malet Street, Bloomsbury",90
"16438",2020,22,13,24,27,"51.51991453","-0.136039674","Scala Street, Fitzrovia",51
"16439",2020,22,14,148,127,"51.52994371","-0.123616824","Belgrove Street , King's Cross",275
"16440",2020,22,15,53,52,"51.51772703","-0.127854211","Great Russell Street, Bloomsbury",105
"16441",2020,22,16,74,72,"51.52635795","-0.125979294","Cartwright Gardens , Bloomsbury",146
"16442",2020,22,17,132,147,"51.5216612","-0.109006325","Hatton Wall, Holborn",279
"16443",2020,22,18,105,101,"51.51477076","-0.12221963","Drury Lane, Covent Garden",206
"16444",2020,22,19,44,39,"51.52505093","-0.131161087","Taviton Street, Bloomsbury",83
"16445",2020,22,20,10,10,"51.527326","-0.13605286","Drummond Street , Euston",20
"16446",2020,22,21,26,27,"51.53007835","-0.13884627","Hampstead Road (Cartmel), Euston",53
"16447",2020,22,22,99,104,"51.5222641","-0.114079481","Northington Street , Holborn",203
"16448",2020,22,23,39,36,"51.51943538","-0.119123345","Red Lion Square, Holborn",75
"16449",2020,22,24,75,73,"51.51908011","-0.124678402","British Museum, Bloomsbury",148
"16450",2020,22,25,47,44,"51.5288338","-0.132250369","Doric Way , Somers Town",91
"16451",2020,22,26,40,52,"51.52728093","-0.11829517","Ampton Street , Clerkenwell",92
"16452",2020,22,27,38,37,"51.51382102","-0.107927706","Bouverie Street, Temple",75
"16453",2020,22,28,223,224,"51.52351808","-0.143613641","Bolsover Street, Fitzrovia",447
"16454",2020,22,29,119,115,"51.513735","-0.193487","Hereford Road, Bayswater",234
"16455",2020,22,30,52,49,"51.52915444","-0.093421615","Windsor Terrace, Hoxton",101
"16456",2020,22,31,88,108,"51.52953709","-0.083353323","Fanshaw Street, Hoxton",196
"16457",2020,22,32,93,95,"51.52469624","-0.084439283","Leonard Circus , Shoreditch",188
"16458",2020,22,33,107,95,"51.5156","-0.070056","Central House, Aldgate",202
"16459",2020,22,34,65,67,"51.5341235","-0.129386874","Pancras Road, King's Cross",132
"16460",2020,22,36,260,265,"51.50173726","-0.184980612","De Vere Gardens, Kensington",525
"16461",2020,22,37,108,121,"51.49159394","-0.192369256","Penywern Road, Earl's Court",229
"16462",2020,22,38,73,73,"51.4973875","-0.197245586","Abingdon Villas, Kensington",146
"16463",2020,22,39,161,158,"51.5263778","-0.078130921","Shoreditch High Street, Shoreditch",319
"16464",2020,22,40,80,75,"51.52127071","-0.0755789","Commercial Street, Shoreditch",155
"16465",2020,22,41,14,15,"51.520955","-0.083493552","Pindar Street, Liverpool Street",29
"16466",2020,22,42,65,68,"51.53099181","-0.093903825","Wenlock Road , Hoxton",133
"16467",2020,22,43,167,168,"51.52026","-0.157183945","Crawford Street, Marylebone",335
"16468",2020,22,44,61,57,"51.51073687","-0.144165239","Bruton Street, Mayfair",118
"16469",2020,22,45,54,38,"51.522511","-0.162298","Boston Place, Marylebone",92
"16470",2020,22,46,121,119,"51.507131","-0.06691","Nesham Street, Wapping",240
"16471",2020,22,47,291,286,"51.52334476","-0.183846408","Warwick Avenue Station, Maida Vale",577
"16472",2020,22,48,103,105,"51.51248445","-0.099141408","Godliman Street, St. Paul's",208
"16473",2020,22,49,94,105,"51.50706909","-0.145904427","Curzon Street, Mayfair",199
"16474",2020,22,50,52,42,"51.52867339","-0.087459376","East Road, Hoxton",94
"16475",2020,22,51,48,47,"51.52671796","-0.104298194","Finsbury Library , Finsbury",95
"16476",2020,22,52,74,72,"51.52295439","-0.094934859","Roscoe Street, St. Luke's",146
"16477",2020,22,53,37,45,"51.5099923","-0.143495266","Grafton Street, Mayfair",82
"16478",2020,22,54,57,55,"51.52174785","-0.094475072","Golden Lane, Barbican",112
"16479",2020,22,55,70,73,"51.51707521","-0.086685542","Finsbury Circus, Liverpool Street",143
"16480",2020,22,56,126,128,"51.52058381","-0.154701411","Paddington Street, Marylebone",254
"16481",2020,22,57,88,68,"51.52334672","-0.120202614","Guilford Street , Bloomsbury",156
"16482",2020,22,58,78,82,"51.52452699","-0.079248081","New Inn Yard, Shoreditch",160
"16483",2020,22,60,88,96,"51.52644828","-0.172190727","Lisson Grove, St. John's Wood",184
"16484",2020,22,61,93,104,"51.49738251","-0.089446947","Great Dover Street, The Borough",197
"16485",2020,22,62,58,70,"51.4907579","-0.106323685","Cotton Garden Estate, Kennington",128
"16486",2020,22,63,47,46,"51.53089041","-0.089782579","Murray Grove , Hoxton",93
"16487",2020,22,64,157,145,"51.50946212","-0.124749274","William IV Street, Strand",302
"16488",2020,22,66,94,80,"51.51795029","-0.108657431","Holborn Circus, Holborn",174
"16489",2020,22,67,39,43,"51.51882555","-0.108028472","Hatton Garden, Holborn",82
"16490",2020,22,68,95,94,"51.52059681","-0.116688468","Theobald's Road , Holborn",189
"16491",2020,22,69,38,27,"51.5262363","-0.134407652","Euston Road, Euston",65
"16492",2020,22,70,56,57,"51.53136059","-0.117069978","Calshot Street , King's Cross",113
"16493",2020,22,71,100,108,"51.5154186","-0.098850915","Newgate Street , St. Paul's",208
"16494",2020,22,72,47,48,"51.52352001","-0.108340165","Farringdon Lane, Clerkenwell",95
"16495",2020,22,73,145,149,"51.52572618","-0.088486188","Old Street Station, St. Luke's",294
"16496",2020,22,74,316,307,"51.48591714","-0.124469948","Vauxhall Cross, Vauxhall",623
"16497",2020,22,75,53,55,"51.53219984","-0.105480698","Torrens Street, Angel",108
"16498",2020,22,76,104,107,"51.52559505","-0.144083893","Longford Street, The Regent's Park",211
"16499",2020,22,77,89,86,"51.52341837","-0.124121774","Russell Square Station, Bloomsbury",175
"16500",2020,22,78,60,58,"51.52486887","-0.099489485","Sadlers Sports Centre, Finsbury",118
"16501",2020,22,79,64,65,"51.511726","-0.11385596","Arundel Street, Temple",129
"16502",2020,22,80,88,73,"51.50069361","-0.102091246","Webber Street , Southwark",161
"16503",2020,22,81,86,88,"51.52025302","-0.141327271","Great Titchfield Street, Fitzrovia",174
"16504",2020,22,82,20,20,"51.514274","-0.111257","Chancery Lane, Holborn",40
"16505",2020,22,83,169,173,"51.50963938","-0.131510949","Panton Street, West End",342
"16506",2020,22,84,17,16,"51.51593725","-0.111778348","Breams Buildings, Holborn",33
"16507",2020,22,85,267,277,"51.50064702","-0.078600401","Tanner Street, Bermondsey",544
"16508",2020,22,86,62,57,"51.48947903","-0.115156562","Sancroft Street, Vauxhall",119
"16509",2020,22,87,31,40,"51.51646835","-0.079684557","Devonshire Square, Liverpool Street",71
"16510",2020,22,88,123,128,"51.51858757","-0.132053392","Bayley Street , Bloomsbury",251
"16511",2020,22,89,61,55,"51.5262503","-0.123509611","Tavistock Place, Bloomsbury",116
"16512",2020,22,90,28,30,"51.53301907","-0.139174593","Harrington Square 1, Camden Town",58
"16513",2020,22,91,101,90,"51.49368637","-0.111014912","Walnut Tree Walk, Vauxhall",191
"16514",2020,22,92,70,71,"51.49889832","-0.100440521","Borough Road, Elephant & Castle",141
"16515",2020,22,93,115,103,"51.53440868","-0.109025404","Cloudesley Road, Angel",218
"16516",2020,22,94,239,280,"51.49506109","-0.085814489","Bricklayers Arms, Borough",519
"16517",2020,22,95,110,112,"51.5208417","-0.097340162","Aldersgate Street, Barbican",222
"16518",2020,22,96,53,61,"51.53095071","-0.078505384","Falkirk Street, Hoxton",114
"16519",2020,22,97,168,167,"51.49792478","-0.183834706","Gloucester Road (North), Kensington",335
"16520",2020,22,98,126,106,"51.52554222","-0.138231303","Hampstead Road, Euston",232
"16521",2020,22,99,303,303,"51.51457763","-0.158264483","Old Quebec Street, Marylebone",606
"16522",2020,22,100,103,103,"51.49043573","-0.122806861","Albert Embankment, Vauxhall",206
"16523",2020,22,101,90,96,"51.51155322","-0.0929401","Queen Street 1, Bank",186
"16524",2020,22,102,100,102,"51.51340693","-0.076793375","Jewry Street, Aldgate",202
"16525",2020,22,103,69,73,"51.50472376","-0.192538767","Vicarage Gate, Kensington",142
"16526",2020,22,104,114,115,"51.51159481","-0.077121322","Crosswall, Tower",229
"16527",2020,22,105,136,137,"51.51552971","-0.190240716","Westbourne Grove, Bayswater",273
"16528",2020,22,106,98,99,"51.51410514","-0.147301667","Woodstock Street, Mayfair",197
"16529",2020,22,107,94,89,"51.52600832","-0.096317627","Finsbury Leisure Centre, St. Luke's",183
"16530",2020,22,108,109,98,"51.49812559","-0.132102166","Abbey Orchard Street, Westminster",207
"16531",2020,22,109,123,125,"51.51563144","-0.132328837","Soho Square , Soho",248
"16532",2020,22,110,161,155,"51.53304322","-0.172528678","Wellington Road, St. John's Wood",316
"16533",2020,22,111,836,858,"51.5100172","-0.157275636","Park Lane , Hyde Park",1694
"16534",2020,22,112,15,12,"51.51580998","-0.105270275","Stonecutter Street, Holborn",27
"16535",2020,22,113,160,157,"51.49646288","-0.183289032","Gloucester Road (Central), South Kensington",317
"16536",2020,22,114,418,424,"51.52451738","-0.158963647","Park Road (Baker Street), The Regent's Park",842
"16537",2020,22,115,191,181,"51.51423368","-0.073537654","Braham Street, Aldgate",372
"16538",2020,22,116,155,155,"51.51449962","-0.141423695","Little Argyll Street, West End",310
"16539",2020,22,117,52,54,"51.49288067","-0.114934001","Lollard Street, Vauxhall",106
"16540",2020,22,118,80,78,"51.49582705","-0.13547809","Rochester Row, Westminster",158
"16541",2020,22,119,104,107,"51.52589324","-0.090847761","Bath Street, St. Luke's",211
"16542",2020,22,120,33,33,"51.51573534","-0.093080779","The Guildhall, Guildhall",66
"16543",2020,22,121,59,61,"51.51891348","-0.156166631","Baker Street, Marylebone",120
"16544",2020,22,122,43,37,"51.52111369","-0.078869751","Norton Folgate, Liverpool Street",80
"16545",2020,22,123,40,36,"51.52836014","-0.104724625","St. John Street, Finsbury",76
"16546",2020,22,124,17,33,"51.49654462","-0.150905245","Eaton Square, Belgravia",50
"16547",2020,22,125,112,125,"51.50069491","-0.094524319","Borough High Street, The Borough",237
"16548",2020,22,126,31,30,"51.51782144","-0.096496865","Museum of London, Barbican",61
"16549",2020,22,127,35,37,"51.51700801","-0.09388536","Wood Street, Guildhall",72
"16550",2020,22,128,107,103,"51.49536226","-0.185296516","Emperor's Gate, South Kensington",210
"16551",2020,22,129,91,90,"51.5118973","-0.137043852","Golden Square, Soho",181
"16552",2020,22,130,498,528,"51.50950627","-0.075459482","Tower Gardens , Tower",1026
"16553",2020,22,131,71,72,"51.53300545","-0.136792671","Eversholt Street , Camden Town",143
"16554",2020,22,132,201,175,"51.52364804","-0.074754872","Bethnal Green Road, Shoreditch",376
"16555",2020,22,134,256,260,"51.504904","-0.06797","Wapping High Street, Wapping",516
"16556",2020,22,135,88,102,"51.52326004","-0.104708922","Clerkenwell Green, Clerkenwell",190
"16557",2020,22,136,90,93,"51.51196176","-0.097441687","Queen Victoria Street, St. Paul's",183
"16558",2020,22,138,288,287,"51.51227622","-0.157436972","Green Street, Mayfair",575
"16559",2020,22,139,72,74,"51.49488108","-0.117974901","Lambeth Road, Vauxhall",146
"16560",2020,22,140,44,53,"51.52096262","-0.085634242","Finsbury Square , Moorgate",97
"16561",2020,22,141,39,38,"51.51530805","-0.147203711","Chapel Place, Marylebone",77
"16562",2020,22,142,85,97,"51.49372451","-0.198286569","West Cromwell Road, Earl's Court",182
"16563",2020,22,143,105,103,"51.4968865","-0.161203828","Pont Street, Knightsbridge",208
"16564",2020,22,144,156,144,"51.48894022","-0.111435796","Kennington Cross, Kennington",300
"16565",2020,22,145,113,112,"51.50074359","-0.202759212","Ilchester Place, Kensington",225
"16566",2020,22,146,121,114,"51.48836528","-0.129361842","Vauxhall Bridge , Pimlico",235
"16567",2020,22,148,145,147,"51.49211134","-0.138364847","Tachbrook Street, Victoria",292
"16568",2020,22,149,226,231,"51.48478899","-0.110683213","Kennington Road Post Office, Oval",457
"16569",2020,22,150,96,78,"51.49705603","-0.168917077","Holy Trinity Brompton, Knightsbridge",174
"16570",2020,22,151,87,79,"51.51213691","-0.201554966","Chepstow Villas, Notting Hill",166
"16571",2020,22,152,154,155,"51.49217002","-0.101536865","Hampton Street, Walworth",309
"16572",2020,22,153,522,530,"51.511933","-0.174411","Bayswater Road, Hyde Park",1052
"16573",2020,22,154,60,37,"51.50379168","-0.11282408","Waterloo Station 3, Waterloo",97
"16574",2020,22,155,135,119,"51.49586666","-0.191933711","Lexham Gardens, Kensington",254
"16575",2020,22,156,96,114,"51.49443626","-0.092921165","New Kent Road, The Borough",210
"16576",2020,22,157,214,202,"51.50039792","-0.193068385","Wright's Lane, Kensington",416
"16577",2020,22,158,148,150,"51.49085368","-0.196170309","Trebovir Road, Earl's Court",298
"16578",2020,22,159,118,115,"51.51461995","-0.137841333","Great Marlborough Street, Soho",233
"16579",2020,22,160,195,173,"51.50663341","-0.131773845","Waterloo Place, St. James's",368
"16580",2020,22,161,60,58,"51.49234577","-0.141334487","Guildhouse Street, Victoria",118
"16581",2020,22,162,115,116,"51.51760685","-0.121328408","Southampton Place, Holborn",231
"16582",2020,22,163,129,140,"51.4931848","-0.167894973","Sloane Avenue, Knightsbridge",269
"16583",2020,22,164,91,92,"51.515607","-0.183118788","Cleveland Gardens, Bayswater",183
"16584",2020,22,165,34,38,"51.517932","-0.183716959","Orsett Terrace, Bayswater",72
"16585",2020,22,166,192,201,"51.50185512","-0.159237081","Seville Street, Knightsbridge",393
"16586",2020,22,167,73,67,"51.49395092","-0.147624377","Eccleston Place, Victoria",140
"16587",2020,22,168,124,115,"51.50040123","-0.195455928","Argyll Road, Kensington",239
"16588",2020,22,169,274,283,"51.51474612","-0.165164288","Porchester Place, Paddington",557
"16589",2020,22,170,35,34,"51.52784273","-0.108068155","Hardwick Street, Clerkenwell",69
"16590",2020,22,171,102,100,"51.4916156","-0.186753859","Collingham Gardens, Earl's Court",202
"16591",2020,22,172,116,107,"51.49121192","-0.173715911","Sumner Place, South Kensington",223
"16592",2020,22,173,75,72,"51.50486","-0.113001","Waterloo Road, South Bank",147
"16593",2020,22,174,35,35,"51.512529","-0.115163","Strand, Strand",70
"16594",2020,22,175,24,24,"51.521668","-0.079608554","Worship Street, Shoreditch",48
"16595",2020,22,176,110,113,"51.51791921","-0.188098863","Gloucester Terrace, Bayswater",223
"16596",2020,22,177,59,61,"51.49616092","-0.140947636","Ashley Place, Victoria",120
"16597",2020,22,178,129,123,"51.48985626","-0.141923621","Warwick Square, Pimlico",252
"16598",2020,22,180,156,150,"51.5129118","-0.153645496","North Audley Street, Mayfair",306
"16599",2020,22,181,78,80,"51.49941247","-0.152317537","Belgrave Square, Belgravia",158
"16600",2020,22,182,68,66,"51.52202903","-0.165842551","Bell Street , Marylebone",134
"16601",2020,22,183,179,175,"51.482362","-0.13612398","Riverlight North, Nine Elms",354
"16602",2020,22,184,151,152,"51.52071513","-0.14521173","Portland Place, Marylebone",303
"16603",2020,22,185,165,167,"51.48805753","-0.140741432","Alderney Street, Pimlico",332
"16604",2020,22,186,120,118,"51.51733558","-0.175810943","South Wharf Road, Paddington",238
"16605",2020,22,187,139,134,"51.49247977","-0.178433004","Queen's Gate (South), South Kensington",273
"16606",2020,22,188,44,53,"51.5165179","-0.164393768","Nutford Place, Marylebone",97
"16607",2020,22,189,66,68,"51.53166681","-0.109914711","Claremont Square, Angel",134
"16608",2020,22,190,133,129,"51.48997562","-0.132845681","Rampayne Street, Pimlico",262
"16609",2020,22,191,908,927,"51.50311799","-0.153520935","Hyde Park Corner, Hyde Park",1835
"16610",2020,22,192,244,243,"51.51251523","-0.133201961","Wardour Street, Soho",487
"16611",2020,22,193,63,55,"51.50581776","-0.100186337","Bankside Mix, Bankside",118
"16612",2020,22,194,339,405,"51.50462759","-0.091773776","Hop Exchange, The Borough",744
"16613",2020,22,195,85,83,"51.50724437","-0.106237501","Milroy Walk, South Bank",168
"16614",2020,22,196,67,65,"51.50368837","-0.098497684","Union Street, The Borough",132
"16615",2020,22,197,77,78,"51.50556905","-0.111606696","Stamford Street, South Bank",155
"16616",2020,22,199,157,155,"51.51048489","-0.082989638","Great Tower Street, Monument",312
"16617",2020,22,200,98,100,"51.51492456","-0.066078037","LMU Commercial Road, Whitechapel",198
"16618",2020,22,201,173,178,"51.5225965","-0.161113413","Dorset Square, Marylebone",351
"16619",2020,22,202,174,177,"51.51236389","-0.06954201","Leman Street, Aldgate",351
"16620",2020,22,203,62,62,"51.51821864","-0.100791005","West Smithfield Rotunda, Farringdon",124
"16621",2020,22,204,68,65,"51.52659961","-0.112432615","Margery Street, Clerkenwell",133
"16622",2020,22,206,135,145,"51.518154","-0.062697","New Road 1 , Whitechapel",280
"16623",2020,22,207,113,101,"51.50135267","-0.153194766","Grosvenor Crescent, Belgravia",214
"16624",2020,22,208,45,49,"51.52505151","-0.166304359","Mallory Street, Marylebone",94
"16625",2020,22,209,82,86,"51.49358391","-0.165101392","Denyer Street, Knightsbridge",168
"16626",2020,22,210,105,107,"51.51681444","-0.151926305","Hinde Street, Marylebone",212
"16627",2020,22,211,140,120,"51.49464523","-0.158105512","Cadogan Place, Knightsbridge",260
"16628",2020,22,212,55,54,"51.50658458","-0.199004026","Campden Hill Road, Notting Hill",109
"16629",2020,22,213,725,751,"51.50274025","-0.149569201","Wellington Arch, Hyde Park",1476
"16630",2020,22,214,82,59,"51.52683806","-0.130504336","Endsleigh Gardens, Euston",141
"16631",2020,22,215,43,33,"51.51906932","-0.088285377","Moorfields, Moorgate",76
"16632",2020,22,216,180,180,"51.49094565","-0.181190899","Old Brompton Road, South Kensington",360
"16633",2020,22,217,137,137,"51.51615461","-0.082422399","Wormwood Street, Liverpool Street",274
"16634",2020,22,218,130,115,"51.48971651","-0.170194408","St. Luke's Church, Chelsea",245
"16635",2020,22,219,170,181,"51.49016361","-0.19039362","Bramham Gardens, Earl's Court",351
"16636",2020,22,220,85,67,"51.49066456","-0.166485083","Chelsea Green, Chelsea",152
"16637",2020,22,221,110,103,"51.49481649","-0.13045856","Horseferry Road, Westminster",213
"16638",2020,22,222,377,355,"51.50275704","-0.155349725","Knightsbridge, Hyde Park",732
"16639",2020,22,223,262,275,"51.49148474","-0.090220911","Rodney Road , Walworth",537
"16640",2020,22,224,401,401,"51.51031","-0.18740235","Queensway, Kensington Gardens",802
"16641",2020,22,225,145,138,"51.50935342","-0.196422","Notting Hill Gate Station, Notting Hill",283
"16642",2020,22,226,98,99,"51.50844614","-0.131961389","Charles II Street, West End",197
"16643",2020,22,227,72,80,"51.52891573","-0.115480888","Great Percy Street, Clerkenwell",152
"16644",2020,22,228,149,175,"51.50742485","-0.134621209","St. James's Square, St. James's",324
"16645",2020,22,229,254,268,"51.50654321","-0.123179697","Whitehall Place, Strand",522
"16646",2020,22,230,73,60,"51.50669284","-0.103137426","Poured Lines, Bankside",133
"16647",2020,22,231,140,136,"51.49396755","-0.17873226","Queen's Gate (Central), South Kensington",276
"16648",2020,22,232,17,16,"51.51501025","-0.112753217","Carey Street, Holborn",33
"16649",2020,22,233,210,211,"51.50777049","-0.130699733","Pall Mall East, West End",421
"16650",2020,22,234,160,160,"51.53450449","-0.106992706","Liverpool Road (N1 Centre), Angel",320
"16651",2020,22,235,139,124,"51.49571828","-0.110889274","Kennington Road  , Vauxhall",263
"16652",2020,22,236,40,48,"51.51838043","-0.073438925","Fashion Street, Whitechapel",88
"16653",2020,22,237,131,143,"51.5097860151","-0.0681619805156","Dock Street, Wapping",274
"16654",2020,22,238,96,104,"51.5233534","-0.175116099","Frampton Street, Paddington",200
"16655",2020,22,239,159,147,"51.52443845","-0.138019439","Warren Street Station, Euston",306
"16656",2020,22,240,9,11,"51.50545935","-0.10569204","Colombo Street, Southwark",20
"16657",2020,22,242,135,137,"51.52200801","-0.151359288","Beaumont Street, Marylebone",272
"16658",2020,22,243,80,105,"51.49096258","-0.139625122","Gloucester Street, Pimlico",185
"16659",2020,22,244,73,69,"51.51611887","-0.128585022","Earnshaw Street , Covent Garden",142
"16660",2020,22,245,100,95,"51.4853572","-0.142207481","Grosvenor Road, Pimlico",195
"16661",2020,22,246,91,107,"51.52285301","-0.099994052","Berry Street, Clerkenwell",198
"16662",2020,22,247,239,235,"51.530529","-0.167515","St. John's Wood Church, The Regent's Park",474
"16663",2020,22,248,866,897,"51.50645179","-0.170279555","Triangle Car Park, Hyde Park",1763
"16664",2020,22,249,93,57,"51.49859784","-0.096191134","Harper Road, The Borough",150
"16665",2020,22,250,54,59,"51.489932","-0.162727","Royal Avenue 1, Chelsea",113
"16666",2020,22,251,155,180,"51.518908","-0.079249","Brushfield Street, Liverpool Street",335
"16667",2020,22,252,320,302,"51.5046364","-0.116542278","Jubilee Gardens, South Bank",622
"16668",2020,22,253,239,261,"51.53404294","-0.086379717","Shoreditch Park, Hoxton",500
"16669",2020,22,254,105,114,"51.53051587","-0.106408455","Chadwell Street, Angel",219
"16670",2020,22,255,158,163,"51.52557531","-0.179592915","Clifton Road, Maida Vale",321
"16671",2020,22,256,12,12,"51.51362054","-0.116764211","Houghton Street, Strand",24
"16672",2020,22,257,115,118,"51.52248185","-0.154907218","Westminster University, Marylebone",233
"16673",2020,22,259,105,99,"51.490959","-0.1532331","Bourne Street, Belgravia",204
"16674",2020,22,260,57,62,"51.5136846","-0.135580879","Broadwick Street, Soho",119
"16675",2020,22,261,56,52,"51.5134891","-0.191351186","Princes Square, Bayswater",108
"16676",2020,22,262,98,80,"51.49874469","-0.103132904","LSBU (Borough Road), Elephant & Castle",178
"16677",2020,22,263,26,26,"51.51422502","-0.080660083","St. Mary Axe, Aldgate",52
"16678",2020,22,264,128,139,"51.52644342","-0.109256828","Tysoe Street, Clerkenwell",267
"16679",2020,22,265,88,87,"51.51595344","-0.169249375","Southwick Street, Paddington",175
"16680",2020,22,266,184,203,"51.50102668","-0.180246101","Queen's Gate (North), Kensington",387
"16681",2020,22,267,116,99,"51.49206037","-0.132224622","Regency Street, Westminster",215
"16682",2020,22,268,66,55,"51.49320445","-0.144132875","Belgrave Road, Victoria",121
"16683",2020,22,269,124,129,"51.50082346","-0.089740764","Empire Square, The Borough",253
"16684",2020,22,270,218,227,"51.4863434","-0.122492418","Kennington Lane Rail Bridge, Vauxhall",445
"16685",2020,22,271,298,307,"51.53583617","-0.156285395","London Zoo,  The Regent's Park",605
"16686",2020,22,272,121,116,"51.50144456","-0.110699309","Baylis Road, Waterloo",237
"16687",2020,22,273,94,80,"51.50613324","-0.114686385","Belvedere Road 1, South Bank",174
"16688",2020,22,274,143,134,"51.49671237","-0.20528437","Warwick Road, Olympia",277
"16689",2020,22,275,46,43,"51.52004497","-0.092176447","Barbican Centre, Barbican",89
"16690",2020,22,276,75,76,"51.50930161","-0.084985356","Lower Thames Street, Monument",151
"16691",2020,22,277,168,177,"51.50315739","-0.191496313","Kensington Church Street, Kensington",345
"16692",2020,22,278,673,683,"51.5034938","-0.07962099","Tooley Street, Bermondsey",1356
"16693",2020,22,279,83,77,"51.51862243","-0.176645823","North Wharf Road, Paddington",160
"16694",2020,22,280,104,108,"51.490083","-0.162418","Royal Avenue 2, Chelsea",212
"16695",2020,22,281,83,82,"51.49580589","-0.127575233","Smith Square, Westminster",165
"16696",2020,22,282,210,181,"51.51906446","-0.059642081","Royal London Hospital, Whitechapel",391
"16697",2020,22,283,12,9,"51.51440928","-0.118478757","Kingsway, Covent Garden",21
"16698",2020,22,284,66,65,"51.49914063","-0.112031483","Lambeth North Station, Waterloo",131
"16699",2020,22,286,107,89,"51.5272947","-0.174653609","St. John's Wood Road, St. John's Wood",196
"16700",2020,22,287,30,28,"51.52367314","-0.128377673","Bedford Way, Bloomsbury",58
"16701",2020,22,288,150,135,"51.49236962","-0.147478734","Elizabeth Bridge, Victoria",285
"16702",2020,22,289,47,48,"51.50923022","-0.151296092","South Audley Street, Mayfair",95
"16703",2020,22,290,157,139,"51.518268","-0.17110323","St Mary's Hospital, Paddington",296
"16704",2020,22,291,137,141,"51.48483991","-0.138089062","Claverton Street, Pimlico",278
"16705",2020,22,292,165,172,"51.49888404","-0.165471605","Montpelier Street, Knightsbridge",337
"16706",2020,22,293,49,55,"51.49815779","-0.209494128","Kensington Olympia Station, Olympia",104
"16707",2020,22,294,170,164,"51.488226","-0.135635511","St. George's Square, Pimlico",334
"16708",2020,22,295,52,63,"51.50029631","-0.092762704","Swan Street, The Borough",115
"16709",2020,22,296,99,97,"51.49363156","-0.190603326","Knaresborough Place, Earl's Court",196
"16710",2020,22,297,78,82,"51.49612799","-0.106000855","Geraldine Street, Elephant & Castle",160
"16711",2020,22,298,390,394,"51.50227992","-0.074189225","Curlew Street, Shad Thames",784
"16712",2020,22,299,6,4,"51.49398524","-0.136928582","Vincent Square, Westminster",10
"16713",2020,22,300,664,671,"51.505014","-0.17306032","Serpentine Car Park, Hyde Park",1335
"16714",2020,22,301,135,148,"51.51475963","-0.148105415","Marylebone Lane, Marylebone",283
"16715",2020,22,302,296,299,"51.466907","-0.216573","Putney Pier, Wandsworth",595
"16716",2020,22,303,832,804,"51.50295379","-0.158456089","Albert Gate, Hyde Park",1636
"16717",2020,22,306,43,43,"51.51816295","-0.135025698","Rathbone Street, Fitzrovia",86
"16718",2020,22,307,892,886,"51.50990837","-0.187842717","Black Lion Gate, Kensington Gardens",1778
"16719",2020,22,308,116,111,"51.49907558","-0.085666316","Long Lane , Bermondsey",227
"16720",2020,22,309,90,92,"51.50963123","-0.119047563","Embankment (Savoy), Strand",182
"16721",2020,22,310,59,68,"51.4908679","-0.116911864","Black Prince Road, Vauxhall",127
"16722",2020,22,311,71,68,"51.51918144","-0.140485596","Foley Street, Fitzrovia",139
"16723",2020,22,312,184,186,"51.53088935","-0.176770502","Grove End Road, St. John's Wood",370
"16724",2020,22,313,44,45,"51.51734403","-0.138072691","Wells Street, Fitzrovia",89
"16725",2020,22,314,88,114,"51.50088934","-0.083159352","Tyers Gate, Bermondsey",202
"16726",2020,22,315,339,319,"51.52536703","-0.153463612","The Tennis Courts, The Regent's Park",658
"16727",2020,22,316,212,214,NA,NA,NA,426
"16728",2020,22,317,41,65,"51.49679128","-0.093913472","Dickens Square, Borough",106
"16729",2020,22,318,86,99,"51.51004801","-0.138846453","Sackville Street, Mayfair",185
"16730",2020,22,319,72,79,"51.52702563","-0.088542771","Baldwin Street, St. Luke's",151
"16731",2020,22,320,132,117,"51.49357351","-0.139956043","Queen Mother Sports Centre, Victoria",249
"16732",2020,22,321,236,232,"51.49785559","-0.081608045","Bermondsey Street, Bermondsey",468
"16733",2020,22,322,65,77,"51.526293","-0.073955","Palissy Street, Shoreditch",142
"16734",2020,22,323,19,24,"51.523196","-0.083067","Clifton Street, Shoreditch",43
"16735",2020,22,324,127,122,"51.49652013","-0.101384068","Ontario Street, Elephant & Castle",249
"16736",2020,22,325,27,26,"51.50908747","-0.129697889","St. Martin's Street, West End",53
"16737",2020,22,326,183,164,"51.53266186","-0.099981142","Graham Street, Angel",347
"16738",2020,22,327,24,21,"51.53095","-0.085603","New North Road 1, Hoxton",45
"16739",2020,22,328,35,35,"51.53114","-0.086016","New North Road 2, Hoxton",70
"16740",2020,22,329,446,432,"51.53589283","-0.160854428","Prince Albert Road, The Regent's Park",878
"16741",2020,22,330,48,42,"51.51641749","-0.179135079","Eastbourne Mews, Paddington",90
"16742",2020,22,331,57,59,"51.52085887","-0.089887855","Bunhill Row, Moorgate",116
"16743",2020,22,332,95,103,"51.49334336","-0.194757949","Nevern Place, Earl's Court",198
"16744",2020,22,333,106,104,"51.50860544","-0.193764092","Palace Gardens Terrace, Notting Hill",210
"16745",2020,22,334,74,75,"51.505044","-0.115851","Concert Hall Approach 1, South Bank",149
"16746",2020,22,335,56,61,"51.51196803","-0.120718759","Tavistock Street, Covent Garden",117
"16747",2020,22,336,70,68,"51.504942","-0.115533","Concert Hall Approach 2, South Bank",138
"16748",2020,22,337,86,90,"51.51108452","-0.197524944","Pembridge Villas, Notting Hill",176
"16749",2020,22,338,135,143,"51.51175646","-0.119643424","Wellington Street , Strand",278
"16750",2020,22,339,34,40,"51.5333196","-0.1117812","Risinghill Street, Angel",74
"16751",2020,22,340,74,91,"51.51444134","-0.087587447","Bank of England Museum, Bank",165
"16752",2020,22,341,263,259,"51.50810309","-0.12602103","Craven Street, Strand",522
"16753",2020,22,343,218,209,"51.53692216","-0.150181444","London Zoo Car Park, The Regent's Park",427
"16754",2020,22,344,34,30,"51.528246","-0.10102611","Goswell Road (City Uni), Finsbury",64
"16755",2020,22,345,181,168,"51.48802358","-0.166878535","Flood Street, Chelsea",349
"16756",2020,22,347,94,93,"51.50013942","-0.113936001","Lower Marsh, Waterloo",187
"16757",2020,22,348,108,113,"51.51217033","-0.150481272","Grosvenor Square, Mayfair",221
"16758",2020,22,349,40,45,"51.51196","-0.142783033","St. George Street, Mayfair",85
"16759",2020,22,350,529,528,"51.5017154373867","-0.1798541843891","Queen's Gate, Kensington Gardens",1057
"16760",2020,22,351,99,102,"51.529423","-0.097122","Macclesfield Rd, St Lukes",201
"16761",2020,22,352,76,84,"51.486965","-0.116625","Vauxhall Street, Vauxhall",160
"16762",2020,22,353,42,35,"51.49459148","-0.134234258","Greycoat Street , Westminster",77
"16763",2020,22,354,172,178,"51.506767","-0.123702","Northumberland Avenue, Strand",350
"16764",2020,22,356,236,229,"51.494412","-0.173881","South Kensington Station, South Kensington",465
"16765",2020,22,357,80,80,"51.520994","-0.139016","Howland Street, Fitzrovia",160
"16766",2020,22,358,31,32,"51.516226","-0.124826","High Holborn , Covent Garden",63
"16767",2020,22,359,65,64,"51.49782999","-0.135440826","Butler Place, Westminster",129
"16768",2020,22,360,73,62,"51.49675303","-0.138733562","Howick Place, Westminster",135
"16769",2020,22,361,35,8,"51.50391973","-0.11342629","Waterloo Station 2, Waterloo",43
"16770",2020,22,362,66,60,"51.536264","-0.133952","Royal College Street, Camden Town",126
"16771",2020,22,363,44,43,"51.5291212008901","-0.171185284853","Lord's, St. John's Wood",87
"16772",2020,22,364,39,34,"51.519656","-0.132339","Alfred Place, Bloomsbury",73
"16773",2020,22,365,71,70,"51.530344","-0.100168","City Road, Angel",141
"16774",2020,22,366,48,44,"51.5109192966489","-0.1511263847351","Millennium Hotel, Mayfair",92
"16775",2020,22,367,146,158,"51.5173721","-0.1642075","Harrowby Street, Marylebone",304
"16776",2020,22,368,98,107,"51.50024195","-0.15934065","Harriet Street, Knightsbridge",205
"16777",2020,22,370,48,50,"51.520205","-0.174593","Paddington Green, Paddington",98
"16778",2020,22,371,34,30,"51.49775","-0.10988","King Edward Walk, Waterloo",64
"16779",2020,22,372,9,9,"51.515208","-0.117863","Sardinia Street, Holborn",18
"16780",2020,22,373,34,32,"51.49980661","-0.176415994","Prince Consort Road, Knightsbridge",66
"16781",2020,22,374,149,123,"51.50402794","-0.11386436","Waterloo Station 1, Waterloo",272
"16782",2020,22,375,63,54,"51.50194596","-0.194392952","Kensington Town Hall, Kensington",117
"16783",2020,22,376,112,115,"51.49188409","-0.125674815","Millbank Tower, Pimlico",227
"16784",2020,22,377,55,49,"51.50535447","-0.113656543","Waterloo Bridge, South Bank",104
"16785",2020,22,378,80,66,"51.49559291","-0.179077626","Natural History Museum, South Kensington",146
"16786",2020,22,379,121,112,"51.51431171","-0.200838199","Turquoise Island, Notting Hill",233
"16787",2020,22,380,47,39,"51.50686435","-0.150666888","Stanhope Gate, Mayfair",86
"16788",2020,22,381,77,82,"51.51953043","-0.13577731","Charlotte Street, Fitzrovia",159
"16789",2020,22,382,36,37,"51.50935171","-0.14744969","Farm Street, Mayfair",73
"16790",2020,22,383,90,92,"51.51310333","-0.13121385","Frith Street, Soho",182
"16791",2020,22,384,52,56,"51.496481","-0.192404","Marloes Road, Kensington",108
"16792",2020,22,386,199,197,"51.51352755","-0.130110822","Moor Street, Soho",396
"16793",2020,22,387,157,155,"51.49369988","-0.121394101","Fire Brigade Pier, Vauxhall",312
"16794",2020,22,388,103,107,"51.51070161","-0.121723604","Southampton Street, Strand",210
"16795",2020,22,389,91,100,"51.51013066","-0.155757901","Upper Grosvenor Street, Mayfair",191
"16796",2020,22,390,41,47,"51.521776","-0.068856","Buxton Street 1, Shoreditch",88
"16797",2020,22,392,110,89,"51.49942855","-0.179702476","Imperial College, Knightsbridge",199
"16798",2020,22,393,30,29,"51.51733427","-0.103604248","Snow Hill, Farringdon",59
"16799",2020,22,394,96,94,"51.524826","-0.176268","Aberdeen Place, St. John's Wood",190
"16800",2020,22,395,148,146,"51.492462","-0.159919","Cadogan Gardens, Chelsea",294
"16801",2020,22,396,70,81,"51.51809","-0.163609","Shouldham Street, Marylebone",151
"16802",2020,22,397,167,157,"51.51348","-0.17977","Devonshire Terrace, Bayswater",324
"16803",2020,22,398,173,164,"51.502319","-0.200742","Holland Park, Kensington",337
"16804",2020,22,399,127,109,"51.52261762","-0.071653961","Brick Lane Market, Shoreditch",236
"16805",2020,22,400,104,104,"51.517703","-0.154106","George Street, Marylebone",208
"16806",2020,22,401,139,131,"51.528187","-0.075375","Columbia Road, Shoreditch",270
"16807",2020,22,402,60,57,"51.52289229","-0.171681991","Penfold Street, Marylebone",117
"16808",2020,22,403,76,78,"51.51689296","-0.158249929","George Place Mews, Marylebone",154
"16809",2020,22,404,579,580,"51.50204238","-0.184400221","Palace Gate, Kensington Gardens",1159
"16810",2020,22,405,159,159,"51.49418566","-0.18267094","Gloucester Road Station, South Kensington",318
"16811",2020,22,409,224,234,"51.493146","-0.099828","Strata, Elephant & Castle",458
"16812",2020,22,410,247,222,"51.519968","-0.169774","Edgware Road Station, Marylebone",469
"16813",2020,22,411,266,287,"51.49337264","-0.09968067","Walworth Road, Elephant & Castle",553
"16814",2020,22,412,71,71,"51.488105","-0.110121","Cleaver Street, Kennington",142
"16815",2020,22,419,282,285,"51.485821","-0.149004","Chelsea Bridge, Pimlico",567
"16816",2020,22,420,50,53,"51.504043","-0.105312","Southwark Station 1, Southwark",103
"16817",2020,22,421,40,37,"51.504044","-0.104778","Southwark Station 2, Southwark",77
"16818",2020,22,423,138,117,"51.49456127","-0.15393398","Eaton Square (South), Belgravia",255
"16819",2020,22,424,117,83,"51.490491","-0.149186","Ebury Bridge, Pimlico",200
"16820",2020,22,425,49,48,"51.533379","-0.139159","Harrington Square 2, Camden Town",97
"16821",2020,22,426,77,76,"51.493072","-0.129925","Vincent Street, Pimlico",153
"16822",2020,22,427,159,165,"51.51397065","-0.09294031","Cheapside, Bank",324
"16823",2020,22,428,190,191,"51.499917","-0.174554","Exhibition Road, Knightsbridge",381
"16824",2020,22,430,78,74,"51.48902","-0.17524","South Parade, Chelsea",152
"16825",2020,22,431,38,48,"51.534474","-0.122203","Crinan Street, King's Cross",86
"16826",2020,22,432,117,110,"51.496957","-0.173894","Exhibition Road Museums, South Kensington",227
"16827",2020,22,433,62,62,"51.524564","-0.116279","Wren Street, Holborn",124
"16828",2020,22,435,139,127,"51.488852","-0.105593","Kennington Station, Kennington",266
"16829",2020,22,436,83,79,"51.51824","-0.11655","Red Lion Street, Holborn",162
"16830",2020,22,437,109,95,"51.488124","-0.120903","Vauxhall Walk, Vauxhall",204
"16831",2020,22,439,47,51,"51.5338","-0.118677","Killick Street, King's Cross",98
"16832",2020,22,440,183,186,"51.483145","-0.113134","Kennington Oval, Oval",369
"16833",2020,22,441,64,53,"51.495656","-0.114605","Sail Street, Vauxhall",117
"16834",2020,22,442,57,58,"51.510101","-0.211358","Walmer Road, Avondale",115
"16835",2020,22,443,97,99,"51.515256","-0.058641","Philpot Street, Whitechapel",196
"16836",2020,22,444,98,96,"51.52568","-0.055312","Bethnal Green Garden, Bethnal Green",194
"16837",2020,22,445,79,83,"51.52388","-0.065076","Cheshire Street, Bethnal Green",162
"16838",2020,22,446,93,101,"51.528936","-0.055894","York Hall, Bethnal Green",194
"16839",2020,22,447,67,64,"51.493381","-0.007542","Jubilee Crescent, Cubitt Town",131
"16840",2020,22,448,189,191,"51.50623","-0.02296","Fisherman's Walk West, Canary Wharf",380
"16841",2020,22,449,216,222,"51.511088","-0.057159","Shadwell Station, Shadwell",438
"16842",2020,22,450,74,66,"51.515975","-0.053177","Jubilee Street, Stepney",140
"16843",2020,22,451,79,82,"51.504719","-0.063531","Hermitage Court, Wapping",161
"16844",2020,22,452,192,199,"51.505697","-0.070542","St. Katharine's Way, Tower",391
"16845",2020,22,453,125,123,"51.508447","-0.055167","Garnet Street, Shadwell",248
"16846",2020,22,454,121,117,"51.487679","-0.021582","Napier Avenue, Millwall",238
"16847",2020,22,455,120,115,"51.49447","-0.014409","East Ferry Road, Cubitt Town",235
"16848",2020,22,456,145,155,"51.538071","-0.144664","Parkway, Camden Town",300
"16849",2020,22,457,261,253,"51.542138","-0.145393","Castlehaven Road, Camden Town",514
"16850",2020,22,458,157,141,"51.504749","-0.057544","Wapping Lane, Wapping",298
"16851",2020,22,459,246,243,"51.535179","-0.03338","Gunmakers Lane, Old Ford",489
"16852",2020,22,460,138,135,"51.516196","-0.029138","Burdett Road, Mile End",273
"16853",2020,22,461,46,56,"51.516","-0.038775","Aston Street, Stepney",102
"16854",2020,22,462,264,264,"51.541603","-0.138853","Bonny Street, Camden Town",528
"16855",2020,22,463,51,51,"51.534776","-0.071881","Thurtle Road, Haggerston",102
"16856",2020,22,464,27,21,"51.51417","-0.052099","St. Mary & St. Michael Church, Stepney",48
"16857",2020,22,465,92,96,"51.53558","-0.08249","Pitfield Street North,Hoxton",188
"16858",2020,22,466,72,83,"51.534464","-0.076341","Whiston Road, Haggerston",155
"16859",2020,22,467,72,80,"51.523538","-0.030556","Southern Grove, Bow",152
"16860",2020,22,468,35,31,"51.521564","-0.022694","Cantrell Road, Bow",66
"16861",2020,22,469,98,108,"51.513757","-0.020467","Lindfield Street, Poplar",206
"16862",2020,22,470,97,81,"51.530535","-0.025492","Mostyn Grove, Bow",178
"16863",2020,22,471,93,90,"51.533283","-0.028155","Hewison Street, Old Ford",183
"16864",2020,22,472,20,17,"51.529452","-0.027616","Malmesbury Road, Bow",37
"16865",2020,22,473,41,52,"51.496137","-0.019355","Millharbour, Millwall",93
"16866",2020,22,475,189,176,"51.499041","-0.020157","Lightermans Road, Millwall",365
"16867",2020,22,476,156,172,"51.489096","-0.009205","Stebondale Street, Cubitt Town",328
"16868",2020,22,477,109,111,"51.49109","-0.018716","Spindrift Avenue, Millwall",220
"16869",2020,22,478,169,168,"51.521889","-0.04667","Stepney Green Station, Stepney",337
"16870",2020,22,479,128,133,"51.527152","-0.058005","Pott Street, Bethnal Green",261
"16871",2020,22,480,292,287,"51.5128711","-0.0389866","Flamborough Street, Limehouse",579
"16872",2020,22,481,342,343,"51.487129","-0.009001","Saunders Ness Road, Cubitt Town",685
"16873",2020,22,483,144,147,"51.51328","-0.047784","Albert Gardens, Stepney",291
"16874",2020,22,484,126,111,"51.528828","-0.013258","Bromley High Street, Bow",237
"16875",2020,22,485,172,177,"51.531127","-0.048017","Old Ford Road, Bethnal Green",349
"16876",2020,22,486,162,143,"51.525645","-0.069543","Granby Street, Shoreditch",305
"16877",2020,22,487,87,77,"51.511811","-0.025626","Canton Street, Poplar",164
"16878",2020,22,488,88,98,"51.506946","-0.058681","Reardon Street, Wapping",186
"16879",2020,22,489,95,105,"51.513074","-0.064094","Christian Street, Whitechapel",200
"16880",2020,22,490,58,47,"51.508622","-0.065006","Pennington Street, Wapping",105
"16881",2020,22,491,114,114,"51.522507","-0.041378","Queen Mary's, Mile End",228
"16882",2020,22,492,187,147,"51.525501","-0.032267204","Maplin Street, Mile End",334
"16883",2020,22,494,12,10,"51.50196","-0.016251","South Quay East, Canary Wharf",22
"16884",2020,22,495,194,175,"51.528169","-0.018703","Bow Church Station, Bow",369
"16885",2020,22,496,124,132,"51.52512","-0.015578","Devons Road, Bow",256
"16886",2020,22,497,62,67,"51.526149","-0.027396845","Merchant Street, Bow",129
"16887",2020,22,498,115,116,"51.527058","-0.025296","Bow Road Station, Bow",231
"16888",2020,22,499,120,123,"51.519265","-0.021345","Furze Green, Bow",243
"16889",2020,22,500,146,158,"51.519806","-0.055731","Ansell House, Stepney",304
"16890",2020,22,501,82,71,"51.522561","-0.054883","Cephas Street, Bethnal Green",153
"16891",2020,22,502,405,412,"51.53341","-0.049591815","Bonner Gate, Victoria Park",817
"16892",2020,22,503,184,179,"51.520893","-0.051394","Cleveland Way, Stepney",363
"16893",2020,22,504,57,54,"51.496454","-0.009506","St. John's Park, Cubitt Town",111
"16894",2020,22,505,84,81,"51.520398","-0.026768","Ackroyd Drive, Bow",165
"16895",2020,22,506,67,71,"51.517475","-0.075855","Bell Lane, Liverpool Street",138
"16896",2020,22,507,40,32,"51.528692","-0.059091","Clarkson Street, Bethnal Green",72
"16897",2020,22,508,66,56,"51.519362","-0.074431","Fournier Street, Whitechapel",122
"16898",2020,22,509,13,12,"51.517842","-0.090075","Fore Street, Guildhall",25
"16899",2020,22,510,304,324,"51.509303","-0.025996","Westferry DLR, Limehouse",628
"16900",2020,22,511,215,224,"51.511066","-0.053558","Sutton Street, Shadwell",439
"16901",2020,22,512,116,117,"51.532091","-0.06142","Pritchard's Road, Bethnal Green",233
"16902",2020,22,513,86,83,"51.5142228","-0.055656","Watney Market, Stepney",169
"16903",2020,22,514,65,70,"51.516204","-0.155525","Portman Square, Marylebone",135
"16904",2020,22,515,78,70,"51.500088","-0.211316","Russell Gardens, Olympia",148
"16905",2020,22,516,97,102,"51.5112","-0.014438","Chrisp Street Market, Poplar",199
"16906",2020,22,517,80,81,"51.532513","-0.033085","Ford Road, Old Ford",161
"16907",2020,22,518,120,118,"51.528224","-0.037471","Antill Road, Mile End",238
"16908",2020,22,519,33,46,"51.518811","-0.011662","Teviot Street, Poplar",79
"16909",2020,22,520,80,70,"51.526041","-0.047218","Bancroft Road, Bethnal Green",150
"16910",2020,22,521,226,226,"51.534137","-0.037366","Driffield Road, Old Ford",452
"16911",2020,22,522,200,177,"51.525941","-0.036017","Clinton Road, Mile End",377
"16912",2020,22,523,67,70,"51.51549","-0.013475","Langdon Park, Poplar",137
"16913",2020,22,524,145,135,"51.511654","-0.179668","Lancaster Gate , Bayswater",280
"16914",2020,22,526,75,77,"51.503143","-0.008428","Lancaster Drive, Blackwall",152
"16915",2020,22,527,128,131,"51.503802","-0.215808","Hansard Mews, Holland Park",259
"16916",2020,22,528,39,40,"51.507326","-0.145827","Clarges Street, Mayfair",79
"16917",2020,22,529,94,79,"51.486892","-0.170983","Manresa Road, Chelsea",173
"16918",2020,22,530,96,98,"51.508896","-0.012413","Newby Place, Poplar",194
"16919",2020,22,531,183,179,"51.530326","-0.042744","Twig Folly Bridge, Mile End",362
"16920",2020,22,532,196,202,"51.50357","-0.020068","Jubilee Plaza, Canary Wharf",398
"16921",2020,22,533,80,63,"51.528222","-0.069743","Wellington Row, Bethnal Green",143
"16922",2020,22,534,153,174,"51.531864","-0.066035","Goldsmith's Row, Haggerston",327
"16923",2020,22,535,211,227,"51.537349","-0.147154","Gloucester Avenue, Camden Town",438
"16924",2020,22,536,89,87,"51.53385","-0.06992","Queensbridge Road, Haggerston",176
"16925",2020,22,537,117,113,"51.51793","-0.067937","Old Montague Street, Whitechapel",230
"16926",2020,22,538,102,103,"51.508981","-0.00699","Naval Row, Blackwall",205
"16927",2020,22,540,235,228,"51.528302","-0.144466","Albany Street, The Regent's Park",463
"16928",2020,22,541,329,347,"51.506613","-0.142844","Green Park Station, Mayfair",676
"16929",2020,22,542,134,123,"51.514115","-0.033828","Salmon Lane, Limehouse",257
"16930",2020,22,543,42,37,"51.509591","-0.204666","Lansdowne Walk, Ladbroke Grove",79
"16931",2020,22,544,54,56,"51.526153","-0.102208","Percival Street, Finsbury",110
"16932",2020,22,545,108,112,"51.539957","-0.145246","Arlington Road, Camden Town",220
"16933",2020,22,546,52,59,"51.517428","-0.107987","New Fetter Lane, Holborn",111
"16934",2020,22,547,272,274,"51.509474","-0.002275","East India DLR, Blackwall",546
"16935",2020,22,548,35,37,"51.498386","-0.107913","Westminster Bridge Road, Elephant & Castle",72
"16936",2020,22,549,71,66,"51.49605","-0.104193","Gaywood  Street, Elephant & Castle",137
"16937",2020,22,550,91,72,"51.521564","-0.039264","Harford Street, Mile End",163
"16938",2020,22,551,32,32,"51.505772","-0.016460175","Import Dock, Canary Wharf",64
"16939",2020,22,552,117,103,"51.511542","-0.056667","Watney Street, Shadwell",220
"16940",2020,22,553,546,541,"51.535678","-0.062546","Regent's Row , Haggerston",1087
"16941",2020,22,554,64,64,"51.513548","-0.005659","Aberfeldy Street, Poplar",128
"16942",2020,22,556,39,41,"51.502661","-0.021596","Heron Quays DLR, Canary Wharf",80
"16943",2020,22,557,48,49,"51.51601","-0.0985","King Edward Street, St Pauls",97
"16944",2020,22,558,92,90,"51.493978","-0.127554","Page Street, Westminster",182
"16945",2020,22,559,101,99,"51.501391","-0.205991","Abbotsbury Road, Holland Park",200
"16946",2020,22,560,49,43,"51.511624","-0.205921","Ladbroke Grove Central, Ladbroke Grove",92
"16947",2020,22,561,68,61,"51.518369","-0.043371","Rectory Square, Stepney",129
"16948",2020,22,562,56,58,"51.51746","-0.12335","Bury Place, Holborn",114
"16949",2020,22,563,95,98,"51.499286","-0.009152","Preston's Road, Cubitt Town",193
"16950",2020,22,564,473,476,"51.509943","-0.117619","Somerset House, Strand",949
"16951",2020,22,565,49,38,"51.521905","-0.063386","Selby Street, Whitechapel",87
"16952",2020,22,566,145,147,"51.509158","-0.224103","Westfield Ariel Way, White City",292
"16953",2020,22,568,140,140,"51.51616","-0.18697","Bishop's Bridge Road West, Bayswater",280
"16954",2020,22,569,65,61,"51.53213","-0.08299","Pitfield Street Central, Hoxton",126
"16955",2020,22,570,144,130,"51.503083","-0.017676","Upper Bank Street, Canary Wharf",274
"16956",2020,22,571,85,91,"51.506256","-0.218337","Westfield Southern Terrace ,Shepherd's Bush",176
"16957",2020,22,572,220,230,"51.539099","-0.141728","Greenland Road, Camden Town",450
"16958",2020,22,573,188,190,"51.485587","-0.18119","Limerston Street, West Chelsea",378
"16959",2020,22,574,151,144,"51.53356","-0.09315","Eagle Wharf Road, Hoxton",295
"16960",2020,22,576,149,142,"51.497304","-0.022793","Alpha Grove, Millwall",291
"16961",2020,22,577,108,112,"51.528869","-0.047548","Globe Town Market, Bethnal Green",220
"16962",2020,22,578,58,43,"51.527607","-0.057133","Hollybush Gardens, Bethnal Green",101
"16963",2020,22,579,286,293,"51.511246","-0.093051","Queen Street 2, Bank",579
"16964",2020,22,580,163,169,"51.48692917","-0.102996299","Doddington Grove, Kennington",332
"16965",2020,22,581,97,102,"51.519167","-0.147983","New Cavendish Street, Marylebone",199
"16966",2020,22,583,220,212,"51.497622","-0.125978","Abingdon Green, Westminster",432
"16967",2020,22,584,106,97,"51.51244","-0.19096","Ilchester Gardens, Bayswater",203
"16968",2020,22,586,70,62,"51.490645","-0.014582","Mudchute DLR, Cubitt Town",132
"16969",2020,22,587,201,208,"51.50964","-0.08497","Monument Street, Monument",409
"16970",2020,22,588,49,55,"51.52959","-0.0801","Hoxton Street, Hoxton",104
"16971",2020,22,589,178,186,"51.487196","-0.179369","Drayton Gardens, West Chelsea",364
"16972",2020,22,590,84,70,"51.53256","-0.16862","Greenberry Street, St.John's Wood",154
"16973",2020,22,592,57,58,"51.5171","-0.18377","Bishop's Bridge Road East, Bayswater",115
"16974",2020,22,593,45,49,"51.531066","-0.11934","Northdown Street, King's Cross",94
"16975",2020,22,594,33,31,"51.513875","-0.117774","Kingsway Southbound, Strand",64
"16976",2020,22,595,152,145,"51.493267","-0.21985","Hammersmith Road, Hammersmith",297
"16977",2020,22,596,193,191,"51.472817","-0.199783","Parson's Green , Parson's Green",384
"16978",2020,22,597,125,113,"51.473471","-0.20782","Fulham Park Road, Fulham",238
"16979",2020,22,598,157,157,"51.494499","-0.228188","Southerton Road, Hammersmith",314
"16980",2020,22,599,81,70,"51.485743","-0.223616","Manbre Road, Hammersmith",151
"16981",2020,22,600,186,186,"51.481747","-0.124642","South Lambeth Road, Vauxhall",372
"16982",2020,22,601,148,159,"51.514767","-0.225787","BBC White City, White City",307
"16983",2020,22,602,151,178,"51.472993","-0.133972","Union Grove, Wandsworth Road",329
"16984",2020,22,603,182,186,"51.477839","-0.116493","Caldwell Street, Stockwell",368
"16985",2020,22,604,58,71,"51.538792","-0.138535","St Martins Close, Camden Town",129
"16986",2020,22,605,110,104,"51.520331","-0.163667","Seymour Place, Marylebone",214
"16987",2020,22,606,42,49,"51.504199","-0.210941","Addison Road, Holland Park",91
"16988",2020,22,607,158,147,"51.468814","-0.210279","Putney Bridge Station, Fulham",305
"16989",2020,22,608,19,25,"51.491093","-0.216493","Colet Gardens, Hammersmith",44
"16990",2020,22,609,103,105,"51.46512358","-0.157788279","Sugden Road, Clapham",208
"16991",2020,22,610,234,239,"51.48256792","-0.172078187","Danvers Street, West Chelsea",473
"16992",2020,22,611,131,126,"51.50646524","-0.208486599","Princedale Road , Holland Park",257
"16993",2020,22,612,186,191,"51.46925984","-0.141812513","Wandsworth Rd, Isley Court, Wandsworth Road",377
"16994",2020,22,613,158,155,"51.50403821","-0.217400093","Woodstock Grove, Shepherd's Bush",313
"16995",2020,22,614,74,75,"51.47817208","-0.144690541","Bradmead, Battersea Park",149
"16996",2020,22,615,172,155,"51.4768851","-0.215895601","Finlay Street, Fulham",327
"16997",2020,22,616,95,91,"51.48102131","-0.209973497","Aintree Street, Fulham",186
"16998",2020,22,617,51,47,"51.47107905","-0.207842908","Elysium Place, Fulham",98
"16999",2020,22,618,185,183,"51.47625965","-0.193254007","Eel Brook Common, Walham Green",368
"17000",2020,22,619,104,115,"51.4737636","-0.197010096","Irene Road, Parsons Green",219
"17001",2020,22,620,115,122,"51.47518024","-0.167160736","Surrey Lane, Battersea",237
"17002",2020,22,621,175,174,"51.46086446","-0.187427294","Wandsworth Town Station, Wandsworth",349
"17003",2020,22,622,138,153,"51.50748124","-0.205535908","Lansdowne Road, Ladbroke Grove",291
"17004",2020,22,623,107,106,"51.46193072","-0.180791784","Nantes Close, Wandsworth",213
"17005",2020,22,624,158,186,"51.4729184","-0.132102704","Courland Grove, Wandsworth Road",344
"17006",2020,22,625,576,619,"51.47761941","-0.149551631","Queen's Circus, Battersea Park",1195
"17007",2020,22,626,145,155,"51.48438657","-0.20481514","Normand Park, West Kensington",300
"17008",2020,22,627,26,41,"51.4687905","-0.158230901","Holden Street, Battersea",67
"17009",2020,22,628,144,132,"51.46881971","-0.184318843","William Morris Way, Sands End",276
"17010",2020,22,629,75,84,"51.45995384","-0.190184054","Morie Street, Wandsworth",159
"17011",2020,22,630,112,117,"51.47073264","-0.126994068","Clarence Walk, Stockwell",229
"17012",2020,22,631,79,80,"51.4795017","-0.141770709","Battersea Park Road, Nine Elms",159
"17013",2020,22,632,53,48,"51.47053858","-0.163041605","Sheepcote Lane, Battersea",101
"17014",2020,22,633,167,169,"51.48959104","-0.209378594","Vereker Road, West Kensington",336
"17015",2020,22,634,69,84,"51.49434708","-0.215804559","Brook Green South, Brook Green",153
"17016",2020,22,635,109,113,"51.48606206","-0.214428378","Greyhound Road, Hammersmith",222
"17017",2020,22,636,67,82,"51.46706414","-0.193502076","South Park, Sands End",149
"17018",2020,22,637,213,204,"51.45787019","-0.174691623","Spencer Park, Wandsworth Common",417
"17019",2020,22,638,121,132,"51.46663393","-0.169821175","Falcon Road, Clapham Junction",253
"17020",2020,22,639,89,89,"51.48357068","-0.202038682","Coomer Place, West Kensington",178
"17021",2020,22,640,136,150,"51.47286577","-0.148059277","Silverthorne Road, Battersea",286
"17022",2020,22,641,110,102,"51.49824168","-0.117495865","Archbishop's Park, Waterloo",212
"17023",2020,22,642,57,72,"51.46916161","-0.174485792","Fawcett Close, Battersea",129
"17024",2020,22,643,115,107,"51.5190427","-0.204764421","All Saints' Road, Portobello",222
"17025",2020,22,644,102,102,"51.48373225","-0.223852256","Rainville Road, Hammersmith",204
"17026",2020,22,645,45,40,"51.50173215","-0.100292412","Great Suffolk Street, The Borough",85
"17027",2020,22,646,241,240,"51.49886563","-0.137424571","Buckingham Gate, Westminster",481
"17028",2020,22,647,130,134,"51.50035306","-0.217515071","Richmond Way, Shepherd's Bush",264
"17029",2020,22,648,92,84,"51.46904022","-0.19627483","Peterborough Road, Sands End",176
"17030",2020,22,649,132,142,"51.48180515","-0.18027465","World's End Place, West Chelsea",274
"17031",2020,22,650,175,160,"51.51687069","-0.213872396","St. Mark's Road, North Kensington",335
"17032",2020,22,651,54,71,"51.48089844","-0.183853573","Thorndike Close, West Chelsea",125
"17033",2020,22,652,41,50,"51.51148696","-0.218190203","Evesham Street, Avondale",91
"17034",2020,22,653,124,118,"51.47084722","-0.17070367","Simpson Street, Clapham Junction",242
"17035",2020,22,654,91,112,"51.48267821","-0.117661574","Ashmole Estate, Oval",203
"17036",2020,22,655,94,84,"51.48294452","-0.219346128","Crabtree Lane, Fulham",178
"17037",2020,22,656,45,37,"51.46841875","-0.199135704","Broomhouse Lane, Parsons Green",82
"17038",2020,22,657,113,113,"51.4996806","-0.221791552","Blythe Road West, Shepherd's Bush",226
"17039",2020,22,658,408,409,"51.47729232","-0.16478637","Ethelburga Estate, Battersea Park",817
"17040",2020,22,659,161,161,"51.511934","-0.10307894","Blackfriars Station, St. Paul's",322
"17041",2020,22,660,92,91,"51.49087074","-0.206029743","West Kensington Station, West Kensington",183
"17042",2020,22,661,190,183,"51.51632095","-0.202608612","All Saints Church, Portobello",373
"17043",2020,22,662,170,154,"51.48498496","-0.167919869","Phene Street, Chelsea",324
"17044",2020,22,663,76,77,"51.51323001","-0.211593602","Clarendon Road, Avondale",153
"17045",2020,22,664,188,196,"51.474376","-0.155442787","Austin Road, Battersea Park",384
"17046",2020,22,665,118,124,"51.46108367","-0.191722864","Smugglers Way, Wandsworth",242
"17047",2020,22,666,127,128,"51.49610093","-0.208158259","Olympia Way, Olympia",255
"17048",2020,22,667,158,158,"51.5015946","-0.222293381","Shepherd's Bush Road North, Shepherd's Bush",316
"17049",2020,22,668,356,371,"51.49422354","-0.236769936","Ravenscourt Park Station, Hammersmith",727
"17050",2020,22,669,80,101,"51.47614939","-0.1232585","Teversham Lane, Stockwell",181
"17051",2020,22,670,117,114,"51.46718562","-0.152248582","Ashley Crescent, Battersea",231
"17052",2020,22,671,92,94,"51.475089","-0.201968","Parsons Green Station, Parsons Green",186
"17053",2020,22,673,177,184,"51.46517078","-0.18038939","Hibbert Street, Battersea",361
"17054",2020,22,674,71,87,"51.53546778","-0.11619105","Carnegie Street, King's Cross",158
"17055",2020,22,675,97,95,"51.46348914","-0.182126248","Usk Road, Clapham Junction",192
"17056",2020,22,676,114,128,"51.47787084","-0.126874471","Hartington Road, Stockwell",242
"17057",2020,22,677,66,92,"51.46866929","-0.146544642","Heath Road, Battersea",158
"17058",2020,22,678,40,72,"51.46231278","-0.211468596","Esmond Street, Putney",112
"17059",2020,22,679,88,63,"51.47453545","-0.170210533","Orbel Street, Battersea",151
"17060",2020,22,680,214,220,"51.47768469","-0.170329317","Westbridge Road, Battersea",434
"17061",2020,22,681,118,173,"51.47303687","-0.214749808","Bishop's Avenue, Fulham",291
"17062",2020,22,682,325,318,"51.48810829","-0.22660621","Crisp Road, Hammersmith",643
"17063",2020,22,683,101,88,"51.46506424","-0.163750945","Dorothy Road, Clapham Junction",189
"17064",2020,22,684,202,201,"51.45475251","-0.195197203","Neville Gill Close, Wandsworth",403
"17065",2020,22,685,114,118,"51.46067005","-0.198735357","Osiers Road, Wandsworth",232
"17066",2020,22,686,84,70,"51.48814438","-0.222456468","Beryl Road, Hammersmith",154
"17067",2020,22,687,123,123,"51.49760804","-0.21145598","Maclise Road, Olympia",246
"17068",2020,22,688,124,127,"51.46095151","-0.20066766","Northfields, Wandsworth",251
"17069",2020,22,689,63,52,"51.45922541","-0.180884959","Spanish Road, Clapham Junction",115
"17070",2020,22,690,60,57,"51.47047503","-0.152130083","Stanley Grove, Battersea",117
"17071",2020,22,691,175,195,"51.47946386","-0.195777222","Erin Close, Walham Green",370
"17072",2020,22,692,275,287,"51.54211855","-0.028941601","Cadogan Close, Victoria Park",562
"17073",2020,22,693,123,125,"51.464786","-0.215618902","Felsham Road, Putney",248
"17074",2020,22,694,206,222,"51.46071722","-0.216526155","Putney Rail Station, Putney",428
"17075",2020,22,695,386,398,"51.53638435","-0.102757578","Islington Green, Angel",784
"17076",2020,22,696,46,55,"51.48728535","-0.217995921","Charing Cross Hospital, Hammersmith",101
"17077",2020,22,697,128,136,"51.53639219","-0.112721065","Charlotte Terrace, Angel",264
"17078",2020,22,698,178,168,"51.53908372","-0.070329419","Shoreditch Court, Haggerston",346
"17079",2020,22,699,93,76,"51.5366541","-0.07023031","Belford House, Haggerston",169
"17080",2020,22,700,112,113,"51.47696496","-0.174347066","Battersea Church Road, Battersea",225
"17081",2020,22,701,154,164,"51.47287627","-0.176267008","Vicarage Crescent, Battersea",318
"17082",2020,22,702,104,104,"51.52868155","-0.065550321","Durant Street, Bethnal Green",208
"17083",2020,22,703,61,62,"51.51505991","-0.10534448","St. Bride Street, Holborn",123
"17084",2020,22,704,62,59,"51.45682071","-0.202802098","Mexfield Road, East Putney",121
"17085",2020,22,705,119,118,NA,NA,NA,237
"17086",2020,22,706,131,144,"51.50215353","-0.083632928","Snowsfields, London Bridge",275
"17087",2020,22,707,93,113,"51.49021762","-0.215087092","Barons Court Station, West Kensington",206
"17088",2020,22,708,102,106,"51.46161068","-0.21614583","Disraeli Road, Putney",208
"17089",2020,22,709,76,100,"51.46321128","-0.215550761","Montserrat Road , Putney",176
"17090",2020,22,710,405,406,"51.47439218","-0.163347594","Albert Bridge Road, Battersea Park",811
"17091",2020,22,711,88,94,"51.48335692","-0.216305546","Everington Street, Fulham",182
"17092",2020,22,712,148,148,"51.51854104","-0.034903714","Mile End Stadium, Mile End",296
"17093",2020,22,713,112,103,"51.54100708","-0.14326094","Hawley Crescent, Camden Town",215
"17094",2020,22,714,54,45,"51.47311696","-0.137235175","Stewart's Road, Wandsworth Road",99
"17095",2020,22,715,64,68,"51.51563007","-0.049067243","Aylward Street, Stepney",132
"17096",2020,22,716,120,108,"51.51542791","-0.02356501","Stainsby Road , Poplar",228
"17097",2020,22,717,242,241,"51.53658514","-0.075885686","Dunston Road , Haggerston",483
"17098",2020,22,718,177,186,"51.53571683","-0.060291813","Ada Street, Hackney Central",363
"17099",2020,22,719,304,310,"51.53642464","-0.054162264","Victoria Park Road, Hackney Central",614
"17100",2020,22,720,95,109,"51.48724429","-0.205279052","Star Road, West Kensington",204
"17101",2020,22,721,103,106,"51.53603947","-0.026262677","Wendon Street, Old Ford",209
"17102",2020,22,722,58,61,"51.52458353","-0.058631453","Finnis Street, Bethnal Green",119
"17103",2020,22,723,181,178,"51.46822047","-0.190346493","Stephendale Road, Sands End",359
"17104",2020,22,724,50,60,"51.45799126","-0.184806157","Alma Road, Wandsworth",110
"17105",2020,22,725,178,181,"51.491327","-0.096518684","Walworth Square, Walworth",359
"17106",2020,22,726,152,152,"51.47505096","-0.150908371","Alfreda Street, Battersea Park",304
"17107",2020,22,727,128,128,"51.47569809","-0.20587627","Chesilton Road, Fulham",256
"17108",2020,22,728,181,158,"51.46199911","-0.206240805","Putney Bridge Road, East Putney",339
"17109",2020,22,729,136,127,"51.47893931","-0.208485293","St. Peter's Terrace, Fulham",263
"17110",2020,22,730,205,215,"51.49208492","-0.229116862","Bridge Avenue, Hammersmith",420
"17111",2020,22,731,83,72,"51.47727637","-0.189210466","Michael Road, Walham Green",155
"17112",2020,22,732,311,310,"51.50630441","-0.087262995","Duke Street Hill, London Bridge",621
"17113",2020,22,733,106,121,"51.50542628","-0.150817316","Park Lane, Mayfair",227
"17114",2020,22,734,100,93,"51.46230566","-0.175407201","Plough Terrace, Clapham Junction",193
"17115",2020,22,735,58,60,"51.46489445","-0.17302926","Grant Road East, Clapham Junction",118
"17116",2020,22,736,85,91,"51.50659035","-0.216104479","Queensdale Road, Shepherd's Bush",176
"17117",2020,22,737,181,190,"51.47993289","-0.19411695","Fulham Broadway, Walham Green",371
"17118",2020,22,738,66,67,"51.47514228","-0.187278987","Imperial Road, Sands End",133
"17119",2020,22,739,130,134,"51.48176572","-0.185273723","Hortensia Road, West Brompton",264
"17120",2020,22,740,50,41,"51.51092871","-0.214594781","Sirdar Road, Avondale",91
"17121",2020,22,741,37,48,"51.5129814","-0.219486603","Freston Road, Avondale",85
"17122",2020,22,742,158,161,"51.51510818","-0.208565479","Blenheim Crescent, Ladbroke Grove",319
"17123",2020,22,743,72,72,"51.46079243","-0.212607684","Oxford Road, Putney",144
"17124",2020,22,744,71,54,"51.46745485","-0.172293499","Ingrave Street, Clapham Junction",125
"17125",2020,22,745,61,57,"51.47816972","-0.18243547","Upcerne Road, West Chelsea",118
"17126",2020,22,746,165,167,"51.4795738","-0.17903854","Lots Road, West Chelsea",332
"17127",2020,22,747,131,124,"51.48796408","-0.161765173","Ormonde Gate, Chelsea",255
"17128",2020,22,748,125,125,"51.53727795","-0.079201849","Hertford Road, De Beauvoir Town",250
"17129",2020,22,749,250,247,"51.53932857","-0.074284675","Haggerston Road, Haggerston",497
"17130",2020,22,750,47,48,"51.4710956","-0.157850096","Culvert Road, Battersea",95
"17131",2020,22,751,25,24,"51.51612862","-0.120909408","Newton Street, Covent Garden",49
"17132",2020,22,754,34,28,"51.5129006","-0.214762686","Grenfell Road, Avondale",62
"17133",2020,22,755,168,143,"51.48512191","-0.174971902","The Vale, Chelsea",311
"17134",2020,22,756,306,304,"51.47515398","-0.159169801","Prince of Wales Drive, Battersea Park",610
"17135",2020,22,757,184,190,"51.48795853","-0.187404506","Harcourt Terrace, West Brompton",374
"17136",2020,22,758,147,141,"51.51787005","-0.201005397","Westbourne Park Road, Portobello",288
"17137",2020,22,759,30,28,"51.52456169","-0.165668686","Broadley Terrace, Marylebone",58
"17138",2020,22,760,77,74,"51.52526975","-0.163795009","Rossmore Road, Marylebone",151
"17139",2020,22,761,40,54,"51.48321729","-0.211860644","Humbolt Road, Fulham",94
"17140",2020,22,762,451,472,"51.50070305","-0.129698963","Storey's Gate, Westminster",923
"17141",2020,22,763,107,110,"51.52059714","-0.032566533","Mile End Park Leisure Centre, Mile End",217
"17142",2020,22,764,106,133,"51.46239255","-0.16829214","St. John's Road, Clapham Junction",239
"17143",2020,22,765,84,82,"51.46760141","-0.20682737","Ranelagh Gardens, Fulham",166
"17144",2020,22,766,181,185,"51.45752945","-0.192165613","Ram Street, Wandsworth",366
"17145",2020,22,767,52,56,"51.45705988","-0.200806304","Santos Road, Wandsworth",108
"17146",2020,22,768,590,606,"51.46134382","-0.159322467","Clapham Common North Side, Clapham Common",1196
"17147",2020,22,769,94,87,"51.473611","-0.191803","Sandilands Road, Walham Green",181
"17148",2020,22,770,98,103,"51.491026","-0.209121","Gwendwr Road, West Kensington",201
"17149",2020,22,771,53,50,"51.509224","-0.216016","Rifle Place, Avondale",103
"17150",2020,22,772,205,222,"51.47250956","-0.122831913","Binfield Road, Stockwell",427
"17151",2020,22,773,96,94,"51.511891","-0.107349","Tallis Street, Temple",190
"17152",2020,22,774,70,74,"51.470131","-0.20464","Hurlingham Park, Parsons Green",144
"17153",2020,22,775,93,109,"51.496664","-0.223868","Little Brook Green, Brook Green",202
"17154",2020,22,776,186,199,"51.460333","-0.167029","Abyssinia Close, Clapham Junction",385
"17155",2020,22,777,65,80,"51.4619230679","-0.165297856693","Limburg Road, Clapham Junction",145
"17156",2020,22,779,37,37,"51.514449","-0.077178979","Houndsditch, Aldgate",74
"17157",2020,22,780,184,183,"51.474665","-0.18316517","Imperial Wharf Station, Sands End",367
"17158",2020,22,781,72,53,"51.495898","-0.173009","Victoria & Albert Museum, South Kensington",125
"17159",2020,22,782,144,147,"51.483911","-0.19760944","Halford Road, West Kensington",291
"17160",2020,22,783,196,209,"51.5403115","-0.021630359","Monier Road, Hackney Wick",405
"17161",2020,22,784,326,326,"51.546326","-0.00993526","East Village, Queen Elizabeth Olympic Park",652
"17162",2020,22,785,603,617,"51.54094","-0.010510565","Aquatic Centre, Queen Elizabeth Olympic Park",1220
"17163",2020,22,786,457,457,"51.549369","-0.015717614","Lee Valley VeloPark, Queen Elizabeth Olympic Park",914
"17164",2020,22,787,435,426,"51.546805","-0.01469126","Timber Lodge, Queen Elizabeth Olympic Park",861
"17165",2020,22,789,523,521,"51.538718","-0.011889482","Podium, Queen Elizabeth Olympic Park",1044
"17166",2020,22,790,175,181,"51.541793","-0.00481","Stratford Station, Stratford",356
"17167",2020,22,792,91,92,"51.505461","-0.10454093","Blackfriars Road, Southwark",183
"17168",2020,22,793,49,55,"51.528279","-0.11955857","Cromer Street, Bloomsbury",104
"17169",2020,22,795,20,21,"51.527068","-0.13186102","Euston Square Gardens, Euston",41
"17170",2020,22,796,56,50,"51.524","-0.12640984","Coram Street, Bloomsbury",106
"17171",2020,22,797,59,51,"51.5293","-0.12827903","Ossulston Street, Somers Town",110
"17172",2020,22,798,108,91,"51.5301998755","-0.122299440803","Birkenhead Street, King's Cross",199
"17173",2020,22,799,72,54,"51.4976984561","-0.137598896295","Kings Gate House, Westminster",126
"17174",2020,22,800,194,208,"51.4811219398","-0.149035374873","Sopwith Way, Battersea Park",402
"17175",2020,22,801,63,71,"51.5052241745","-0.0980318118664","Lavington Street, Bankside",134
"17176",2020,22,802,175,171,"51.4765900593","-0.118256789081","Albert Square, Stockwell",346
"17177",2020,22,803,78,74,"51.5054099403","-0.0983410884509","Southwark Street, Bankside",152
"17178",2020,22,804,154,158,"51.5346677396","-0.125078652873","Good's Way, King's Cross",312
"17179",2020,22,806,106,120,"51.5372405623","-0.124807385707","Handyside Street, King's Cross",226
"17180",2020,22,807,229,231,"51.5212","-0.20888818","Bevington Road West, North Kensington",460
"17181",2020,22,809,51,54,"51.5162778834","-0.118272991635","Lincoln's Inn Fields, Holborn",105
"17182",2020,22,810,43,52,"51.5067252868","-0.0988072461627","Tate Modern, Bankside",95
"17183",2020,22,811,303,328,"51.5057030357","-0.0277727426235","Westferry Circus, Canary Wharf",631
"17184",2020,22,812,235,250,"51.5487311915","-0.0226065549321","Here East North, Queen Elizabeth Olympic Park",485
"17185",2020,22,813,46,73,"51.4878074485","-0.122759625866","New Spring Gardens Walk, Vauxhall",119
"17186",2020,22,814,195,181,"51.4714330677","-0.123670735702","Clapham Road, Lingham Street, Stockwell",376
"17187",2020,22,815,264,264,"51.5000891978","-0.116628700672","Lambeth Palace Road, Waterloo",528
"17188",2020,22,816,166,170,"51.5465327935","-0.0205975904647","Here East South, Queen Elizabeth Olympic Park",336
"17189",2020,22,817,208,206,"51.4813354746","-0.138212295869","Riverlight South, Nine Elms",414
"17190",2020,22,818,672,687,"51.501513","-0.12382322","Westminster Pier, Westminster",1359
"17191",2020,22,819,107,117,"51.50621","-0.114842","Belvedere Road 2, South Bank",224
"17192",2020,22,820,82,85,"51.492807","-0.091938","Victory Place, Walworth",167
"17193",2020,22,821,413,422,"51.4835074867","-0.147714557371","Battersea Power Station, Battersea Park",835
"17194",2020,22,826,131,141,"51.496863","-0.1429434","Allington Street, Victoria",272
"17195",2020,22,827,167,159,"51.479601","-0.11147178","Cranmer Road, Stockwell",326
"17196",2020,22,828,156,145,"51.473874","-0.11258096","Normandy Road, Stockwell",301
"17197",2020,22,829,73,83,"51.469217","-0.11268674","Wynne Road, Stockwell",156
"17198",2020,22,830,123,116,"51.469202","-0.11902256","Sidney Road, Stockwell",239
"17199",2020,22,831,200,208,"51.466232","-0.11317995","St John's Crescent, Brixton",408
"17200",2020,22,832,173,187,"51.464019","-0.11578197","Ferndale Road, Brixton",360
"17201",2020,22,833,519,548,"51.460232","-0.11537509","Saltoun Road, Brixton",1067
"17202",2020,22,834,324,333,"51.477966","-0.14785703","Gas Holders, Battersea Park",657
"17203",2020,22,835,28,35,"51.516785","-0.10494775","Farringdon Street, Holborn",63
"17204",2020,22,836,133,148,"51.541596","-0.12544145","York Way, Kings Cross",281
"17205",2020,22,838,21,26,"51.518093","-0.0914017","Fore Street Avenue, Guildhall",47
"17206",2020,22,839,133,144,"51.508033","-0.10682363","Sea Containers, South Bank",277
"17207",2020,4,475,NA,1,"51.499041","-0.020157","Lightermans Road, Millwall",NA
"17208",2020,13,370,NA,14,"51.520205","-0.174593","Paddington Green, Paddington",NA
"17209",2020,14,370,NA,15,"51.520205","-0.174593","Paddington Green, Paddington",NA
"17210",2020,15,370,NA,10,"51.520205","-0.174593","Paddington Green, Paddington",NA
"17211",2020,16,370,NA,6,"51.520205","-0.174593","Paddington Green, Paddington",NA
